"school_code","district_code","district","school","female","male","total"
"2880113","2880013","Achievement First Hartford Academy Inc. District","Achievement First Hartford Academy Inc.","199","241","440"
"2795113","2790013","Amistad Academy District","Amistad Academy","378","366","744"
"0010111","0010011","Andover School District","Andover Elementary School","143","193","336"
"0026111","0020011","Ansonia School District","Ansonia High School","383","394","777"
"0025111","0020011","Ansonia School District","Ansonia Middle School","226","251","477"
"0020311","0020011","Ansonia School District","Mead School","311","349","660"
"0020811","0020011","Ansonia School District","Prendergast School","382","429","811"
"2446114","2440014","Area Cooperative Educational Services","Collaborative Alternative Magnet School","47","63","110"
"2449414","2440014","Area Cooperative Educational Services","Mill Road School","21","127","148"
"2445114","2440014","Area Cooperative Educational Services","Thomas Edison Magnet Middle School","361","372","733"
"2449514","2440014","Area Cooperative Educational Services","Village School","49","127","176"
"2449214","2440014","Area Cooperative Educational Services","Whitney High School East","26","97","123"
"2449114","2440014","Area Cooperative Educational Services","Whitney High School North","22","78","100"
"2449314","2440014","Area Cooperative Educational Services","Whitney High School West","14","42","56"
"2440314","2440014","Area Cooperative Educational Services","Wintergreen Interdistrict  Magnet School","331","299","630"
"0030111","0030011","Ashford School District","Ashford School","219","256","475"
"0046111","0040011","Avon School District","Avon High School","529","550","1079"
"0045111","0040011","Avon School District","Avon Middle School","321","280","601"
"0040411","0040011","Avon School District","Pine Grove School","313","342","655"
"0040311","0040011","Avon School District","Roaring Brook School","351","331","682"
"0040511","0040011","Avon School District","Thompson Brook School","265","303","568"
"0050111","0050011","Barkhamsted School District","Barkhamsted Elementary School","143","202","345"
"0058011","0050011","Barkhamsted School District","Shared Services Integrated Preschool","8","14","22"
"0076111","0070011","Berlin School District","Berlin High School","513","509","1022"
"0075111","0070011","Berlin School District","Catherine M. McGee Middle School","340","393","733"
"0070411","0070011","Berlin School District","Emma Hart Willard School","252","336","588"
"0070511","0070011","Berlin School District","Mary E. Griswold School","272","292","564"
"0070111","0070011","Berlin School District","Richard D. Hubbard School","111","141","252"
"0080111","0080011","Bethany School District","Bethany Community School","239","276","515"
"0090411","0090011","Bethel School District","Anna H. Rockwell School","190","230","420"
"0096111","0090011","Bethel School District","Bethel High School","506","481","987"
"0095111","0090011","Bethel School District","Bethel Middle School","341","362","703"
"0090111","0090011","Bethel School District","Frank A. Berry School","235","262","497"
"0090511","0090011","Bethel School District","Ralph M. T. Johnson School","215","220","435"
"0116111","0110011","Bloomfield School District","Bloomfield High School","290","339","629"
"0110711","0110011","Bloomfield School District","Carmen Arace Intermediate School","137","157","294"
"0115211","0110011","Bloomfield School District","Carmen Arace Middle School","160","154","314"
"0110311","0110011","Bloomfield School District","J. P. Vincent School","116","138","254"
"0110611","0110011","Bloomfield School District","Laurel School","121","143","264"
"0110511","0110011","Bloomfield School District","Metacomet School","78","104","182"
"0116211","0110011","Bloomfield School District","The Big Picture High School","52","36","88"
"0110811","0110011","Bloomfield School District","Wintonbury Early Childhood Magnet School","120","134","254"
"0120111","0120011","Bolton School District","Bolton Center School","296","287","583"
"0126111","0120011","Bolton School District","Bolton High School","164","133","297"
"0130111","0130011","Bozrah School District","Fields Memorial School","137","119","256"
"0146111","0140011","Branford School District","Branford High School","582","527","1109"
"0145111","0140011","Branford School District","Francis Walsh Intermediate School","532","581","1113"
"0148011","0140011","Branford School District","Indian Neck School","22","36","58"
"0141611","0140011","Branford School District","John B. Sliney School","185","176","361"
"0141511","0140011","Branford School District","Mary R. Tisko School","215","213","428"
"0141411","0140011","Branford School District","Mary T. Murphy School","217","216","433"
"2850113","2850013","Bridgeport Achievement First District","Achievement First Bridgeport Academy","125","113","238"
"0150111","0150011","Bridgeport School District","Barnum School","303","328","631"
"0156111","0150011","Bridgeport School District","Bassick High School","525","628","1153"
"0150211","0150011","Bridgeport School District","Beardsley School","183","192","375"
"0150311","0150011","Bridgeport School District","Black Rock School","139","118","257"
"0154011","0150011","Bridgeport School District","Blackham School","503","566","1069"
"0159011","0150011","Bridgeport School District","Bridgeport Learning Center","9","44","53"
"0150411","0150011","Bridgeport School District","Bryant School","193","208","401"
"0156211","0150011","Bridgeport School District","Central High School","1110","1107","2217"
"0151411","0150011","Bridgeport School District","Cesar Batalla School","515","546","1061"
"0152111","0150011","Bridgeport School District","Classical Studies Academy","178","150","328"
"0150511","0150011","Bridgeport School District","Columbus School","354","328","682"
"0153911","0150011","Bridgeport School District","Cross School","178","202","380"
"0154211","0150011","Bridgeport School District","Curiale School","278","301","579"
"0154111","0150011","Bridgeport School District","Dunbar School","178","146","324"
"0150711","0150011","Bridgeport School District","Edison School","132","134","266"
"0153211","0150011","Bridgeport School District","Geraldine Johnson School","386","453","839"
"0151111","0150011","Bridgeport School District","Hall School","118","159","277"
"0151211","0150011","Bridgeport School District","Hallen School","149","191","340"
"0156311","0150011","Bridgeport School District","Harding High School","774","771","1545"
"0154511","0150011","Bridgeport School District","High Horizons Magnet School","237","195","432"
"0151311","0150011","Bridgeport School District","Hooker School","198","263","461"
"0152211","0150011","Bridgeport School District","Jettie S. Tisdale School","306","314","620"
"0151911","0150011","Bridgeport School District","Longfellow School","208","214","422"
"0151011","0150011","Bridgeport School District","Luis Munoz Marin School","439","428","867"
"0152011","0150011","Bridgeport School District","Madison School","240","322","562"
"0159511","0150011","Bridgeport School District","Make The Grade","23","31","54"
"0154611","0150011","Bridgeport School District","Multicultural Magnet School","250","201","451"
"0159411","0150011","Bridgeport School District","New Start Program","22","24","46"
"0158011","0150011","Bridgeport School District","Parent-Children Program","*","0","*"
"0159211","0150011","Bridgeport School District","Park City Academy","*","*","17"
"0151711","0150011","Bridgeport School District","Park City Magnet School","254","258","512"
"0152511","0150011","Bridgeport School District","Read School","395","468","863"
"0152611","0150011","Bridgeport School District","Roosevelt School","242","284","526"
"0154411","0150011","Bridgeport School District","Skane Center","109","134","243"
"0159111","0150011","Bridgeport School District","The University School","*","*","28"
"0153011","0150011","Bridgeport School District","Waltersville School","251","271","522"
"0153611","0150011","Bridgeport School District","Winthrop School","361","363","724"
"0179011","0170011","Bristol School District","Alternative Special Education Program (ASEP)","*","*","19"
"0176111","0170011","Bristol School District","Bristol Central High School","660","704","1364"
"0176211","0170011","Bristol School District","Bristol Eastern High School","656","649","1305"
"0175111","0170011","Bristol School District","Chippens Hill Middle School","442","468","910"
"0170711","0170011","Bristol School District","Clara T. O'Connell School","173","202","375"
"0170111","0170011","Bristol School District","Clarence A. Bingham School","107","129","236"
"0179211","0170011","Bristol School District","Community/Vocational Program","*","*","13"
"0170311","0170011","Bristol School District","Edgewood School","171","184","355"
"0171411","0170011","Bristol School District","Ellen P. Hubbell School","250","261","511"
"0170511","0170011","Bristol School District","Greene-Hills School","174","188","362"
"0171911","0170011","Bristol School District","Ivy Drive School","168","191","359"
"0170611","0170011","Bristol School District","John J. Jennings School","164","177","341"
"0175311","0170011","Bristol School District","Memorial Boulevard Middle School","269","275","544"
"0171711","0170011","Bristol School District","Mountain View School","171","196","367"
"0175211","0170011","Bristol School District","Northeast Middle School","270","315","585"
"0171111","0170011","Bristol School District","South Side School","252","314","566"
"0171211","0170011","Bristol School District","Stafford School","240","240","480"
"0186111","0180011","Brookfield School District","Brookfield High School","509","507","1016"
"0180311","0180011","Brookfield School District","Center Elementary School","192","227","419"
"0180411","0180011","Brookfield School District","Huckleberry Hill Elementary School","279","267","546"
"0185311","0180011","Brookfield School District","Whisconier Middle School","444","473","917"
"0190111","0190011","Brooklyn School District","Brooklyn Elementary School","296","280","576"
"0195111","0190011","Brooklyn School District","Brooklyn Middle School","188","198","386"
"0210111","0210011","Canaan School District","Lee H. Kellogg School","53","42","95"
"0220211","0220011","Canterbury School District","Canterbury Elementary School","143","186","329"
"0225111","0220011","Canterbury School District","Dr. Helen Baldwin Middle School","105","117","222"
"0236111","0230011","Canton School District","Canton High School","240","274","514"
"0230311","0230011","Canton School District","Canton Intermediate School","193","195","388"
"0235111","0230011","Canton School District","Canton Middle School","139","152","291"
"0230211","0230011","Canton School District","Cherry Brook Primary School","288","281","569"
"2415114","2410014","Capitol Region Education Council","Academy of Aerospace and Engineering","66","102","168"
"2419214","2410014","Capitol Region Education Council","Farmington Valley Regional Diagnostic Center","9","16","25"
"2410114","2410014","Capitol Region Education Council","Glastonbury/East Hartford Magnet School","125","136","261"
"2416314","2410014","Capitol Region Education Council","Great Path Academy at MCC","138","96","234"
"2416414","2410014","Capitol Region Education Council","Greater Hartford Academy of  the Arts High School - Full Time","180","94","274"
"2419414","2410014","Capitol Region Education Council","Integrated Program Models","*","*","9"
"2410414","2410014","Capitol Region Education Council","International Magnet School for Global Citizenship","82","100","182"
"2419014","2410014","Capitol Region Education Council","John J. Allison Polaris Center","17","36","53"
"2419614","2410014","Capitol Region Education Council","Lincoln Academy Regional Interdistrict Collaborative","0","*","*"
"2416114","2410014","Capitol Region Education Council","Metropolitan Learning Center for Global and International Studies","373","340","713"
"2413114","2410014","Capitol Region Education Council","Montessori Magnet School","167","169","336"
"2415214","2410014","Capitol Region Education Council","Public Safety Academy","72","144","216"
"2410314","2410014","Capitol Region Education Council","Reggio Magnet School of the Arts","77","94","171"
"2419514","2410014","Capitol Region Education Council","River Street Early Learning Center (Site 2)","11","41","52"
"2419314","2410014","Capitol Region Education Council","River Street School","24","128","152"
"2419114","2410014","Capitol Region Education Council","Soundbridge","53","36","89"
"2415014","2410014","Capitol Region Education Council","Two Rivers Magnet Middle School","277","315","592"
"2410214","2410014","Capitol Region Education Council","University of Hartford Magnet School","197","221","418"
"0240211","0240011","Chaplin School District","Chaplin Elementary School","83","90","173"
"2870113","2870013","Charter School for Young Children on Asylum Hill District","Charter School for Young Children on Asylum Hill  Inc.","104","81","185"
"0250111","0250011","Cheshire School District","Chapman School","171","154","325"
"0256111","0250011","Cheshire School District","Cheshire High School","735","814","1549"
"0250211","0250011","Cheshire School District","Darcey School","191","204","395"
"0255111","0250011","Cheshire School District","Dodd Middle School","416","399","815"
"0250611","0250011","Cheshire School District","Doolittle School","247","269","516"
"0250411","0250011","Cheshire School District","Highland School","400","440","840"
"0259011","0250011","Cheshire School District","Humiston School","7","10","17"
"0250511","0250011","Cheshire School District","Norton School","252","240","492"
"0260111","0260011","Chester School District","Chester Elementary School","163","136","299"
"0270111","0270011","Clinton School District","Abraham Pierson School","167","133","300"
"0275111","0270011","Clinton School District","Jared Eliot School","242","253","495"
"0270311","0270011","Clinton School District","Lewin G. Joel Jr. School","317","354","671"
"0276111","0270011","Clinton School District","The Morgan School","281","277","558"
"0286111","0280011","Colchester School District","Bacon Academy","509","494","1003"
"0280411","0280011","Colchester School District","Colchester Elementary School","337","397","734"
"0280211","0280011","Colchester School District","Jack Jackter Intermediate School","342","364","706"
"0285111","0280011","Colchester School District","William J. Johnston Middle School","389","372","761"
"0290111","0290011","Colebrook School District","Colebrook Consolidated School","60","59","119"
"0300111","0300011","Columbia School District","Horace W. Porter School","271","283","554"
"2686113","2680013","Common Ground High School District","Common Ground High School","82","78","160"
"9001516","9000016","Connecticut Technical High School System","A. I. Prince Technical High School","370","313","683"
"9001116","9000016","Connecticut Technical High School System","Bullard-Havens Technical High School","460","426","886"
"9001916","9000016","Connecticut Technical High School System","E. C. Goodwin Technical High School","200","344","544"
"9001416","9000016","Connecticut Technical High School System","Eli Whitney Technical High School","246","265","511"
"9002716","9000016","Connecticut Technical High School System","Ella T. Grasso Southeastern Technical High School","254","337","591"
"9002516","9000016","Connecticut Technical High School System","Emmett O'Brien Technical High School","150","364","514"
"9001716","9000016","Connecticut Technical High School System","H. C. Wilcox Technical High School","300","481","781"
"9001316","9000016","Connecticut Technical High School System","H. H. Ellis Technical High School","147","419","566"
"9001216","9000016","Connecticut Technical High School System","Henry Abbott Technical High School","207","464","671"
"9001616","9000016","Connecticut Technical High School System","Howell Cheney Technical High School","109","514","623"
"9002016","9000016","Connecticut Technical High School System","Norwich Technical High School","174","383","557"
"9002216","9000016","Connecticut Technical High School System","Oliver Wolcott Technical High School","251","510","761"
"9002616","9000016","Connecticut Technical High School System","Platt Technical High School","289","591","880"
"9001816","9000016","Connecticut Technical High School System","Vinal Technical High School","176","431","607"
"9002316","9000016","Connecticut Technical High School System","W. F. Kaynor Technical High School","300","437","737"
"9002416","9000016","Connecticut Technical High School System","Windham Technical High School","201","356","557"
"2439214","2430014","Cooperative Educational Services","Developmental Learning Center (DLC)","28","48","76"
"2439114","2430014","Cooperative Educational Services","Preschool-Primary Learning Center (PLC)","14","44","58"
"2439314","2430014","Cooperative Educational Services","RISE Transitional Program","*","*","10"
"2438014","2430014","Cooperative Educational Services","School Readiness","31","22","53"
"2430114","2430014","Cooperative Educational Services","Six-Six Magnet School","221","218","439"
"2439414","2430014","Cooperative Educational Services","Therapeutic Day Program","23","119","142"
"0310111","0310011","Cornwall School District","Cornwall Consolidated School","60","62","122"
"0325111","0320011","Coventry School District","Capt. Nathan Hale School","228","253","481"
"0328011","0320011","Coventry School District","Coventry Early Intervention Services","*","*","11"
"0320211","0320011","Coventry School District","Coventry Grammar School","209","205","414"
"0326111","0320011","Coventry School District","Coventry High School","279","284","563"
"0320411","0320011","Coventry School District","George Hersey Robertson School","205","235","440"
"0336111","0330011","Cromwell School District","Cromwell High School","314","291","605"
"0335111","0330011","Cromwell School District","Cromwell Middle School","222","243","465"
"0330211","0330011","Cromwell School District","Edna C. Stevens School","221","256","477"
"0330311","0330011","Cromwell School District","Woodside Intermediate School","238","263","501"
"0346211","0340011","Danbury School District","Alternative Center For Excellence","50","38","88"
"0345111","0340011","Danbury School District","Broadview Middle School","553","555","1108"
"0346111","0340011","Danbury School District","Danbury High School","1411","1443","2854"
"0341411","0340011","Danbury School District","Ellsworth Avenue School","190","205","395"
"0341111","0340011","Danbury School District","Great Plain School","147","160","307"
"0340211","0340011","Danbury School District","Hayestown Avenue School","202","237","439"
"0341711","0340011","Danbury School District","King Street Intermediate School","148","159","307"
"0341311","0340011","Danbury School District","King Street Primary School","144","156","300"
"0341811","0340011","Danbury School District","Mill Ridge Educational Center","168","184","352"
"0340511","0340011","Danbury School District","Mill Ridge Primary School","147","149","296"
"0340611","0340011","Danbury School District","Morris Street School","184","185","369"
"0340811","0340011","Danbury School District","Park Avenue School","208","200","408"
"0341511","0340011","Danbury School District","Pembroke School","153","172","325"
"0345211","0340011","Danbury School District","Rogers Park Middle School","486","550","1036"
"0341211","0340011","Danbury School District","Shelter Rock School","201","195","396"
"0341011","0340011","Danbury School District","South Street School","172","172","344"
"0341611","0340011","Danbury School District","Stadley Rough School","238","229","467"
"0341911","0340011","Danbury School District","Western CT Academy of International Studies Elementary Magnet School","179","204","383"
"0356111","0350011","Darien School District","Darien High School","637","627","1264"
"0350211","0350011","Darien School District","Hindley Elementary School","271","275","546"
"0350711","0350011","Darien School District","Holmes Elementary School","223","261","484"
"0355111","0350011","Darien School District","Middlesex Middle School","549","607","1156"
"0351311","0350011","Darien School District","Ox Ridge Elementary School","227","251","478"
"0350511","0350011","Darien School District","Royle Elementary School","192","251","443"
"0350611","0350011","Darien School District","Tokeneke Elementary School","183","226","409"
"0360111","0360011","Deep River School District","Deep River Elementary School","173","176","349"
"3370315","3370015","Department of Mental Health and Addiction Services","Cedarcrest Regional Hosp - Blue Hills Hosp. Substance Ab","*","*","*"
"3370515","3370015","Department of Mental Health and Addiction Services","Greater Bridgeport Community Mental Health Center","*","0","*"
"0370611","0370011","Derby School District","Bradley School","191","195","386"
"0376111","0370011","Derby School District","Derby High School","296","328","624"
"0370411","0370011","Derby School District","Irving School","204","235","439"
"0400111","0400011","East Granby School District","Allgrove School","135","146","281"
"0406111","0400011","East Granby School District","East Granby High School","126","130","256"
"0405111","0400011","East Granby School District","East Granby Middle School","108","122","230"
"0400211","0400011","East Granby School District","R. Dudley Seymour School","75","62","137"
"0410111","0410011","East Haddam School District","East Haddam Elementary School","180","241","421"
"0416111","0410011","East Haddam School District","Nathan Hale-Ray High School","225","181","406"
"0415111","0410011","East Haddam School District","Nathan Hale-Ray Middle School","278","281","559"
"0420311","0420011","East Hampton School District","Center School","154","147","301"
"0426111","0420011","East Hampton School District","East Hampton High School","287","283","570"
"0425111","0420011","East Hampton School District","East Hampton Middle School","258","241","499"
"0420111","0420011","East Hampton School District","Memorial School","301","347","648"
"0429011","0420011","East Hampton School District","The Learning Center at East Hampton","*","*","8"
"0430911","0430011","East Hartford School District","Anna E. Norris School","138","181","319"
"0436311","0430011","East Hartford School District","Connecticut IB Academy","106","61","167"
"0430611","0430011","East Hartford School District","Dr. Franklin H. Mayberry School","203","205","408"
"0432211","0430011","East Hartford School District","Dr. John A. Langford School","164","181","345"
"0431011","0430011","East Hartford School District","Dr. Thomas S. O'Connell School","157","174","331"
"0436211","0430011","East Hartford School District","East Hartford High School","942","961","1903"
"0435111","0430011","East Hartford School District","East Hartford Middle School","445","460","905"
"0432011","0430011","East Hartford School District","Governor William Pitkin School","187","189","376"
"0430511","0430011","East Hartford School District","Hockanum School","144","196","340"
"0430411","0430011","East Hartford School District","Joseph O. Goodwin School","163","192","355"
"0431811","0430011","East Hartford School District","Robert J. O'Brien School","206","205","411"
"0431211","0430011","East Hartford School District","Silver Lane School","173","161","334"
"0436411","0430011","East Hartford School District","Stevens Alternate High School","48","69","117"
"0432411","0430011","East Hartford School District","Sunset Ridge Middle School","237","225","462"
"0438011","0430011","East Hartford School District","Willowbrook Early Childhood","141","144","285"
"0439011","0430011","East Hartford School District","Woodland School","24","160","184"
"0441711","0440011","East Haven School District","Carbone School/East Haven Academy","136","101","237"
"0441411","0440011","East Haven School District","D. C. Moore School","111","115","226"
"0440111","0440011","East Haven School District","Deer Run School","155","189","344"
"0441311","0440011","East Haven School District","Dominick H. Ferrara School","91","106","197"
"0446111","0440011","East Haven School District","East Haven High School","500","468","968"
"0441011","0440011","East Haven School District","Grove J. Tuttle School","115","118","233"
"0441911","0440011","East Haven School District","Hays School","75","79","154"
"0445111","0440011","East Haven School District","Joseph Melillo Middle School","214","260","474"
"0440711","0440011","East Haven School District","Momauguin School","98","114","212"
"0441811","0440011","East Haven School District","Overbrook Elementary School","91","91","182"
"0449011","0440011","East Haven School District","Pathways","9","23","32"
"0441611","0440011","East Haven School District","Robert W. Carbone School","124","137","261"
"0456111","0450011","East Lyme School District","East Lyme High School","617","604","1221"
"0455111","0450011","East Lyme School District","East Lyme Middle School","425","418","843"
"0450111","0450011","East Lyme School District","Flanders School","192","187","379"
"0458011","0450011","East Lyme School District","Integrated Preschool","21","26","47"
"0450411","0450011","East Lyme School District","Lillie B. Haynes School","169","198","367"
"0450211","0450011","East Lyme School District","Niantic Center School","117","120","237"
"0470111","0470011","East Windsor School District","Broad Brook Elementary School","297","304","601"
"0476111","0470011","East Windsor School District","East Windsor High School","177","199","376"
"0475411","0470011","East Windsor School District","East Windsor Middle School","187","215","402"
"2536014","2530014","Eastern Connecticut Regional Educational Service Center (EASTCONN)","Arts at the Capitol Theater Magnet School (ACT)","66","22","88"
"2539014","2530014","Eastern Connecticut Regional Educational Service Center (EASTCONN)","EastConn Special Education","10","40","50"
"2536114","2530014","Eastern Connecticut Regional Educational Service Center (EASTCONN)","Quinebaug Middle College","35","35","70"
"0390111","0390011","Eastford School District","Eastford Elementary School","75","95","170"
"0465111","0460011","Easton School District","Helen Keller Middle School","201","183","384"
"0460111","0460011","Easton School District","Samuel Staples Elementary School","324","406","730"
"2428014","2420014","EdAdvance","EdAdvance Headstart","90","83","173"
"2429014","2420014","EdAdvance","The ACCESS School at The Danuta M. Thibodeau Education Center","9","18","27"
"0480111","0480011","Ellington School District","Center School","197","206","403"
"0480211","0480011","Ellington School District","Crystal Lake School","102","119","221"
"0486111","0480011","Ellington School District","Ellington High School","398","379","777"
"0485111","0480011","Ellington School District","Ellington Middle School","200","205","405"
"0480711","0480011","Ellington School District","Windermere Intermediate School","223","191","414"
"0480611","0480011","Ellington School District","Windermere School","221","226","447"
"2890113","2890013","Elm City College Preparatory School District","Elm City College Preparatory School","280","267","547"
"0491311","0490011","Enfield School District","Edgar H. Parkman School","169","174","343"
"0491611","0490011","Enfield School District","Eli Whitney School","186","238","424"
"0496111","0490011","Enfield School District","Enfield High School","395","428","823"
"0490211","0490011","Enfield School District","Enfield Street School","178","178","356"
"0499011","0490011","Enfield School District","Enfield Transitional Learning Academy","*","*","*"
"0496211","0490011","Enfield School District","Enrico Fermi High School","596","562","1158"
"0491211","0490011","Enfield School District","Harriet Beecher Stowe School","126","132","258"
"0490411","0490011","Enfield School District","Hazardville Memorial School","164","207","371"
"0498011","0490011","Enfield School District","Head Start Program","50","54","104"
"0491811","0490011","Enfield School District","Henry Barnard School","190","238","428"
"0495211","0490011","Enfield School District","John F. Kennedy Middle School","425","447","872"
"0491111","0490011","Enfield School District","Nathan Hale School","129","130","259"
"0491511","0490011","Enfield School District","Prudence Crandall School","207","196","403"
"0491711","0490011","Enfield School District","Thomas G. Alcorn School","149","144","293"
"0500111","0500011","Essex School District","Essex Elementary School","303","290","593"
"2726113","2720013","Explorations District","Explorations","51","29","80"
"0510211","0510011","Fairfield School District","Burr Elementary School","209","210","419"
"0510111","0510011","Fairfield School District","Dwight Elementary School","168","148","316"
"0518011","0510011","Fairfield School District","Early Childhood Center","42","93","135"
"0516011","0510011","Fairfield School District","Fairfield Ludlowe High School","759","693","1452"
"0516211","0510011","Fairfield School District","Fairfield Warde High School","665","633","1298"
"0515211","0510011","Fairfield School District","Fairfield Woods Middle School","329","343","672"
"0510411","0510011","Fairfield School District","Holland Hill School","162","173","335"
"0511711","0510011","Fairfield School District","Jennings School","163","189","352"
"0510611","0510011","Fairfield School District","McKinley School","214","237","451"
"0510711","0510011","Fairfield School District","Mill Hill School","230","248","478"
"0511611","0510011","Fairfield School District","North Stratfield School","223","255","478"
"0511811","0510011","Fairfield School District","Osborn Hill School","258","293","551"
"0511211","0510011","Fairfield School District","Riverfield School","214","252","466"
"0515311","0510011","Fairfield School District","Roger Ludlowe Middle School","483","483","966"
"0511311","0510011","Fairfield School District","Sherman School","236","238","474"
"0511411","0510011","Fairfield School District","Stratfield School","249","243","492"
"0515111","0510011","Fairfield School District","Tomlinson Middle School","394","379","773"
"0520411","0520011","Farmington School District","East Farms School","203","235","438"
"0528011","0520011","Farmington School District","Farmington Collaborative PK","18","49","67"
"0526111","0520011","Farmington School District","Farmington High School","654","670","1324"
"0525111","0520011","Farmington School District","Irving A. Robbins Middle School","313","373","686"
"0520211","0520011","Farmington School District","Noah Wallace School","160","175","335"
"0520111","0520011","Farmington School District","Union School","149","145","294"
"0520311","0520011","Farmington School District","West District School","177","173","350"
"0520511","0520011","Farmington School District","West Woods Upper Elementary School","313","345","658"
"0530111","0530011","Franklin School District","Franklin Elementary School","105","119","224"
"0540211","0540011","Glastonbury School District","Buttonball Lane School","273","262","535"
"0540311","0540011","Glastonbury School District","Eastbury School","150","168","318"
"0540811","0540011","Glastonbury School District","Gideon Welles School","278","263","541"
"0546111","0540011","Glastonbury School District","Glastonbury High School","1030","1072","2102"
"0540411","0540011","Glastonbury School District","Hebron Avenue School","271","261","532"
"0540611","0540011","Glastonbury School District","Hopewell School","260","266","526"
"0540711","0540011","Glastonbury School District","Naubuc School","258","231","489"
"0540911","0540011","Glastonbury School District","Nayaug Elementary School","317","328","645"
"0545211","0540011","Glastonbury School District","Smith Middle School","568","560","1128"
"0560111","0560011","Granby School District","Frank M. Kearns Primary School","222","247","469"
"0566111","0560011","Granby School District","Granby Memorial High School","361","390","751"
"0565111","0560011","Granby School District","Granby Memorial Middle School","189","165","354"
"0560411","0560011","Granby School District","Kelly Lane Primary School","158","189","347"
"0560311","0560011","Granby School District","Wells Road Intermediate School","169","185","354"
"0575111","0570011","Greenwich School District","Central Middle School","292","339","631"
"0570211","0570011","Greenwich School District","Cos Cob School","204","213","417"
"0575211","0570011","Greenwich School District","Eastern Middle School","401","373","774"
"0570411","0570011","Greenwich School District","Glenville School","140","156","296"
"0576111","0570011","Greenwich School District","Greenwich High School","1271","1417","2688"
"0570511","0570011","Greenwich School District","Hamilton Avenue School","207","203","410"
"0571311","0570011","Greenwich School District","International School At Dundee","178","193","371"
"0570311","0570011","Greenwich School District","Julian Curtiss School","171","172","343"
"0570611","0570011","Greenwich School District","New Lebanon School","106","113","219"
"0570711","0570011","Greenwich School District","North Mianus School","229","226","455"
"0570811","0570011","Greenwich School District","North Street School","229","257","486"
"0570911","0570011","Greenwich School District","Old Greenwich School","227","218","445"
"0571111","0570011","Greenwich School District","Parkway School","139","180","319"
"0571011","0570011","Greenwich School District","Riverside School","238","264","502"
"0575311","0570011","Greenwich School District","Western Middle School","231","259","490"
"0580311","0580011","Griswold School District","Griswold Elementary School","451","462","913"
"0586211","0580011","Griswold School District","Griswold High School","371","369","740"
"0585111","0580011","Griswold School District","Griswold Middle School","183","224","407"
"0595311","0590011","Groton School District","Carl C. Cutler Middle School","168","182","350"
"0592011","0590011","Groton School District","Catherine Kolnaski Magnet School","234","237","471"
"0591811","0590011","Groton School District","Charles Barnum School","175","205","380"
"0590311","0590011","Groton School District","Claude Chester School","191","197","388"
"0595111","0590011","Groton School District","Fitch Middle School","202","207","409"
"0591711","0590011","Groton School District","Mary Morrisson School","160","178","338"
"0591911","0590011","Groton School District","Northeast Academy Elementary School","215","222","437"
"0591211","0590011","Groton School District","Pleasant Valley School","146","166","312"
"0596111","0590011","Groton School District","Robert E. Fitch High School","678","628","1306"
"0590111","0590011","Groton School District","S. B. Butler School","171","191","362"
"0595211","0590011","Groton School District","West Side Middle School","141","135","276"
"0600711","0600011","Guilford School District","A. Baldwin Middle School","249","295","544"
"0600611","0600011","Guilford School District","A. W. Cox School","177","144","321"
"0600411","0600011","Guilford School District","Calvin Leete School","167","165","332"
"0605111","0600011","Guilford School District","E. C. Adams Middle School","309","310","619"
"0606111","0600011","Guilford School District","Guilford High School","570","545","1115"
"0600211","0600011","Guilford School District","Guilford Lakes School","209","224","433"
"0600311","0600011","Guilford School District","Melissa Jones School","172","175","347"
"0628011","0620011","Hamden School District","Alice Peck Learning Center","36","60","96"
"0621211","0620011","Hamden School District","Bear Path School","231","226","457"
"0620211","0620011","Hamden School District","Church Street School","196","215","411"
"0620311","0620011","Hamden School District","Dunbar Hill School","156","170","326"
"0626111","0620011","Hamden School District","Hamden High School","934","1038","1972"
"0625211","0620011","Hamden School District","Hamden Middle School","411","470","881"
"0620411","0620011","Hamden School District","Helen Street School","127","172","299"
"0621111","0620011","Hamden School District","Ridge Hill School","143","171","314"
"0620111","0620011","Hamden School District","Shepherd Glen School","162","151","313"
"0621011","0620011","Hamden School District","Spring Glen School","169","189","358"
"0621411","0620011","Hamden School District","West Woods School","248","264","512"
"0630111","0630011","Hampton School District","Hampton Elementary School","55","88","143"
"0640711","0640011","Hartford School District","Asian Studies Academy at Bellizzi School","143","185","328"
"0640411","0640011","Hartford School District","Batchelder School","270","298","568"
"0642811","0640011","Hartford School District","Betances Early Reading Lab Magnet School","175","170","345"
"0643511","0640011","Hartford School District","Breakthrough II Magnet School","65","64","129"
"0643311","0640011","Hartford School District","Breakthrough Magnet School","176","176","352"
"0647111","0640011","Hartford School District","Bulkeley High School","282","288","570"
"0646111","0640011","Hartford School District","Bulkeley High School Lower School","328","438","766"
"0640611","0640011","Hartford School District","Burns Latino Studies Academy","292","292","584"
"0642311","0640011","Hartford School District","Burr School","291","334","625"
"0646911","0640011","Hartford School District","Capital Preparatory Magnet School","155","121","276"
"0642411","0640011","Hartford School District","Clark School","191","225","416"
"0646411","0640011","Hartford School District","Classical Magnet School","403","310","713"
"0646011","0640011","Hartford School District","Culinary Arts Academy at Weaver High School","130","135","265"
"0645311","0640011","Hartford School District","Dr. Joseph Bellizzi Middle School","216","219","435"
"0640911","0640011","Hartford School District","Environmental Sciences Magnet at Hooker School","175","170","345"
"0643211","0640011","Hartford School District","Expeditionary Learning Academy at Moylan School","302","308","610"
"0643611","0640011","Hartford School District","Global Communications Academy","185","191","376"
"0647211","0640011","Hartford School District","HPHS Engineering and Green Technology Academy","86","292","378"
"0647311","0640011","Hartford School District","HPHS Freshmen Academy","187","186","373"
"0647411","0640011","Hartford School District","HPHS Law and Government Academy","203","168","371"
"0647511","0640011","Hartford School District","HPHS Nursing and Health Sciences Academy","302","92","394"
"0645411","0640011","Hartford School District","Hartford Magnet Trinity College Academy","316","295","611"
"0649011","0640011","Hartford School District","Hartford Transitional Learning Academy (Elementary)","*","*","35"
"0649111","0640011","Hartford School District","Hartford Transitional Learning Academy (Secondary)","14","61","75"
"0647611","0640011","Hartford School District","High School, Inc.","99","98","197"
"0647711","0640011","Hartford School District","Journalism and Media Academy Magnet School","77","88","165"
"0641011","0640011","Hartford School District","Kennelly School","421","374","795"
"0641111","0640011","Hartford School District","Kinsella Magnet School of Performing Arts","357","261","618"
"0640811","0640011","Hartford School District","M. D. Fox School","392","409","801"
"0641611","0640011","Hartford School District","M. L. King, Jr. School","252","260","512"
"0641211","0640011","Hartford School District","McDonough Middle School","162","196","358"
"0641911","0640011","Hartford School District","Milner School","196","204","400"
"0643711","0640011","Hartford School District","Montessori Magnet at Fisher School","68","81","149"
"0641411","0640011","Hartford School District","Naylor/CCSU Leadership Academy","354","348","702"
"0647811","0640011","Hartford School District","OPPortunity High School","49","41","90"
"0641511","0640011","Hartford School District","Parkville Community School","248","266","514"
"0646611","0640011","Hartford School District","Pathways Academy of Technology and Design","148","203","351"
"0645211","0640011","Hartford School District","Quirk Middle School","120","123","243"
"0641711","0640011","Hartford School District","Rawson School","339","395","734"
"0640111","0640011","Hartford School District","SAND School","219","194","413"
"0642511","0640011","Hartford School District","STEM Magnet at Fisher School","112","141","253"
"0643011","0640011","Hartford School District","Sanchez School","241","252","493"
"0642611","0640011","Hartford School District","Simpson-Waverly School","220","217","437"
"0646511","0640011","Hartford School District","Sports and Medical Sciences Academy","310","292","602"
"0646711","0640011","Hartford School District","University High School of Science and Engineering","141","221","362"
"0646311","0640011","Hartford School District","Weaver High School","165","170","335"
"0642011","0640011","Hartford School District","Webster Micro Society Magnet School","293","326","619"
"0642111","0640011","Hartford School District","West Middle School","349","349","698"
"0642211","0640011","Hartford School District","Wish Museum School","200","226","426"
"0650111","0650011","Hartland School District","Hartland School","108","119","227"
"0670211","0670011","Hebron School District","Gilead Hill School","250","254","504"
"0670111","0670011","Hebron School District","Hebron Elementary School","304","364","668"
"2860113","2860013","Highville Charter School District","Highville Charter School","157","146","303"
"2640113","2640013","Integrated Day Charter School District","Integrated Day Charter School","160","170","330"
"2655113","2650013","Interdistrict School for Arts and Comm District","Interdistrict School For Arts And Communication","96","86","182"
"2610113","2610013","Jumoke Academy District","Jumoke Academy","241","193","434"
"0680111","0680011","Kent School District","Kent Center School","131","151","282"
"0698011","0690011","Killingly School District","Goodyear Early Childhood Center","40","58","98"
"0690111","0690011","Killingly School District","Killingly Central School","245","257","502"
"0696111","0690011","Killingly School District","Killingly High School","418","371","789"
"0695211","0690011","Killingly School District","Killingly Intermediate School","356","434","790"
"0690311","0690011","Killingly School District","Killingly Memorial School","248","254","502"
"2455014","2450014","Learn","Dual Language & Arts Magnet Middle School","43","24","67"
"2459014","2450014","Learn","Learn Special Education","*","*","33"
"2450114","2450014","Learn","Regional Multicultural Magnet School","273","251","524"
"2450214","2450014","Learn","The Friendship School","224","273","497"
"0710111","0710011","Lebanon School District","Lebanon Elementary School","232","262","494"
"0715111","0710011","Lebanon School District","Lebanon Middle School","208","196","404"
"0716211","0710011","Lebanon School District","Lyman Memorial High School","314","235","549"
"0720211","0720011","Ledyard School District","Gales Ferry School","97","122","219"
"0720411","0720011","Ledyard School District","Gallup Hill School","179","169","348"
"0720311","0720011","Ledyard School District","Juliet W. Long School","154","161","315"
"0720111","0720011","Ledyard School District","Ledyard Center School","200","205","405"
"0726111","0720011","Ledyard School District","Ledyard High School","501","425","926"
"0725111","0720011","Ledyard School District","Ledyard Middle School","211","237","448"
"0736011","0730011","Lisbon School District","Community Connection - The Big Picture High School","14","8","22"
"0730111","0730011","Lisbon School District","Lisbon Central School","254","291","545"
"0740211","0740011","Litchfield School District","Center School","165","179","344"
"0746111","0740011","Litchfield School District","Litchfield High School","291","277","568"
"0740311","0740011","Litchfield School District","Litchfield Intermediate School","142","147","289"
"0766111","0760011","Madison School District","Daniel Hand High School","630","634","1264"
"0760611","0760011","Madison School District","Dr. Robert H. Brown Middle School","282","305","587"
"0760211","0760011","Madison School District","Island Avenue Elementary School","165","152","317"
"0760111","0760011","Madison School District","J. Milton Jeffrey Elementary School","261","287","548"
"0760311","0760011","Madison School District","Kathleen H. Ryerson Elementary School","143","168","311"
"0769011","0760011","Madison School District","Town Campus Learning Center","10","19","29"
"0765211","0760011","Madison School District","Walter C. Polson Upper Middle School","310","298","608"
"0770911","0770011","Manchester School District","Nathan Hale School","133","127","260"
"0770111","0770011","Manchester School District","Bowers School","201","230","431"
"0770311","0770011","Manchester School District","Buckley School","168","177","345"
"0771711","0770011","Manchester School District","Elisabeth M. Bennet Academy","198","254","452"
"0770411","0770011","Manchester School District","Highland Park School","110","168","278"
"0775311","0770011","Manchester School District","Illing Middle School","440","509","949"
"0770611","0770011","Manchester School District","Keeney School","204","197","401"
"0776111","0770011","Manchester School District","Manchester High School","999","979","1978"
"0778011","0770011","Manchester School District","Manchester Preschool Center","85","100","185"
"0779011","0770011","Manchester School District","Manchester Regional Academy","28","70","98"
"0771611","0770011","Manchester School District","Martin School","121","139","260"
"0771011","0770011","Manchester School District","Robertson School","156","179","335"
"0771211","0770011","Manchester School District","Verplanck School","146","145","291"
"0771311","0770011","Manchester School District","Waddell School","152","159","311"
"0771411","0770011","Manchester School District","Washington School","145","165","310"
"0780411","0780011","Mansfield School District","Annie E. Vinton School","129","145","274"
"0780211","0780011","Mansfield School District","Dorothy C. Goodwin School","87","109","196"
"0785111","0780011","Mansfield School District","Mansfield Middle School","271","292","563"
"0780511","0780011","Mansfield School District","Southeast Elementary School","116","122","238"
"0790111","0790011","Marlborough School District","Elmer Thienes-Mary Hall Elementary School","345","324","669"
"0800711","0800011","Meriden School District","Nathan Hale School","309","301","610"
"0800111","0800011","Meriden School District","Benjamin Franklin School","195","263","458"
"0801111","0800011","Meriden School District","Casimir Pulaski School","332","348","680"
"0806111","0800011","Meriden School District","Francis T. Maloney High School","618","610","1228"
"0800311","0800011","Meriden School District","Hanover School","258","295","553"
"0800411","0800011","Meriden School District","Israel Putnam School","234","310","544"
"0800511","0800011","Meriden School District","John Barry School","248","274","522"
"0805211","0800011","Meriden School District","Lincoln Middle School","347","395","742"
"0806211","0800011","Meriden School District","Orville H. Platt High School","582","532","1114"
"0800811","0800011","Meriden School District","Roger Sherman School","239","287","526"
"0801011","0800011","Meriden School District","Thomas Hooker School","250","261","511"
"0805411","0800011","Meriden School District","Washington Middle School","413","460","873"
"0830211","0830011","Middletown School District","Bielefield School","152","170","322"
"0839011","0830011","Middletown School District","DEAL Program","*","*","16"
"0830511","0830011","Middletown School District","Farm Hill School","136","171","307"
"0831511","0830011","Middletown School District","Keigwin Middle School","180","189","369"
"0831311","0830011","Middletown School District","Lawrence School","167","179","346"
"0830911","0830011","Middletown School District","MacDonough School","110","101","211"
"0836211","0830011","Middletown School District","Middletown High School","655","669","1324"
"0831211","0830011","Middletown School District","Moody School","203","235","438"
"0831111","0830011","Middletown School District","Snow School","182","171","353"
"0830111","0830011","Middletown School District","Spencer School","193","186","379"
"0831411","0830011","Middletown School District","Wesley School","177","195","372"
"0835411","0830011","Middletown School District","Woodrow Wilson Middle School","361","383","744"
"0840111","0840011","Milford School District","Calf Pen Meadow School","153","149","302"
"0845111","0840011","Milford School District","East Shore Middle School","245","315","560"
"0845211","0840011","Milford School District","Harborside Middle School","290","294","584"
"0841911","0840011","Milford School District","J. F. Kennedy School","178","181","359"
"0846211","0840011","Milford School District","Jonathan Law High School","497","509","1006"
"0846311","0840011","Milford School District","Joseph A. Foran High School","541","511","1052"
"0841611","0840011","Milford School District","Live Oaks School","155","173","328"
"0841711","0840011","Milford School District","Mathewson School","231","257","488"
"0840711","0840011","Milford School District","Meadowside School","176","182","358"
"0840811","0840011","Milford School District","Orange Avenue School","218","251","469"
"0841811","0840011","Milford School District","Orchard Hills School","199","215","414"
"0841011","0840011","Milford School District","Pumpkin Delight School","134","156","290"
"0841411","0840011","Milford School District","Simon Lake School","176","183","359"
"0845311","0840011","Milford School District","West Shore Middle School","275","285","560"
"0850611","0850011","Monroe School District","Chalk Hill School","279","298","577"
"0850511","0850011","Monroe School District","Fawn Hollow Elementary School","245","285","530"
"0855211","0850011","Monroe School District","Jockey Hollow School","329","348","677"
"0856111","0850011","Monroe School District","Masuk High School","635","667","1302"
"0850111","0850011","Monroe School District","Monroe Elementary School","162","196","358"
"0850311","0850011","Monroe School District","Stepney Elementary School","217","233","450"
"0860711","0860011","Montville School District","Dr. Charles E. Murphy School","172","192","364"
"0865111","0860011","Montville School District","Leonard J. Tyl Middle School","322","337","659"
"0860111","0860011","Montville School District","Mohegan School","219","193","412"
"0866111","0860011","Montville School District","Montville High School","379","413","792"
"0860511","0860011","Montville School District","Oakdale School","208","233","441"
"0869011","0860011","Montville School District","Palmer Academy","9","12","21"
"0880811","0880011","Naugatuck School District","Andrew Avenue School","107","120","227"
"0880111","0880011","Naugatuck School District","Central Avenue School","150","134","284"
"0885111","0880011","Naugatuck School District","City Hill Middle School","233","238","471"
"0880211","0880011","Naugatuck School District","Cross Street Intermediate School","182","206","388"
"0888111","0880011","Naugatuck School District","Head Start","47","57","104"
"0880411","0880011","Naugatuck School District","Hillside Intermediate School","166","202","368"
"0885211","0880011","Naugatuck School District","Hillside Middle School","142","164","306"
"0880511","0880011","Naugatuck School District","Hop Brook Elementary School","160","160","320"
"0880311","0880011","Naugatuck School District","Maple Hill School","221","238","459"
"0886111","0880011","Naugatuck School District","Naugatuck High School","705","729","1434"
"0880611","0880011","Naugatuck School District","Salem School","115","131","246"
"0880711","0880011","Naugatuck School District","Western School","119","155","274"
"2800113","2800013","New Beginnings Inc Family Academy District","New Beginnings Inc Family Academy","195","165","360"
"0899211","0890011","New Britain School District","Academic Extension Center","7","14","21"
"0899311","0890011","New Britain School District","Behavior Support Program","*","*","12"
"0890311","0890011","New Britain School District","Chamberlain  Elementary School","202","273","475"
"0891111","0890011","New Britain School District","Frank J. DiLoreto School","470","324","794"
"0890511","0890011","New Britain School District","Gaffney School","227","295","522"
"0890611","0890011","New Britain School District","Holmes School","212","256","468"
"0895411","0890011","New Britain School District","House of Arts Letters and Science (HALS)  Academy","85","70","155"
"0890711","0890011","New Britain School District","Jefferson School","187","236","423"
"0890811","0890011","New Britain School District","Lincoln School","292","319","611"
"0896111","0890011","New Britain School District","New Britain High School","1293","1466","2759"
"0899011","0890011","New Britain School District","New Britain Transition Center","10","26","36"
"0890911","0890011","New Britain School District","Northend School","134","162","296"
"0895311","0890011","New Britain School District","Pulaski Middle School","291","358","649"
"0895111","0890011","New Britain School District","Roosevelt Middle School","215","227","442"
"0895211","0890011","New Britain School District","Slade Middle School","356","360","716"
"0891211","0890011","New Britain School District","Smalley Academy","346","365","711"
"0891311","0890011","New Britain School District","Smith School","295","316","611"
"0891511","0890011","New Britain School District","Vance School","254","269","523"
"0900411","0900011","New Canaan School District","East School","275","264","539"
"0906111","0900011","New Canaan School District","New Canaan High School","655","632","1287"
"0905111","0900011","New Canaan School District","Saxe Middle School","614","604","1218"
"0900211","0900011","New Canaan School District","South School","270","271","541"
"0900311","0900011","New Canaan School District","West School","233","259","492"
"0910111","0910011","New Fairfield School District","Consolidated School","304","345","649"
"0910211","0910011","New Fairfield School District","Meeting House Hill School","276","361","637"
"0916111","0910011","New Fairfield School District","New Fairfield High School","502","518","1020"
"0915211","0910011","New Fairfield School District","New Fairfield Middle School","346","377","723"
"0920311","0920011","New Hartford School District","Ann Antolini School","175","186","361"
"0920111","0920011","New Hartford School District","Bakerville Consolidated School","80","74","154"
"0929011","0920011","New Hartford School District","Bridges I","*","*","6"
"0920211","0920011","New Hartford School District","New Hartford Elementary School","57","53","110"
"0931211","0930011","New Haven School District","Edgewood School","225","234","459"
"0931411","0930011","New Haven School District","Nathan Hale School","259","274","533"
"0931511","0930011","New Haven School District","Augusta Lewis Troup School","236","289","525"
"0930211","0930011","New Haven School District","Barnard Environmental Magnet School","248","256","504"
"0930311","0930011","New Haven School District","Beecher School","218","260","478"
"0931811","0930011","New Haven School District","Benjamin Jepson Magnet School","223","273","496"
"0935511","0930011","New Haven School District","Betsy Ross Arts Magnet School","299","174","473"
"0934311","0930011","New Haven School District","Bishop Woods Architecture and Design Magnet School","220","227","447"
"0934811","0930011","New Haven School District","Celentano BioTech, Health and Medical Magnet School","217","248","465"
"0930511","0930011","New Haven School District","Clarence Rogers School","66","84","150"
"0930611","0930011","New Haven School District","Clinton Avenue School","221","234","455"
"0934111","0930011","New Haven School District","Columbus Family Academy","234","193","427"
"0933111","0930011","New Haven School District","Conte/West Hills Magnet School","324","311","635"
"0936411","0930011","New Haven School District","Cooperative High School","376","165","541"
"0936811","0930011","New Haven School District","Cortlandt V.R. Creed Health and Sport Sciences High School","41","151","192"
"0930911","0930011","New Haven School District","Davis 21st Century Magnet Elementary School","192","221","413"
"0938211","0930011","New Haven School District","Dwight Early Childhood Program","18","29","47"
"0938111","0930011","New Haven School District","Early Learning Center","60","58","118"
"0934611","0930011","New Haven School District","East Rock Community Magnet School","241","262","503"
"0931711","0930011","New Haven School District","Engineering - Science University Magnet School","57","101","158"
"0931611","0930011","New Haven School District","Fair Haven School","288","331","619"
"0938011","0930011","New Haven School District","Headstart","219","222","441"
"0938311","0930011","New Haven School District","Helene Grant HeadStart","134","140","274"
"0936611","0930011","New Haven School District","High School In The Community","188","139","327"
"0930711","0930011","New Haven School District","Hill Central Music Academy","179","186","365"
"0936311","0930011","New Haven School District","Hill Regional Career High School","448","251","699"
"0936211","0930011","New Haven School District","James Hillhouse High School","445","503","948"
"0931311","0930011","New Haven School District","John C. Daniels","279","253","532"
"0930811","0930011","New Haven School District","John S. Martinez Sea and Sky STEM School","310","278","588"
"0930411","0930011","New Haven School District","Katherine Brennan School","88","88","176"
"0933011","0930011","New Haven School District","King/Robinson Magnet School","233","242","475"
"0932011","0930011","New Haven School District","Lincoln-Bassett School","155","162","317"
"0931911","0930011","New Haven School District","Mauro-Sheridan Magnet School","252","344","596"
"0936011","0930011","New Haven School District","Metropolitan Business Academy","86","98","184"
"0937011","0930011","New Haven School District","New Haven Academy","130","109","239"
"0939211","0930011","New Haven School District","Polly T. McCabe Center","26","0","26"
"0939111","0930011","New Haven School District","Riverside Education Academy","91","99","190"
"0934211","0930011","New Haven School District","Roberto Clemente Leadership Academy for Global Awareness","188","195","383"
"0931011","0930011","New Haven School District","Ross/Woodward School","268","268","536"
"0936711","0930011","New Haven School District","Sound School","154","174","328"
"0932811","0930011","New Haven School District","Strong 21st Century Communications Magnet and SCSU Lab School","130","137","267"
"0932911","0930011","New Haven School District","Truman School","279","270","549"
"0939011","0930011","New Haven School District","Urban Youth Center Middle School","9","25","34"
"0934911","0930011","New Haven School District","West Rock Authors Academy","106","124","230"
"0933211","0930011","New Haven School District","Wexler/Grant Community School","248","213","461"
"0936111","0930011","New Haven School District","Wilbur Cross High School","772","848","1620"
"0933811","0930011","New Haven School District","Worthington Hooker School","217","216","433"
"0950311","0950011","New London School District","Jennings School","287","257","544"
"0955111","0950011","New London School District","Bennie Dover Jackson Middle School","265","345","610"
"0950211","0950011","New London School District","Harbor School","130","158","288"
"0950911","0950011","New London School District","Nathan Hale Arts Magnet School","127","146","273"
"0959111","0950011","New London School District","New London Clinical Day Program","7","15","22"
"0956111","0950011","New London School District","New London High School","417","518","935"
"0950511","0950011","New London School District","Shoreline Academy","50","53","103"
"0950811","0950011","New London School District","Winthrop STEM Elementary Magnet School","94","130","224"
"0960511","0960011","New Milford School District","Hill And Plain School","199","250","449"
"0960711","0960011","New Milford School District","John Pettibone School","204","244","448"
"0969011","0960011","New Milford School District","Litchfield Hills Transition Center","*","*","7"
"0966111","0960011","New Milford School District","New Milford High School","782","784","1566"
"0960811","0960011","New Milford School District","Northville Elementary School","261","273","534"
"0960911","0960011","New Milford School District","Sarah Noble Intermediate School","532","554","1086"
"0965211","0960011","New Milford School District","Schaghticoke Middle School","401","373","774"
"0940611","0940011","Newington School District","Anna Reynolds School","213","232","445"
"0940211","0940011","Newington School District","Elizabeth Green School","149","159","308"
"0940811","0940011","Newington School District","John Paterson School","211","279","490"
"0945311","0940011","Newington School District","John Wallace Middle School","386","342","728"
"0945111","0940011","Newington School District","Martin Kellogg Middle School","306","327","633"
"0946111","0940011","Newington School District","Newington High School","706","762","1468"
"0940711","0940011","Newington School District","Ruth Chaffee School","202","193","395"
"0970111","0970011","Newtown School District","Hawley Elementary School","191","229","420"
"0970411","0970011","Newtown School District","Head O'Meadow Elementary School","159","216","375"
"0970311","0970011","Newtown School District","Middle Gate Elementary School","258","237","495"
"0976111","0970011","Newtown School District","Newtown High School","868","863","1731"
"0975111","0970011","Newtown School District","Newtown Middle School","447","449","896"
"0978011","0970011","Newtown School District","Newtown Preschool","37","50","87"
"0970511","0970011","Newtown School District","Reed Intermediate School","403","458","861"
"0970211","0970011","Newtown School District","Sandy Hook Elementary School","291","334","625"
"0980111","0980011","Norfolk School District","Botelle Elementary School","69","68","137"
"0989211","0980011","Norfolk School District","Bridges II","*","*","*"
"0989011","0980011","Norfolk School District","IEP Program","*","*","*"
"0990411","0990011","North Branford School District","Jerome Harrison School","153","174","327"
"0996111","0990011","North Branford School District","North Branford High School","351","335","686"
"0995111","0990011","North Branford School District","North Branford Intermediate School","287","322","609"
"0990511","0990011","North Branford School District","Stanley T. Williams School","135","116","251"
"0990611","0990011","North Branford School District","Totoket Valley Elementary School","245","220","465"
"1000111","1000011","North Canaan School District","North Canaan Elementary School","171","157","328"
"1010811","1010011","North Haven School District","Clintonville Elementary School","175","221","396"
"1010711","1010011","North Haven School District","Green Acres Elementary School","192","201","393"
"1010211","1010011","North Haven School District","Montowese Elementary School","217","198","415"
"1016111","1010011","North Haven School District","North Haven High School","602","579","1181"
"1015211","1010011","North Haven School District","North Haven Middle School","426","446","872"
"1010311","1010011","North Haven School District","Ridge Road Elementary School","208","220","428"
"1020111","1020011","North Stonington School District","North Stonington Elementary School","165","218","383"
"1026111","1020011","North Stonington School District","Wheeler High School","105","121","226"
"1025111","1020011","North Stonington School District","Wheeler Middle School","89","93","182"
"1036211","1030011","Norwalk School District","Brien McMahon High School","874","820","1694"
"1030211","1030011","Norwalk School District","Brookside Elementary School","214","269","483"
"1030311","1030011","Norwalk School District","Columbus Magnet School","188","160","348"
"1030411","1030011","Norwalk School District","Cranbury Elementary School","221","260","481"
"1032011","1030011","Norwalk School District","Fox Run Elementary School","206","254","460"
"1030711","1030011","Norwalk School District","Jefferson Magnet School","255","284","539"
"1030811","1030011","Norwalk School District","Kendall Elementary School","222","261","483"
"1032211","1030011","Norwalk School District","Marvin Elementary School","222","235","457"
"1032111","1030011","Norwalk School District","Naramake Elementary School","219","218","437"
"1035211","1030011","Norwalk School District","Nathan Hale Middle School","290","298","588"
"1036111","1030011","Norwalk School District","Norwalk High School","766","737","1503"
"1036311","1030011","Norwalk School District","Norwalk Pathways Academy at Briggs","35","64","99"
"1035311","1030011","Norwalk School District","Ponus Ridge Middle School","312","374","686"
"1035511","1030011","Norwalk School District","Roton Middle School","207","193","400"
"1031311","1030011","Norwalk School District","Rowayton School","229","239","468"
"1032311","1030011","Norwalk School District","Silvermine Elementary School","171","166","337"
"1031411","1030011","Norwalk School District","Tracey School","192","209","401"
"1035411","1030011","Norwalk School District","West Rocks Middle School","324","339","663"
"1032411","1030011","Norwalk School District","Wolfpit School","156","173","329"
"9016122","9010022","Norwich Free Academy District","Norwich Free Academy","1269","1152","2421"
"1040111","1040011","Norwich School District","Bishop School Early Learning Center","89","84","173"
"1049111","1040011","Norwich School District","Deborah-Tennant Zinewicz  School","10","37","47"
"1040611","1040011","Norwich School District","Greeneville School","157","171","328"
"1049011","1040011","Norwich School District","Hickory Street School","*","*","19"
"1041411","1040011","Norwich School District","John B. Stanton Network School","164","189","353"
"1045111","1040011","Norwich School District","Kelly Middle School","315","316","631"
"1042011","1040011","Norwich School District","Moriarty Magnet School","163","203","366"
"1040811","1040011","Norwich School District","Samuel Huntington School","182","229","411"
"1045211","1040011","Norwich School District","Teachers' Memorial Middle School","282","238","520"
"1046111","1040011","Norwich School District","Thames River Academy","40","45","85"
"1041711","1040011","Norwich School District","Thomas W. Mahan School","173","127","300"
"1041911","1040011","Norwich School District","Uncas Network School","80","89","169"
"1041811","1040011","Norwich School District","Veterans' Memorial School","118","115","233"
"1041511","1040011","Norwich School District","Wequonnoc Magnet School","125","111","236"
"2635113","2630013","Odyssey Community School District","Odyssey Community School","98","82","180"
"1060211","1060011","Old Saybrook School District","Kathleen E. Goodwin School","232","233","465"
"1065211","1060011","Old Saybrook School District","Old Saybrook Middle School","292","306","598"
"1066111","1060011","Old Saybrook School District","Old Saybrook Senior High School","269","259","528"
"1070211","1070011","Orange School District","Mary L. Tracy School","94","92","186"
"1070511","1070011","Orange School District","Peck Place School","213","198","411"
"1070311","1070011","Orange School District","Race Brook School","208","192","400"
"1070411","1070011","Orange School District","Turkey Hill School","140","160","300"
"1085111","1080011","Oxford School District","Great Oak School","253","252","505"
"1080111","1080011","Oxford School District","Oxford Center School","262","274","536"
"1086011","1080011","Oxford School District","Oxford High School","269","296","565"
"1080311","1080011","Oxford School District","Quaker Farms School","273","277","550"
"2835113","2830013","Park City Prep Charter School District","Park City Prep Charter School","116","126","242"
"1090511","1090011","Plainfield School District","Early Childhood Center","127","147","274"
"1090111","1090011","Plainfield School District","Moosup Elementary School","139","156","295"
"1095111","1090011","Plainfield School District","Plainfield Central School","275","298","573"
"1096111","1090011","Plainfield School District","Plainfield High School","433","419","852"
"1090311","1090011","Plainfield School District","Plainfield Memorial School","208","211","419"
"1090411","1090011","Plainfield School District","Shepard Hill Elementary School","157","152","309"
"1100411","1100011","Plainville School District","Frank T. Wheeler School","135","148","283"
"1100211","1100011","Plainville School District","Linden Street School","198","215","413"
"1100511","1100011","Plainville School District","Louis Toffolon School","173","177","350"
"1105211","1100011","Plainville School District","Middle School of Plainville","281","293","574"
"1106111","1100011","Plainville School District","Plainville High School","440","422","862"
"1108011","1100011","Plainville School District","Prekindergarten Program","22","32","54"
"1115111","1110011","Plymouth School District","Eli Terry Jr. Middle School","208","247","455"
"1110411","1110011","Plymouth School District","Harry S. Fisher Elementary School","200","193","393"
"1110211","1110011","Plymouth School District","Plymouth Center School","176","236","412"
"1116111","1110011","Plymouth School District","Terryville High School","256","265","521"
"1120111","1120011","Pomfret School District","Pomfret Community School","274","258","532"
"1130511","1130011","Portland School District","Brownstone Intermediate School","115","122","237"
"1130411","1130011","Portland School District","Gildersleeve School","130","118","248"
"1136111","1130011","Portland School District","Portland High School","173","189","362"
"1135111","1130011","Portland School District","Portland Middle School","116","124","240"
"1130211","1130011","Portland School District","Valley View School","181","168","349"
"1145111","1140011","Preston School District","Preston Plains School","71","77","148"
"1140411","1140011","Preston School District","Preston Veterans' Memorial School","150","134","284"
"1169011","1160011","Putnam School District","Helping Hands","*","*","*"
"1160311","1160011","Putnam School District","Putnam Elementary School","307","337","644"
"1166111","1160011","Putnam School District","Putnam High School","150","177","327"
"1165111","1160011","Putnam School District","Putnam Middle School","106","148","254"
"1175111","1170011","Redding School District","John Read Middle School","314","281","595"
"1170111","1170011","Redding School District","Redding Elementary School","320","350","670"
"2016112","2010012","Regional School District 01","Housatonic Valley Regional High School","252","258","510"
"2045112","2040012","Regional School District 04","John Winthrop Middle School","171","183","354"
"2046112","2040012","Regional School District 04","Valley Regional High School","305","313","618"
"2055112","2050012","Regional School District 05","Amity Middle School: Bethany","193","230","423"
"2055212","2050012","Regional School District 05","Amity Middle School: Orange","211","219","430"
"2056112","2050012","Regional School District 05","Amity Regional High School","784","846","1630"
"2060112","2060012","Regional School District 06","Goshen Center School","113","105","218"
"2060212","2060012","Regional School District 06","James Morris School","100","107","207"
"2068012","2060012","Regional School District 06","Stepping Stones Preschool Program","6","8","14"
"2066112","2060012","Regional School District 06","Wamogo Regional High School","298","238","536"
"2060312","2060012","Regional School District 06","Warren Elementary School","44","52","96"
"2079112","2070012","Regional School District 07","AIM","*","*","13"
"2079012","2070012","Regional School District 07","FLEX","0","*","*"
"2079412","2070012","Regional School District 07","Intensive Learning Program","0","6","6"
"2079212","2070012","Regional School District 07","Links","11","12","23"
"2076112","2070012","Regional School District 07","Northwestern Regional High School","402","355","757"
"2075112","2070012","Regional School District 07","Northwestern Regional Middle School","174","168","342"
"2079312","2070012","Regional School District 07","STEP","8","13","21"
"2086112","2080012","Regional School District 08","RHAM High School","499","586","1085"
"2085112","2080012","Regional School District 08","RHAM Middle School","294","350","644"
"2096112","2090012","Regional School District 09","Joel Barlow High School","496","462","958"
"2105112","2100012","Regional School District 10","Har-Bur Middle School","431","475","906"
"2100312","2100012","Regional School District 10","Harwinton Consolidated School","239","238","477"
"2100212","2100012","Regional School District 10","Lake Garda Elementary School","296","325","621"
"2106112","2100012","Regional School District 10","Lewis S. Mills High School","381","432","813"
"2116112","2110012","Regional School District 11","Parish Hill High School","145","146","291"
"2120212","2120012","Regional School District 12","Booth Free School","58","54","112"
"2128012","2120012","Regional School District 12","Early Childhood Education Center","17","12","29"
"2126112","2120012","Regional School District 12","Shepaug Valley High School","141","182","323"
"2125112","2120012","Regional School District 12","Shepaug Valley Middle School","117","131","248"
"2120112","2120012","Regional School District 12","The Burnham School","37","50","87"
"2120412","2120012","Regional School District 12","Washington Primary School","84","85","169"
"2136112","2130012","Regional School District 13","Coginchaug Regional High School","298","279","577"
"2130212","2130012","Regional School District 13","Francis E. Korn School","89","104","193"
"2135112","2130012","Regional School District 13","Frank Ward Strong School","177","169","346"
"2130112","2130012","Regional School District 13","Frederick Brewster School","110","174","284"
"2130512","2130012","Regional School District 13","John Lyman School","163","160","323"
"2130412","2130012","Regional School District 13","Middlefield Memorial School","173","187","360"
"2140112","2140012","Regional School District 14","Bethlehem Elementary School","175","175","350"
"2148012","2140012","Regional School District 14","Integrated Star Preschool Program","14","15","29"
"2140212","2140012","Regional School District 14","Mitchell Elementary School","213","202","415"
"2146112","2140012","Regional School District 14","Nonnewaug High School","458","384","842"
"2145112","2140012","Regional School District 14","Woodbury Middle School","230","243","473"
"2150412","2150012","Regional School District 15","Gainfield Elementary School","216","230","446"
"2150712","2150012","Regional School District 15","Long Meadow Elementary School","286","322","608"
"2155212","2150012","Regional School District 15","Memorial Middle School","272","260","532"
"2150612","2150012","Regional School District 15","Middlebury Elementary School","202","251","453"
"2156212","2150012","Regional School District 15","Pomperaug Regional High School","687","731","1418"
"2150512","2150012","Regional School District 15","Pomperaug School","227","304","531"
"2155112","2150012","Regional School District 15","Rochambeau Middle School","281","273","554"
"2160312","2160012","Regional School District 16","Algonquin School","230","243","473"
"2160212","2160012","Regional School District 16","Community School","133","93","226"
"2160112","2160012","Regional School District 16","Laurel Ledge School","228","247","475"
"2165112","2160012","Regional School District 16","Long River Middle School","316","306","622"
"2166012","2160012","Regional School District 16","Woodland Regional High School","380","409","789"
"2170212","2170012","Regional School District 17","Burr District Elementary School","150","154","304"
"2170112","2170012","Regional School District 17","Haddam Elementary School","122","146","268"
"2176112","2170012","Regional School District 17","Haddam-Killingworth High School","328","361","689"
"2175112","2170012","Regional School District 17","Haddam-Killingworth Middle School","389","411","800"
"2170312","2170012","Regional School District 17","Killingworth Elementary School","215","225","440"
"2180312","2180012","Regional School District 18","Center School","149","115","264"
"2180112","2180012","Regional School District 18","Lyme Consolidated School","70","75","145"
"2186112","2180012","Regional School District 18","Lyme-Old Lyme High School","227","216","443"
"2185112","2180012","Regional School District 18","Lyme-Old Lyme Middle School","147","178","325"
"2180212","2180012","Regional School District 18","Mile Creek School","143","161","304"
"2196112","2190012","Regional School District 19","E. O. Smith High School","610","583","1193"
"1180811","1180011","Ridgefield School District","Barlow Mountain Elementary School","181","225","406"
"1180611","1180011","Ridgefield School District","Branchville Elementary School","211","214","425"
"1185111","1180011","Ridgefield School District","East Ridge Middle School","346","395","741"
"1180411","1180011","Ridgefield School District","Farmingville Elementary School","180","188","368"
"1180311","1180011","Ridgefield School District","Ridgebury Elementary School","220","202","422"
"1186111","1180011","Ridgefield School District","Ridgefield High School","861","891","1752"
"1180511","1180011","Ridgefield School District","Scotland Elementary School","175","217","392"
"1185211","1180011","Ridgefield School District","Scotts Ridge Middle School","300","310","610"
"1180211","1180011","Ridgefield School District","Veterans Park Elementary School","141","184","325"
"1195111","1190011","Rocky Hill School District","Albert D. Griswold Middle School","338","311","649"
"1190211","1190011","Rocky Hill School District","Dr. Oran A. Moser School","44","39","83"
"1190411","1190011","Rocky Hill School District","Myrtle H. Stevens School","223","278","501"
"1196111","1190011","Rocky Hill School District","Rocky Hill High School","384","397","781"
"1190511","1190011","Rocky Hill School District","West Hill School","323","303","626"
"1210111","1210011","Salem School District","Salem Elementary School","236","254","490"
"1220111","1220011","Salisbury School District","Salisbury Central School","156","155","311"
"1230111","1230011","Scotland School District","Scotland Elementary School","78","83","161"
"1240311","1240011","Seymour School District","Anna L. Lopresti School","145","152","297"
"1240111","1240011","Seymour School District","Bungay School","274","289","563"
"1240411","1240011","Seymour School District","Paul E. Chatfield School","139","152","291"
"1246111","1240011","Seymour School District","Seymour High School","363","341","704"
"1245111","1240011","Seymour School District","Seymour Middle School","278","293","571"
"1250111","1250011","Sharon School District","Sharon Center School","103","102","205"
"1260911","1260011","Shelton School District","Mohegan School","332","313","645"
"1261011","1260011","Shelton School District","Booth Hill School","228","253","481"
"1260511","1260011","Shelton School District","Elizabeth Shelton School","282","308","590"
"1265111","1260011","Shelton School District","Intermediate School","441","432","873"
"1260411","1260011","Shelton School District","Lafayette School","152","168","320"
"1260811","1260011","Shelton School District","Long Hill School","305","295","600"
"1266111","1260011","Shelton School District","Shelton High School","801","830","1631"
"1260611","1260011","Shelton School District","Sunnyside School","139","179","318"
"1270111","1270011","Sherman School District","Sherman School","215","229","444"
"2700113","2700013","Side By Side Charter School District","Side By Side Charter School","115","117","232"
"1280111","1280011","Simsbury School District","Central School","182","209","391"
"1285111","1280011","Simsbury School District","Henry James Memorial School","394","433","827"
"1280611","1280011","Simsbury School District","Latimer Lane School","227","263","490"
"1286111","1280011","Simsbury School District","Simsbury High School","746","835","1581"
"1280711","1280011","Simsbury School District","Squadron Line School","375","406","781"
"1280311","1280011","Simsbury School District","Tariffville School","129","154","283"
"1280411","1280011","Simsbury School District","Tootin' Hills School","232","280","512"
"1295111","1290011","Somers School District","Mabelle B. Avery Middle School","200","214","414"
"1290411","1290011","Somers School District","Somers Elementary School","313","351","664"
"1296111","1290011","Somers School District","Somers High School","281","291","572"
"1320211","1320011","South Windsor School District","Pleasant Valley School","200","236","436"
"1320711","1320011","South Windsor School District","Eli Terry School","204","231","435"
"1320611","1320011","South Windsor School District","Orchard Hill School","225","241","466"
"1320111","1320011","South Windsor School District","Philip R. Smith School","174","186","360"
"1326211","1320011","South Windsor School District","South Windsor High School","734","841","1575"
"1325111","1320011","South Windsor School District","Timothy Edwards School","535","538","1073"
"1320411","1320011","South Windsor School District","Wapping Elementary School","145","164","309"
"1315311","1310011","Southington School District","John F. Kennedy Middle School","382","419","801"
"1311511","1310011","Southington School District","Derynoski Elementary School","369","322","691"
"1311311","1310011","Southington School District","Flanders Elementary School","159","148","307"
"1310211","1310011","Southington School District","Hatton Elementary School","197","242","439"
"1315111","1310011","Southington School District","Joseph A. Depaolo Middle School","372","411","783"
"1310611","1310011","Southington School District","Plantsville Elementary School","99","117","216"
"1310711","1310011","Southington School District","South End Elementary School","103","119","222"
"1316211","1310011","Southington School District","Southington High School","1017","1016","2033"
"1310811","1310011","Southington School District","Strong Elementary School","237","240","477"
"1310911","1310011","Southington School District","Thalberg Elementary School","203","219","422"
"1311411","1310011","Southington School District","Urbin T. Kelley School","199","208","407"
"1330111","1330011","Sprague School District","Sayles School","165","186","351"
"1340611","1340011","Stafford School District","Stafford Elementary School","249","274","523"
"1346111","1340011","Stafford School District","Stafford High School","275","262","537"
"1345211","1340011","Stafford School District","Stafford Middle School","208","199","407"
"1340311","1340011","Stafford School District","Staffordville School","85","96","181"
"1340411","1340011","Stafford School District","West Stafford School","91","100","191"
"2826013","2820013","Stamford Academy District","Stamford Academy","59","72","131"
"1355611","1350011","Stamford School District","Cloonan School","266","315","581"
"1352011","1350011","Stamford School District","Davenport Ridge School","280","253","533"
"1355311","1350011","Stamford School District","Dolan School","297","318","615"
"1352211","1350011","Stamford School District","Hart School","217","264","481"
"1351211","1350011","Stamford School District","Julia A. Stark School","263","295","558"
"1350511","1350011","Stamford School District","K. T. Murphy School","273","251","524"
"1350611","1350011","Stamford School District","Newfield School","303","334","637"
"1351811","1350011","Stamford School District","Northeast School","390","362","752"
"1358011","1350011","Stamford School District","Preschool Team","11","30","41"
"1355811","1350011","Stamford School District","Rippowam Middle School","330","360","690"
"1350811","1350011","Stamford School District","Rogers International School","328","322","650"
"1350911","1350011","Stamford School District","Roxbury School","318","379","697"
"1355711","1350011","Stamford School District","Scofield Middle School","310","307","617"
"1351111","1350011","Stamford School District","Springdale School","264","292","556"
"1356111","1350011","Stamford School District","Stamford High School","846","887","1733"
"1352111","1350011","Stamford School District","Stillmeadow School","302","310","612"
"1356411","1350011","Stamford School District","The Academy of Information Technology","257","422","679"
"1351911","1350011","Stamford School District","Toquam Magnet School","289","293","582"
"1355511","1350011","Stamford School District","Turn of River School","259","280","539"
"1356311","1350011","Stamford School District","Westhill High School","1132","1149","2281"
"1351411","1350011","Stamford School District","Westover School","342","336","678"
"1360311","1360011","Sterling School District","Sterling Community School","235","272","507"
"1370511","1370011","Stonington School District","Deans Mill School","243","262","505"
"1375211","1370011","Stonington School District","Mystic Middle School","210","202","412"
"1375111","1370011","Stonington School District","Pawcatuck Middle School","184","189","373"
"1378011","1370011","Stonington School District","Special Needs Preschool Program","11","11","22"
"1376111","1370011","Stonington School District","Stonington High School","382","411","793"
"1370411","1370011","Stonington School District","West Broad Street School","94","90","184"
"1370611","1370011","Stonington School District","West Vine Street School","115","116","231"
"1381311","1380011","Stratford School District","Eli Whitney School","263","262","525"
"1386211","1380011","Stratford School District","Bunnell High School","629","617","1246"
"1380311","1380011","Stratford School District","Chapel School","264","299","563"
"1385211","1380011","Stratford School District","David Wooster Middle School","278","295","573"
"1380411","1380011","Stratford School District","Franklin School","176","166","342"
"1385311","1380011","Stratford School District","Harry B. Flood Middle School","301","303","604"
"1381611","1380011","Stratford School District","Honeyspot School","115","124","239"
"1380811","1380011","Stratford School District","Lordship School","108","109","217"
"1380911","1380011","Stratford School District","Nichols School","210","227","437"
"1381011","1380011","Stratford School District","Second Hill Lane School","354","369","723"
"1381511","1380011","Stratford School District","Stratford Academy - Johnson House","229","224","453"
"1386111","1380011","Stratford School District","Stratford High School","517","464","981"
"1389011","1380011","Stratford School District","Strive-Stratford","6","11","17"
"1381411","1380011","Stratford School District","Wilcoxson School","192","214","406"
"1390411","1390011","Suffield School District","A. Ward Spaulding School","256","259","515"
"1390311","1390011","Suffield School District","McAlister Intermediate School","281","279","560"
"1396111","1390011","Suffield School District","Suffield High School","446","406","852"
"1395111","1390011","Suffield School District","Suffield Middle School","300","331","631"
"2696113","2690013","The Bridge Academy District","The Bridge Academy","148","115","263"
"9026122","9020022","The Gilbert School District","The Gilbert School","210","171","381"
"1400111","1400011","Thomaston School District","Black Rock School","179","169","348"
"1400211","1400011","Thomaston School District","Thomaston Center School","122","140","262"
"1406211","1400011","Thomaston School District","Thomaston High School","270","288","558"
"1410111","1410011","Thompson School District","Mary R. Fisher Elementary School","247","260","507"
"1415111","1410011","Thompson School District","Thompson Middle School","209","230","439"
"1416111","1410011","Thompson School District","Tourtellotte Memorial High School","194","184","378"
"1420111","1420011","Tolland School District","Birch Grove Primary School","350","358","708"
"1426111","1420011","Tolland School District","Tolland High School","451","490","941"
"1420211","1420011","Tolland School District","Tolland Intermediate School","362","369","731"
"1425111","1420011","Tolland School District","Tolland Middle School","378","394","772"
"1430111","1430011","Torrington School District","East School","230","249","479"
"1430211","1430011","Torrington School District","Forbes School","174","209","383"
"1430811","1430011","Torrington School District","Southwest School","157","174","331"
"1430911","1430011","Torrington School District","Torringford School","304","356","660"
"1436111","1430011","Torrington School District","Torrington High School","566","618","1184"
"1435111","1430011","Torrington School District","Torrington Middle School","529","607","1136"
"1431311","1430011","Torrington School District","Vogel-Wetmore School","221","237","458"
"2785113","2780013","Trailblazers Academy District","Trailblazers Academy","63","102","165"
"1440111","1440011","Trumbull School District","Booth Hill School","265","259","524"
"1440811","1440011","Trumbull School District","Daniels Farm School","253","271","524"
"1441011","1440011","Trumbull School District","Frenchtown Elementary School","302","355","657"
"1445211","1440011","Trumbull School District","Hillcrest Middle School","344","376","720"
"1440411","1440011","Trumbull School District","Jane Ryan School","201","212","413"
"1445111","1440011","Trumbull School District","Madison Middle School","448","451","899"
"1440311","1440011","Trumbull School District","Middlebrook School","225","256","481"
"1440911","1440011","Trumbull School District","Tashua School","202","209","411"
"1448011","1440011","Trumbull School District","Trumbull Early Childhood Education Center","98","138","236"
"1446111","1440011","Trumbull School District","Trumbull High School","1146","1003","2149"
"3361715","3360015","Unified School District #1","Bergin Correctional Institution","0","32","32"
"3360115","3360015","Unified School District #1","Bridgeport Correctional Center","0","8","8"
"3360215","3360015","Unified School District #1","Brooklyn Correctional Institution","0","7","7"
"3360315","3360015","Unified School District #1","Cheshire Correctional Institution","0","27","27"
"3362415","3360015","Unified School District #1","Corrigan/Radgowski Correctional Institution","0","56","56"
"3360415","3360015","Unified School District #1","Enfield Correctional Institution","0","19","19"
"3361915","3360015","Unified School District #1","Garner Correctional Institution","0","20","20"
"3360515","3360015","Unified School District #1","Gates Correctional Institution","0","17","17"
"3360615","3360015","Unified School District #1","Hartford Correctional Center","0","60","60"
"3362215","3360015","Unified School District #1","MacDougall/Walker Correctional Institution","0","77","77"
"3361115","3360015","Unified School District #1","Manson Youth Institution","*","*","498"
"3360915","3360015","Unified School District #1","New Haven Correctional Center","0","16","16"
"3362615","3360015","Unified School District #1","Northern Correctional Institution","0","13","13"
"3361215","3360015","Unified School District #1","Osborn Correctional Institution","0","29","29"
"3361315","3360015","Unified School District #1","Robinson Correctional Institution","0","32","32"
"3361415","3360015","Unified School District #1","Webster Correctional Institution","0","6","6"
"3361515","3360015","Unified School District #1","Willard/Cybulski Correctional Institution","0","12","12"
"3362515","3360015","Unified School District #1","York Correctional Institution","61","0","61"
"3470115","3470015","Unified School District #2","Children's Place School","19","16","35"
"3476515","3470015","Unified School District #2","High Meadows","0","12","12"
"3470315","3470015","Unified School District #2","Riverview School","32","31","63"
"3476715","3470015","Unified School District #2","Walter G. Cady School","*","*","97"
"1450111","1450011","Union School District","Union Elementary School","44","34","78"
"1460311","1460011","Vernon School District","Northeast School","143","138","281"
"1461411","1460011","Vernon School District","Center Road School","257","233","490"
"1460111","1460011","Vernon School District","Lake Street School","145","167","312"
"1460211","1460011","Vernon School District","Maple Street School","152","172","324"
"1469011","1460011","Vernon School District","Next Step Program (AACBP)","*","*","12"
"1466111","1460011","Vernon School District","Rockville High School","587","521","1108"
"1461011","1460011","Vernon School District","Skinner Road School","163","189","352"
"1465111","1460011","Vernon School District","Vernon Center Middle School","383","419","802"
"1470111","1470011","Voluntown School District","Voluntown Elementary School","156","144","300"
"1480211","1480011","Wallingford School District","Highland School","156","152","308"
"1489011","1480011","Wallingford School District","A.R.T.S. Academy","*","*","11"
"1481011","1480011","Wallingford School District","Cook Hill School","185","211","396"
"1485211","1480011","Wallingford School District","Dag Hammarskjold Middle School","354","346","700"
"1480911","1480011","Wallingford School District","Evarts C. Stevens School","216","214","430"
"1485311","1480011","Wallingford School District","James H. Moran Middle School","425","414","839"
"1486111","1480011","Wallingford School District","Lyman Hall High School","635","521","1156"
"1486211","1480011","Wallingford School District","Mark T. Sheehan High School","488","491","979"
"1480111","1480011","Wallingford School District","Moses Y. Beach School","182","174","356"
"1480311","1480011","Wallingford School District","Parker Farms School","184","171","355"
"1481211","1480011","Wallingford School District","Pond Hill School","146","142","288"
"1480411","1480011","Wallingford School District","Rock Hill School","160","168","328"
"1480811","1480011","Wallingford School District","Yalesville School","256","255","511"
"1511011","1510011","Waterbury School District","Brooklyn Elementary School","94","109","203"
"1515211","1510011","Waterbury School District","West Side Middle School","549","644","1193"
"1512311","1510011","Waterbury School District","Washington School","167","143","310"
"1512111","1510011","Waterbury School District","B. W. Tinker School","247","304","551"
"1510311","1510011","Waterbury School District","Barnard School","131","119","250"
"1510511","1510011","Waterbury School District","Bucks Hill School","267","298","565"
"1510611","1510011","Waterbury School District","Bunker Hill School","247","244","491"
"1512711","1510011","Waterbury School District","Carrington School","234","260","494"
"1516211","1510011","Waterbury School District","Crosby High School","632","698","1330"
"1510911","1510011","Waterbury School District","Driggs School","248","299","547"
"1519111","1510011","Waterbury School District","Enlightenment School","75","100","175"
"1511411","1510011","Waterbury School District","F. J. Kingsbury School","235","236","471"
"1512611","1510011","Waterbury School District","Gilmartin School","110","139","249"
"1510711","1510011","Waterbury School District","H. S. Chase School","388","397","785"
"1511311","1510011","Waterbury School District","Hopeville School","216","198","414"
"1516411","1510011","Waterbury School District","John F. Kennedy High School","692","677","1369"
"1513111","1510011","Waterbury School District","Maloney Interdistrict Magnet School","285","322","607"
"1511111","1510011","Waterbury School District","Margaret M. Generali Elementary School","288","295","583"
"1515111","1510011","Waterbury School District","Michael F. Wallace Middle School","655","685","1340"
"1515311","1510011","Waterbury School District","North End Middle School","594","637","1231"
"1512811","1510011","Waterbury School District","Regan School","147","144","291"
"1513311","1510011","Waterbury School District","Rotella Interdistrict Magnet School","316","297","613"
"1518011","1510011","Waterbury School District","Special Education Preschool","78","140","218"
"1512011","1510011","Waterbury School District","Sprague School","240","217","457"
"1519011","1510011","Waterbury School District","State Street School","19","67","86"
"1512211","1510011","Waterbury School District","Walsh School","253","290","543"
"1516011","1510011","Waterbury School District","Waterbury Arts Magnet School (High)","288","197","485"
"1515011","1510011","Waterbury School District","Waterbury Arts Magnet School (Middle)","183","133","316"
"1510811","1510011","Waterbury School District","Wendell L. Cross School","180","187","367"
"1516311","1510011","Waterbury School District","Wilby High School","573","611","1184"
"1513211","1510011","Waterbury School District","Woodrow Wilson School","216","211","427"
"1525111","1520011","Waterford School District","Clark Lane Middle School","314","353","667"
"1520611","1520011","Waterford School District","Oswegatchie Elementary School","207","230","437"
"1520711","1520011","Waterford School District","Quaker Hill Elementary School","183","220","403"
"1520511","1520011","Waterford School District","Southwest Elementary School","191","189","380"
"1526111","1520011","Waterford School District","Waterford High School","479","501","980"
"1530311","1530011","Watertown School District","Fletcher W. Judson School","183","162","345"
"1530211","1530011","Watertown School District","John Trumbull Primary School","351","382","733"
"1530411","1530011","Watertown School District","Polk School","195","195","390"
"1535111","1530011","Watertown School District","Swift Middle School","380","404","784"
"1536111","1530011","Watertown School District","Watertown High School","495","491","986"
"1551711","1550011","West Hartford School District","Smith School","177","191","368"
"1559111","1550011","West Hartford School District","Achieve","*","*","*"
"1551611","1550011","West Hartford School District","Aiken School","218","241","459"
"1550211","1550011","West Hartford School District","Braeburn School","221","217","438"
"1555311","1550011","West Hartford School District","Bristow Middle School","211","209","420"
"1550411","1550011","West Hartford School District","Bugbee School","212","199","411"
"1550511","1550011","West Hartford School District","Charter Oak International Academy","170","170","340"
"1556111","1550011","West Hartford School District","Conard High School","800","764","1564"
"1550611","1550011","West Hartford School District","Duffy School","269","313","582"
"1556211","1550011","West Hartford School District","Hall High School","777","803","1580"
"1555111","1550011","West Hartford School District","King Philip Middle School","424","452","876"
"1550911","1550011","West Hartford School District","Morley School","186","193","379"
"1551011","1550011","West Hartford School District","Norfeldt School","203","224","427"
"1555211","1550011","West Hartford School District","Sedgwick Middle School","443","436","879"
"1559011","1550011","West Hartford School District","WAAVE (W Hartford Applied Academic/Voc'l Experience)","*","*","12"
"1551211","1550011","West Hartford School District","Webster Hill School","233","213","446"
"1551311","1550011","West Hartford School District","Whiting Lane School","220","285","505"
"1551511","1550011","West Hartford School District","Wolcott School","254","243","497"
"1561211","1560011","West Haven School District","Washington School","200","231","431"
"1560811","1560011","West Haven School District","Alma E. Pagels School","174","193","367"
"1561311","1560011","West Haven School District","Anna V. Molloy School","154","132","286"
"1565311","1560011","West Haven School District","Carrigan 5/6 Intermediate School","332","369","701"
"1561011","1560011","West Haven School District","Clarence E. Thompson School","193","190","383"
"1560611","1560011","West Haven School District","Edith E. Mackrille School","187","179","366"
"1560311","1560011","West Haven School District","Forest School","212","249","461"
"1565111","1560011","West Haven School District","Harry M. Bailey Middle School","381","348","729"
"1561411","1560011","West Haven School District","Savin Rock Community School","202","236","438"
"1560411","1560011","West Haven School District","Seth G. Haley School","246","257","503"
"1566111","1560011","West Haven School District","West Haven High School","800","769","1569"
"1540211","1540011","Westbrook School District","Daisy Ingraham School","178","190","368"
"1546111","1540011","Westbrook School District","Westbrook High School","134","166","300"
"1545111","1540011","Westbrook School District","Westbrook Middle School","144","160","304"
"1570111","1570011","Weston School District","Hurlbutt Elementary School","255","273","528"
"1576111","1570011","Weston School District","Weston High School","420","378","798"
"1570211","1570011","Weston School District","Weston Intermediate School","285","341","626"
"1575111","1570011","Weston School District","Weston Middle School","292","308","600"
"1585111","1580011","Westport School District","Bedford Middle School","412","433","845"
"1580311","1580011","Westport School District","Coleytown Elementary School","239","228","467"
"1585311","1580011","Westport School District","Coleytown Middle School","273","219","492"
"1580411","1580011","Westport School District","Green's Farms School","223","244","467"
"1580511","1580011","Westport School District","King's Highway Elementary School","232","251","483"
"1580711","1580011","Westport School District","Long Lots School","278","318","596"
"1580811","1580011","Westport School District","Saugatuck Elementary School","239","286","525"
"1586111","1580011","Westport School District","Staples High School","885","900","1785"
"1588011","1580011","Westport School District","Stepping Stones Preschool","17","39","56"
"1590811","1590011","Wethersfield School District","Alfred W. Hanmer School","182","212","394"
"1591011","1590011","Wethersfield School District","Charles Wright School","166","145","311"
"1590211","1590011","Wethersfield School District","Emerson-Williams School","222","250","472"
"1591111","1590011","Wethersfield School District","Highcrest School","204","226","430"
"1591211","1590011","Wethersfield School District","Samuel B. Webb Elementary School","208","236","444"
"1595211","1590011","Wethersfield School District","Silas Deane Middle School","264","314","578"
"1596111","1590011","Wethersfield School District","Wethersfield High School","587","594","1181"
"1600111","1600011","Willington School District","Center School","104","123","227"
"1605111","1600011","Willington School District","Hall Memorial School","158","157","315"
"1615211","1610011","Wilton School District","Middlebrook School","479","555","1034"
"1610711","1610011","Wilton School District","Cider Mill School","534","490","1024"
"1610611","1610011","Wilton School District","Ina E. Driscoll School","236","264","500"
"1610511","1610011","Wilton School District","Miller-Driscoll School","234","258","492"
"1616111","1610011","Wilton School District","Wilton High School","630","661","1291"
"1620411","1620011","Winchester School District","Batcheller Early Education Center","45","58","103"
"1620211","1620011","Winchester School District","Mary P. Hinsdale School","181","227","408"
"1620511","1620011","Winchester School District","Pearson Academy","95","132","227"
"1625111","1620011","Winchester School District","Pearson Middle School","102","122","224"
"1638011","1630011","Windham School District","Early Headstart","12","18","30"
"1639011","1630011","Windham School District","Eastern Regional Academy/Windham","6","28","34"
"1630111","1630011","Windham School District","Natchaug School","130","139","269"
"1630311","1630011","Windham School District","North Windham School","212","228","440"
"1630611","1630011","Windham School District","W. B. Sweeney School","158","200","358"
"1630511","1630011","Windham School District","Windham Center School","164","151","315"
"1638311","1630011","Windham School District","Windham Early Childhood Prospect Street","82","122","204"
"1636111","1630011","Windham School District","Windham High School","396","469","865"
"1635111","1630011","Windham School District","Windham Middle School","480","471","951"
"1650111","1650011","Windsor Locks School District","North Street School","204","238","442"
"1650411","1650011","Windsor Locks School District","South Elementary School","184","203","387"
"1656111","1650011","Windsor Locks School District","Windsor Locks High School","271","280","551"
"1655111","1650011","Windsor Locks School District","Windsor Locks Middle School","201","221","422"
"1640111","1640011","Windsor School District","Clover Street School","157","129","286"
"1640811","1640011","Windsor School District","John F. Kennedy School","157","176","333"
"1640911","1640011","Windsor School District","Oliver Ellsworth School","198","212","410"
"1640511","1640011","Windsor School District","Poquonock Elementary School","153","145","298"
"1641011","1640011","Windsor School District","Roger Wolcott Early Child Center","102","121","223"
"1645311","1640011","Windsor School District","Sage Park Middle School","401","439","840"
"1646111","1640011","Windsor School District","Windsor High School","661","707","1368"
"1660611","1660011","Wolcott School District","Alcott School","171","195","366"
"1660211","1660011","Wolcott School District","Frisbie School","186","197","383"
"1665111","1660011","Wolcott School District","Tyrrell Middle School","358","369","727"
"1660511","1660011","Wolcott School District","Wakelee School","211","221","432"
"1666111","1660011","Wolcott School District","Wolcott High School","416","427","843"
"1670211","1670011","Woodbridge School District","Beecher Road Intermediate School","210","224","434"
"1670111","1670011","Woodbridge School District","Beecher Road Primary School","151","148","299"
"9036122","9030022","Woodstock Academy District","Woodstock Academy","609","544","1153"
"1690211","1690011","Woodstock School District","Woodstock Elementary School","238","262","500"
"1695111","1690011","Woodstock School District","Woodstock Middle School","193","224","417"

