school_code,district_code,district,school,female,male,total,year
2795113,2790013,Amistad Academy District,Amistad Academy,263,284,547,2007-08
0010111,0010011,Andover School District,Andover Elementary School,151,196,347,2007-08
0026111,0020011,Ansonia School District,Ansonia High School,380,380,760,2007-08
0025111,0020011,Ansonia School District,Ansonia Middle School,290,306,596,2007-08
0020311,0020011,Ansonia School District,Mead School,274,325,599,2007-08
0020811,0020011,Ansonia School District,Prendergast School,364,412,776,2007-08
2449014,2440014,Area Cooperative Educational Services,A. C. E. S. Special Education Town Campus Learning Center,8,11,19,2007-08
2446114,2440014,Area Cooperative Educational Services,Collaborative Alternative Magnet School,40,59,99,2007-08
2449414,2440014,Area Cooperative Educational Services,Mill Road School,33,143,176,2007-08
2445114,2440014,Area Cooperative Educational Services,Thomas Edison Magnet Middle School,368,384,752,2007-08
2449514,2440014,Area Cooperative Educational Services,Village School,45,129,174,2007-08
2449214,2440014,Area Cooperative Educational Services,Whitney High School East,33,92,125,2007-08
2449114,2440014,Area Cooperative Educational Services,Whitney High School North,18,74,92,2007-08
2449314,2440014,Area Cooperative Educational Services,Whitney High School West,21,35,56,2007-08
2440314,2440014,Area Cooperative Educational Services,Wintergreen Interdistrict  Magnet School,306,299,605,2007-08
0030111,0030011,Ashford School District,Ashford School,234,266,500,2007-08
0046111,0040011,Avon School District,Avon High School,511,525,1036,2007-08
0045111,0040011,Avon School District,Avon Middle School,278,304,582,2007-08
0040411,0040011,Avon School District,Pine Grove School,293,325,618,2007-08
0040311,0040011,Avon School District,Roaring Brook School,390,386,776,2007-08
0040511,0040011,Avon School District,Thompson Brook School,313,277,590,2007-08
0050111,0050011,Barkhamsted School District,Barkhamsted Elementary School,146,182,328,2007-08
0058011,0050011,Barkhamsted School District,Shared Services Integrated Preschool,12,18,30,2007-08
0076111,0070011,Berlin School District,Berlin High School,498,565,1063,2007-08
0075111,0070011,Berlin School District,Catherine M. McGee Middle School,390,388,778,2007-08
0070411,0070011,Berlin School District,Emma Hart Willard School,252,325,577,2007-08
0070511,0070011,Berlin School District,Mary E. Griswold School,273,316,589,2007-08
0070111,0070011,Berlin School District,Richard D. Hubbard School,112,151,263,2007-08
0080111,0080011,Bethany School District,Bethany Community School,269,300,569,2007-08
0090411,0090011,Bethel School District,Anna H. Rockwell School,200,225,425,2007-08
0096111,0090011,Bethel School District,Bethel High School,523,511,1034,2007-08
0095111,0090011,Bethel School District,Bethel Middle School,365,378,743,2007-08
0090111,0090011,Bethel School District,Frank A. Berry School,226,262,488,2007-08
0090511,0090011,Bethel School District,Ralph M. T. Johnson School,222,232,454,2007-08
0116111,0110011,Bloomfield School District,Bloomfield High School,307,318,625,2007-08
0110711,0110011,Bloomfield School District,Carmen Arace Intermediate School,177,171,348,2007-08
0115211,0110011,Bloomfield School District,Carmen Arace Middle School,167,175,342,2007-08
0110311,0110011,Bloomfield School District,J. P. Vincent School,138,177,315,2007-08
0110611,0110011,Bloomfield School District,Laurel School,116,152,268,2007-08
0110511,0110011,Bloomfield School District,Metacomet School,113,125,238,2007-08
0116211,0110011,Bloomfield School District,The Big Picture High School,51,28,79,2007-08
0120111,0120011,Bolton School District,Bolton Center School,297,300,597,2007-08
0126111,0120011,Bolton School District,Bolton High School,147,128,275,2007-08
0130111,0130011,Bozrah School District,Fields Memorial School,144,120,264,2007-08
0146111,0140011,Branford School District,Branford High School,577,569,1146,2007-08
0145111,0140011,Branford School District,Francis Walsh Intermediate School,554,528,1082,2007-08
0148011,0140011,Branford School District,Indian Neck School,18,40,58,2007-08
0141611,0140011,Branford School District,John B. Sliney School,170,175,345,2007-08
0141511,0140011,Branford School District,Mary R. Tisko School,213,217,430,2007-08
0141411,0140011,Branford School District,Mary T. Murphy School,189,227,416,2007-08
2850113,2850013,Bridgeport Achievement First District,Achievement First Bridgeport Academy,46,39,85,2007-08
0150111,0150011,Bridgeport School District,Barnum School,135,144,279,2007-08
0156111,0150011,Bridgeport School District,Bassick High School,599,686,1285,2007-08
0150211,0150011,Bridgeport School District,Beardsley School,311,296,607,2007-08
0150311,0150011,Bridgeport School District,Black Rock School,123,149,272,2007-08
0154011,0150011,Bridgeport School District,Blackham School,554,623,1177,2007-08
0159011,0150011,Bridgeport School District,Bridgeport Learning Center,15,39,54,2007-08
0150411,0150011,Bridgeport School District,Bryant School,205,208,413,2007-08
0156211,0150011,Bridgeport School District,Central High School,1192,1147,2339,2007-08
0151411,0150011,Bridgeport School District,Cesar Batalla School,558,604,1162,2007-08
0152111,0150011,Bridgeport School District,Classical Studies Academy,195,180,375,2007-08
0150511,0150011,Bridgeport School District,Columbus School,370,393,763,2007-08
0153911,0150011,Bridgeport School District,Cross School,194,212,406,2007-08
0154211,0150011,Bridgeport School District,Curiale School,278,314,592,2007-08
0154111,0150011,Bridgeport School District,Dunbar School,186,177,363,2007-08
0150711,0150011,Bridgeport School District,Edison School,198,210,408,2007-08
0150911,0150011,Bridgeport School District,Garfield School,139,139,278,2007-08
0153211,0150011,Bridgeport School District,Geraldine Johnson School,88,108,196,2007-08
0151111,0150011,Bridgeport School District,Hall School,160,184,344,2007-08
0151211,0150011,Bridgeport School District,Hallen School,152,170,322,2007-08
0156311,0150011,Bridgeport School District,Harding High School,832,890,1722,2007-08
0154511,0150011,Bridgeport School District,High Horizons Magnet School,230,214,444,2007-08
0151311,0150011,Bridgeport School District,Hooker School,204,246,450,2007-08
0152211,0150011,Bridgeport School District,Jettie S. Tisdale School,173,156,329,2007-08
0151911,0150011,Bridgeport School District,Longfellow School,239,236,475,2007-08
0151011,0150011,Bridgeport School District,Luis Munoz Marin School,425,421,846,2007-08
0152011,0150011,Bridgeport School District,Madison School,247,315,562,2007-08
0159511,0150011,Bridgeport School District,Make The Grade,9,28,37,2007-08
0154311,0150011,Bridgeport School District,Maplewood Annex,65,122,187,2007-08
0154611,0150011,Bridgeport School District,Multicultural Magnet School,259,216,475,2007-08
0159411,0150011,Bridgeport School District,New Start Program,*,*,14,2007-08
0159211,0150011,Bridgeport School District,Park City Academy,6,24,30,2007-08
0151711,0150011,Bridgeport School District,Park City Magnet School,249,252,501,2007-08
0152511,0150011,Bridgeport School District,Read School,420,484,904,2007-08
0152611,0150011,Bridgeport School District,Roosevelt School,340,387,727,2007-08
0154411,0150011,Bridgeport School District,Skane Center,93,126,219,2007-08
0159111,0150011,Bridgeport School District,The University School,19,27,46,2007-08
0153011,0150011,Bridgeport School District,Waltersville School,221,235,456,2007-08
0153611,0150011,Bridgeport School District,Winthrop School,378,380,758,2007-08
0179011,0170011,Bristol School District,Alternative Special Education Program (ASEP),*,*,23,2007-08
0176111,0170011,Bristol School District,Bristol Central High School,697,768,1465,2007-08
0176211,0170011,Bristol School District,Bristol Eastern High School,682,651,1333,2007-08
0175111,0170011,Bristol School District,Chippens Hill Middle School,452,477,929,2007-08
0170711,0170011,Bristol School District,Clara T. O'Connell School,183,172,355,2007-08
0170111,0170011,Bristol School District,Clarence A. Bingham School,116,137,253,2007-08
0170311,0170011,Bristol School District,Edgewood School,158,198,356,2007-08
0171411,0170011,Bristol School District,Ellen P. Hubbell School,246,244,490,2007-08
0170511,0170011,Bristol School District,Greene-Hills School,176,220,396,2007-08
0171911,0170011,Bristol School District,Ivy Drive School,189,213,402,2007-08
0170611,0170011,Bristol School District,John J. Jennings School,191,183,374,2007-08
0175311,0170011,Bristol School District,Memorial Boulevard Middle School,258,284,542,2007-08
0171711,0170011,Bristol School District,Mountain View School,167,202,369,2007-08
0175211,0170011,Bristol School District,Northeast Middle School,263,295,558,2007-08
0171111,0170011,Bristol School District,South Side School,266,314,580,2007-08
0171211,0170011,Bristol School District,Stafford School,249,248,497,2007-08
0186111,0180011,Brookfield School District,Brookfield High School,482,538,1020,2007-08
0180311,0180011,Brookfield School District,Center Elementary School,188,186,374,2007-08
0180411,0180011,Brookfield School District,Huckleberry Hill Elementary School,307,297,604,2007-08
0185311,0180011,Brookfield School District,Whisconier Middle School,486,465,951,2007-08
0190111,0190011,Brooklyn School District,Brooklyn Elementary School,281,299,580,2007-08
0195111,0190011,Brooklyn School District,Brooklyn Middle School,202,204,406,2007-08
0210111,0210011,Canaan School District,Lee H. Kellogg School,57,44,101,2007-08
0220211,0220011,Canterbury School District,Canterbury Elementary School,135,181,316,2007-08
0225111,0220011,Canterbury School District,Dr. Helen Baldwin Middle School,110,152,262,2007-08
0236111,0230011,Canton School District,Canton High School,246,268,514,2007-08
0230311,0230011,Canton School District,Canton Intermediate School,196,209,405,2007-08
0235111,0230011,Canton School District,Canton Middle School,134,136,270,2007-08
0230211,0230011,Canton School District,Cherry Brook Primary School,283,255,538,2007-08
2410114,2410014,Capitol Region Education Council,Glastonbury/East Hartford Magnet School,129,128,257,2007-08
2416314,2410014,Capitol Region Education Council,Great Path Academy at MCC,73,38,111,2007-08
2416414,2410014,Capitol Region Education Council,Greater Hartford Academy of  the Arts High School - Full Time,28,15,43,2007-08
2419014,2410014,Capitol Region Education Council,John J. Allison Polaris Center,129,260,389,2007-08
2416114,2410014,Capitol Region Education Council,Metropolitan Learning Center for Global and International Studies,353,323,676,2007-08
2413114,2410014,Capitol Region Education Council,Montessori Magnet School,174,155,329,2007-08
2415014,2410014,Capitol Region Education Council,Two Rivers Magnet Middle School,288,294,582,2007-08
2410214,2410014,Capitol Region Education Council,University of Hartford Magnet School,207,199,406,2007-08
0240211,0240011,Chaplin School District,Chaplin Elementary School,100,110,210,2007-08
0250111,0250011,Cheshire School District,Chapman School,172,160,332,2007-08
0256111,0250011,Cheshire School District,Cheshire High School,777,835,1612,2007-08
0250211,0250011,Cheshire School District,Darcey School,191,202,393,2007-08
0255111,0250011,Cheshire School District,Dodd Middle School,388,436,824,2007-08
0250611,0250011,Cheshire School District,Doolittle School,250,287,537,2007-08
0250411,0250011,Cheshire School District,Highland School,434,474,908,2007-08
0259011,0250011,Cheshire School District,Humiston School,11,12,23,2007-08
0250511,0250011,Cheshire School District,Norton School,258,235,493,2007-08
0260111,0260011,Chester School District,Chester Elementary School,175,166,341,2007-08
0270111,0270011,Clinton School District,Abraham Pierson School,164,174,338,2007-08
0275111,0270011,Clinton School District,Jared Eliot School,218,244,462,2007-08
0270311,0270011,Clinton School District,Lewin G. Joel Jr. School,350,317,667,2007-08
0276111,0270011,Clinton School District,The Morgan School,333,305,638,2007-08
0286111,0280011,Colchester School District,Bacon Academy,460,522,982,2007-08
0280411,0280011,Colchester School District,Colchester Elementary School,376,398,774,2007-08
0280211,0280011,Colchester School District,Jack Jackter Intermediate School,347,334,681,2007-08
0285111,0280011,Colchester School District,William J. Johnston Middle School,429,372,801,2007-08
0290111,0290011,Colebrook School District,Colebrook Consolidated School,66,56,122,2007-08
0300111,0300011,Columbia School District,Horace W. Porter School,293,293,586,2007-08
2686113,2680013,Common Ground High School District,Common Ground High School,78,74,152,2007-08
9001516,9000016,Connecticut Technical High School System,A. I. Prince Technical High School,316,265,581,2007-08
9001116,9000016,Connecticut Technical High School System,Bullard-Havens Technical High School,444,434,878,2007-08
9001916,9000016,Connecticut Technical High School System,E. C. Goodwin Technical High School,193,268,461,2007-08
9001416,9000016,Connecticut Technical High School System,Eli Whitney Technical High School,268,261,529,2007-08
9002716,9000016,Connecticut Technical High School System,Ella T. Grasso Southeastern Technical High School,246,343,589,2007-08
9002516,9000016,Connecticut Technical High School System,Emmett O'Brien Technical High School,176,354,530,2007-08
9001716,9000016,Connecticut Technical High School System,H. C. Wilcox Technical High School,256,440,696,2007-08
9001316,9000016,Connecticut Technical High School System,H. H. Ellis Technical High School,156,407,563,2007-08
9001216,9000016,Connecticut Technical High School System,Henry Abbott Technical High School,176,394,570,2007-08
9001616,9000016,Connecticut Technical High School System,Howell Cheney Technical High School,84,480,564,2007-08
9002116,9000016,Connecticut Technical High School System,J. M. Wright Technical High School,105,150,255,2007-08
9002016,9000016,Connecticut Technical High School System,Norwich Technical High School,116,294,410,2007-08
9002216,9000016,Connecticut Technical High School System,Oliver Wolcott Technical High School,237,483,720,2007-08
9002616,9000016,Connecticut Technical High School System,Platt Technical High School,258,595,853,2007-08
9001816,9000016,Connecticut Technical High School System,Vinal Technical High School,158,429,587,2007-08
9002316,9000016,Connecticut Technical High School System,W. F. Kaynor Technical High School,268,436,704,2007-08
9002416,9000016,Connecticut Technical High School System,Windham Technical High School,167,316,483,2007-08
2439014,2430014,Cooperative Educational Services,C. E. S. Special Education,56,184,240,2007-08
2430114,2430014,Cooperative Educational Services,Six-Six Magnet School,231,204,435,2007-08
0310111,0310011,Cornwall School District,Cornwall Consolidated School,63,66,129,2007-08
0325111,0320011,Coventry School District,Capt. Nathan Hale School,261,278,539,2007-08
0328011,0320011,Coventry School District,Coventry Early Intervention Services,*,*,11,2007-08
0320211,0320011,Coventry School District,Coventry Grammar School,191,234,425,2007-08
0326111,0320011,Coventry School District,Coventry High School,272,287,559,2007-08
0320411,0320011,Coventry School District,George Hersey Robertson School,240,234,474,2007-08
0336111,0330011,Cromwell School District,Cromwell High School,298,261,559,2007-08
0335111,0330011,Cromwell School District,Cromwell Middle School,245,228,473,2007-08
0330211,0330011,Cromwell School District,Edna C. Stevens School,227,258,485,2007-08
0330311,0330011,Cromwell School District,Woodside Intermediate School,214,258,472,2007-08
0346211,0340011,Danbury School District,Alternative Center For Excellence,56,41,97,2007-08
0345111,0340011,Danbury School District,Broadview Middle School,555,589,1144,2007-08
0346111,0340011,Danbury School District,Danbury High School,1443,1392,2835,2007-08
0341411,0340011,Danbury School District,Ellsworth Avenue School,171,162,333,2007-08
0341111,0340011,Danbury School District,Great Plain School,153,162,315,2007-08
0340211,0340011,Danbury School District,Hayestown Avenue School,180,220,400,2007-08
0341711,0340011,Danbury School District,King Street Intermediate School,157,160,317,2007-08
0341311,0340011,Danbury School District,King Street Primary School,142,152,294,2007-08
0341811,0340011,Danbury School District,Mill Ridge Educational Center,148,199,347,2007-08
0340511,0340011,Danbury School District,Mill Ridge Primary School,148,150,298,2007-08
0340611,0340011,Danbury School District,Morris Street School,148,195,343,2007-08
0340811,0340011,Danbury School District,Park Avenue School,199,177,376,2007-08
0341511,0340011,Danbury School District,Pembroke School,151,185,336,2007-08
0345211,0340011,Danbury School District,Rogers Park Middle School,483,548,1031,2007-08
0341211,0340011,Danbury School District,Shelter Rock School,164,174,338,2007-08
0341011,0340011,Danbury School District,South Street School,166,140,306,2007-08
0341611,0340011,Danbury School District,Stadley Rough School,223,232,455,2007-08
0341911,0340011,Danbury School District,Western CT Academy of International Studies Elementary Magnet School,161,156,317,2007-08
0356111,0350011,Darien School District,Darien High School,601,579,1180,2007-08
0350211,0350011,Darien School District,Hindley Elementary School,257,262,519,2007-08
0350711,0350011,Darien School District,Holmes Elementary School,237,247,484,2007-08
0355111,0350011,Darien School District,Middlesex Middle School,547,570,1117,2007-08
0351311,0350011,Darien School District,Ox Ridge Elementary School,252,260,512,2007-08
0350511,0350011,Darien School District,Royle Elementary School,193,258,451,2007-08
0350611,0350011,Darien School District,Tokeneke Elementary School,169,221,390,2007-08
0360111,0360011,Deep River School District,Deep River Elementary School,192,197,389,2007-08
3370315,3370015,Department of Mental Health and Addiction Services,Cedarcrest Regional Hosp - Blue Hills Hosp. Substance Ab,*,*,7,2007-08
3370415,3370015,Department of Mental Health and Addiction Services,Connecticut Mental Health Center,*,*,*,2007-08
3370215,3370015,Department of Mental Health and Addiction Services,Connecticut Valley Hospital,0,*,*,2007-08
3370515,3370015,Department of Mental Health and Addiction Services,Greater Bridgeport Community Mental Health Center,0,*,*,2007-08
0370611,0370011,Derby School District,Bradley School,183,181,364,2007-08
0376111,0370011,Derby School District,Derby High School,313,356,669,2007-08
0370411,0370011,Derby School District,Irving School,199,218,417,2007-08
0400111,0400011,East Granby School District,Allgrove School,157,137,294,2007-08
0406111,0400011,East Granby School District,East Granby High School,125,133,258,2007-08
0405111,0400011,East Granby School District,East Granby Middle School,96,122,218,2007-08
0400211,0400011,East Granby School District,R. Dudley Seymour School,71,70,141,2007-08
0410111,0410011,East Haddam School District,East Haddam Elementary School,260,276,536,2007-08
0416111,0410011,East Haddam School District,Nathan Hale-Ray High School,207,199,406,2007-08
0415111,0410011,East Haddam School District,Nathan Hale-Ray Middle School,236,241,477,2007-08
0420311,0420011,East Hampton School District,Center School,182,167,349,2007-08
0426111,0420011,East Hampton School District,East Hampton High School,308,272,580,2007-08
0425111,0420011,East Hampton School District,East Hampton Middle School,238,270,508,2007-08
0420111,0420011,East Hampton School District,Memorial School,293,340,633,2007-08
0430911,0430011,East Hartford School District,Anna E. Norris School,132,166,298,2007-08
0436311,0430011,East Hartford School District,Connecticut IB Academy,111,55,166,2007-08
0430611,0430011,East Hartford School District,Dr. Franklin H. Mayberry School,197,211,408,2007-08
0432211,0430011,East Hartford School District,Dr. John A. Langford School,176,171,347,2007-08
0431011,0430011,East Hartford School District,Dr. Thomas S. O'Connell School,165,149,314,2007-08
0436211,0430011,East Hartford School District,East Hartford High School,991,1031,2022,2007-08
0435111,0430011,East Hartford School District,East Hartford Middle School,459,543,1002,2007-08
0432011,0430011,East Hartford School District,Governor William Pitkin School,176,176,352,2007-08
0430511,0430011,East Hartford School District,Hockanum School,167,187,354,2007-08
0430411,0430011,East Hartford School District,Joseph O. Goodwin School,159,161,320,2007-08
0431811,0430011,East Hartford School District,Robert J. O'Brien School,235,229,464,2007-08
0431211,0430011,East Hartford School District,Silver Lane School,149,174,323,2007-08
0436411,0430011,East Hartford School District,Stevens Alternate High School,61,90,151,2007-08
0432411,0430011,East Hartford School District,Sunset Ridge Middle School,206,246,452,2007-08
0438011,0430011,East Hartford School District,Willowbrook Early Childhood,119,169,288,2007-08
0439011,0430011,East Hartford School District,Woodland School,25,155,180,2007-08
0441711,0440011,East Haven School District,Carbone School/East Haven Academy,119,102,221,2007-08
0441411,0440011,East Haven School District,D. C. Moore School,117,122,239,2007-08
0440111,0440011,East Haven School District,Deer Run School,159,176,335,2007-08
0441311,0440011,East Haven School District,Dominick H. Ferrara School,89,97,186,2007-08
0446111,0440011,East Haven School District,East Haven High School,551,546,1097,2007-08
0441011,0440011,East Haven School District,Grove J. Tuttle School,103,109,212,2007-08
0441911,0440011,East Haven School District,Hays School,76,102,178,2007-08
0445111,0440011,East Haven School District,Joseph Melillo Middle School,236,246,482,2007-08
0440711,0440011,East Haven School District,Momauguin School,81,128,209,2007-08
0441811,0440011,East Haven School District,Overbrook Elementary School,71,94,165,2007-08
0449011,0440011,East Haven School District,Pathways,12,23,35,2007-08
0441611,0440011,East Haven School District,Robert W. Carbone School,164,155,319,2007-08
0456111,0450011,East Lyme School District,East Lyme High School,676,628,1304,2007-08
0455111,0450011,East Lyme School District,East Lyme Middle School,448,465,913,2007-08
0450111,0450011,East Lyme School District,Flanders School,197,202,399,2007-08
0458011,0450011,East Lyme School District,Integrated Preschool,23,30,53,2007-08
0450411,0450011,East Lyme School District,Lillie B. Haynes School,172,168,340,2007-08
0450211,0450011,East Lyme School District,Niantic Center School,125,116,241,2007-08
0470111,0470011,East Windsor School District,Broad Brook Elementary School,302,318,620,2007-08
0476111,0470011,East Windsor School District,East Windsor High School,224,232,456,2007-08
0475411,0470011,East Windsor School District,East Windsor Middle School,183,217,400,2007-08
2536014,2530014,Eastern Connecticut Regional Educational Service Center (EASTCONN),Arts at the Capitol Theater Magnet School (ACT),*,*,20,2007-08
2539014,2530014,Eastern Connecticut Regional Educational Service Center (EASTCONN),EastConn Special Education,7,37,44,2007-08
0390111,0390011,Eastford School District,Eastford Elementary School,89,98,187,2007-08
0465111,0460011,Easton School District,Helen Keller Middle School,206,171,377,2007-08
0460111,0460011,Easton School District,Samuel Staples Elementary School,355,446,801,2007-08
2428014,2420014,EdAdvance,EdAdvance Headstart,71,85,156,2007-08
2429014,2420014,EdAdvance,The ACCESS School at The Danuta M. Thibodeau Education Center,9,14,23,2007-08
0480111,0480011,Ellington School District,Center School,208,200,408,2007-08
0480211,0480011,Ellington School District,Crystal Lake School,106,101,207,2007-08
0486111,0480011,Ellington School District,Ellington High School,371,399,770,2007-08
0485111,0480011,Ellington School District,Ellington Middle School,207,201,408,2007-08
0480711,0480011,Ellington School District,Windermere Intermediate School,197,204,401,2007-08
0480611,0480011,Ellington School District,Windermere School,201,203,404,2007-08
2810113,2810013,Elm City College Preparatory School,Elm City College Preparatory School,239,237,476,2007-08
0491311,0490011,Enfield School District,Edgar H. Parkman School,170,193,363,2007-08
0491611,0490011,Enfield School District,Eli Whitney School,166,221,387,2007-08
0496111,0490011,Enfield School District,Enfield High School,446,480,926,2007-08
0490211,0490011,Enfield School District,Enfield Street School,159,174,333,2007-08
0496211,0490011,Enfield School District,Enrico Fermi High School,589,567,1156,2007-08
0491211,0490011,Enfield School District,Harriet Beecher Stowe School,148,134,282,2007-08
0490411,0490011,Enfield School District,Hazardville Memorial School,195,218,413,2007-08
0498011,0490011,Enfield School District,Head Start Program,44,60,104,2007-08
0491811,0490011,Enfield School District,Henry Barnard School,193,236,429,2007-08
0495211,0490011,Enfield School District,John F. Kennedy Middle School,489,503,992,2007-08
0491111,0490011,Enfield School District,Nathan Hale School,124,148,272,2007-08
0491511,0490011,Enfield School District,Prudence Crandall School,209,207,416,2007-08
0491711,0490011,Enfield School District,Thomas G. Alcorn School,145,138,283,2007-08
0500111,0500011,Essex School District,Essex Elementary School,271,280,551,2007-08
2726113,2720013,Explorations District,Explorations,47,39,86,2007-08
0510211,0510011,Fairfield School District,Burr Elementary School,218,227,445,2007-08
0510111,0510011,Fairfield School District,Dwight Elementary School,180,160,340,2007-08
0518011,0510011,Fairfield School District,Early Childhood Center,33,88,121,2007-08
0516011,0510011,Fairfield School District,Fairfield Ludlowe High School,720,660,1380,2007-08
0516211,0510011,Fairfield School District,Fairfield Warde High School,637,594,1231,2007-08
0515211,0510011,Fairfield School District,Fairfield Woods Middle School,299,298,597,2007-08
0510411,0510011,Fairfield School District,Holland Hill School,191,167,358,2007-08
0511711,0510011,Fairfield School District,Jennings School,167,186,353,2007-08
0510611,0510011,Fairfield School District,McKinley School,214,248,462,2007-08
0510711,0510011,Fairfield School District,Mill Hill School,224,241,465,2007-08
0511611,0510011,Fairfield School District,North Stratfield School,231,264,495,2007-08
0511811,0510011,Fairfield School District,Osborn Hill School,250,269,519,2007-08
0511211,0510011,Fairfield School District,Riverfield School,225,248,473,2007-08
0515311,0510011,Fairfield School District,Roger Ludlowe Middle School,442,445,887,2007-08
0511311,0510011,Fairfield School District,Sherman School,210,243,453,2007-08
0511411,0510011,Fairfield School District,Stratfield School,233,227,460,2007-08
0515111,0510011,Fairfield School District,Tomlinson Middle School,373,364,737,2007-08
0520411,0520011,Farmington School District,East Farms School,200,230,430,2007-08
0528011,0520011,Farmington School District,Farmington Collaborative PK,21,36,57,2007-08
0526111,0520011,Farmington School District,Farmington High School,670,719,1389,2007-08
0525111,0520011,Farmington School District,Irving A. Robbins Middle School,328,324,652,2007-08
0520211,0520011,Farmington School District,Noah Wallace School,163,167,330,2007-08
0520111,0520011,Farmington School District,Union School,143,155,298,2007-08
0520311,0520011,Farmington School District,West District School,169,181,350,2007-08
0520511,0520011,Farmington School District,West Woods Upper Elementary School,315,372,687,2007-08
0530111,0530011,Franklin School District,Franklin Elementary School,112,121,233,2007-08
0540211,0540011,Glastonbury School District,Buttonball Lane School,299,276,575,2007-08
0540311,0540011,Glastonbury School District,Eastbury School,172,185,357,2007-08
0540811,0540011,Glastonbury School District,Gideon Welles School,277,274,551,2007-08
0546111,0540011,Glastonbury School District,Glastonbury High School,1036,1029,2065,2007-08
0540411,0540011,Glastonbury School District,Hebron Avenue School,275,250,525,2007-08
0540611,0540011,Glastonbury School District,Hopewell School,258,284,542,2007-08
0540711,0540011,Glastonbury School District,Naubuc School,232,249,481,2007-08
0540911,0540011,Glastonbury School District,Nayaug Elementary School,338,337,675,2007-08
0545211,0540011,Glastonbury School District,Smith Middle School,529,541,1070,2007-08
0560111,0560011,Granby School District,Frank M. Kearns Primary School,229,268,497,2007-08
0566111,0560011,Granby School District,Granby Memorial High School,333,416,749,2007-08
0565111,0560011,Granby School District,Granby Memorial Middle School,192,182,374,2007-08
0560411,0560011,Granby School District,Kelly Lane Primary School,173,190,363,2007-08
0560311,0560011,Granby School District,Wells Road Intermediate School,172,172,344,2007-08
0575111,0570011,Greenwich School District,Central Middle School,330,383,713,2007-08
0570211,0570011,Greenwich School District,Cos Cob School,203,204,407,2007-08
0575211,0570011,Greenwich School District,Eastern Middle School,341,384,725,2007-08
0570411,0570011,Greenwich School District,Glenville School,162,182,344,2007-08
0576111,0570011,Greenwich School District,Greenwich High School,1292,1401,2693,2007-08
0570511,0570011,Greenwich School District,Hamilton Avenue School,179,198,377,2007-08
0571311,0570011,Greenwich School District,International School At Dundee,185,187,372,2007-08
0570311,0570011,Greenwich School District,Julian Curtiss School,154,173,327,2007-08
0570611,0570011,Greenwich School District,New Lebanon School,116,113,229,2007-08
0570711,0570011,Greenwich School District,North Mianus School,242,212,454,2007-08
0570811,0570011,Greenwich School District,North Street School,235,280,515,2007-08
0570911,0570011,Greenwich School District,Old Greenwich School,237,217,454,2007-08
0571111,0570011,Greenwich School District,Parkway School,144,188,332,2007-08
0571011,0570011,Greenwich School District,Riverside School,215,284,499,2007-08
0575311,0570011,Greenwich School District,Western Middle School,255,272,527,2007-08
0580311,0580011,Griswold School District,Griswold Elementary School,438,468,906,2007-08
0586211,0580011,Griswold School District,Griswold High School,414,378,792,2007-08
0585111,0580011,Griswold School District,Griswold Middle School,206,233,439,2007-08
0595311,0590011,Groton School District,Carl C. Cutler Middle School,183,193,376,2007-08
0591811,0590011,Groton School District,Charles Barnum School,178,189,367,2007-08
0590311,0590011,Groton School District,Claude Chester School,168,185,353,2007-08
0590411,0590011,Groton School District,Colonel Ledyard School,72,67,139,2007-08
0590511,0590011,Groton School District,Eastern Point School,244,254,498,2007-08
0595111,0590011,Groton School District,Fitch Middle School,234,221,455,2007-08
0591711,0590011,Groton School District,Mary Morrisson School,129,153,282,2007-08
0590911,0590011,Groton School District,Noank School,118,122,240,2007-08
0591211,0590011,Groton School District,Pleasant Valley School,224,205,429,2007-08
0596111,0590011,Groton School District,Robert E. Fitch High School,730,684,1414,2007-08
0590111,0590011,Groton School District,S. B. Butler School,156,161,317,2007-08
0595211,0590011,Groton School District,West Side Middle School,156,137,293,2007-08
0600711,0600011,Guilford School District,A. Baldwin Middle School,304,304,608,2007-08
0600611,0600011,Guilford School District,A. W. Cox School,172,175,347,2007-08
0600411,0600011,Guilford School District,Calvin Leete School,155,152,307,2007-08
0605111,0600011,Guilford School District,E. C. Adams Middle School,291,309,600,2007-08
0606111,0600011,Guilford School District,Guilford High School,597,557,1154,2007-08
0600211,0600011,Guilford School District,Guilford Lakes School,195,254,449,2007-08
0600311,0600011,Guilford School District,Melissa Jones School,171,179,350,2007-08
0628011,0620011,Hamden School District,Alice Peck Learning Center,36,60,96,2007-08
0621211,0620011,Hamden School District,Bear Path School,221,243,464,2007-08
0620211,0620011,Hamden School District,Church Street School,179,203,382,2007-08
0620311,0620011,Hamden School District,Dunbar Hill School,176,201,377,2007-08
0626111,0620011,Hamden School District,Hamden High School,1068,1124,2192,2007-08
0625211,0620011,Hamden School District,Hamden Middle School,432,481,913,2007-08
0629011,0620011,Hamden School District,Hamden Transition Academy,0,*,*,2007-08
0620411,0620011,Hamden School District,Helen Street School,148,195,343,2007-08
0621111,0620011,Hamden School District,Ridge Hill School,169,179,348,2007-08
0620111,0620011,Hamden School District,Shepherd Glen School,162,168,330,2007-08
0621011,0620011,Hamden School District,Spring Glen School,141,178,319,2007-08
0621411,0620011,Hamden School District,West Woods School,228,267,495,2007-08
0630111,0630011,Hampton School District,Hampton Elementary School,77,89,166,2007-08
0640711,0640011,Hartford School District,Asian Studies Academy at Bellizzi School,205,229,434,2007-08
0640311,0640011,Hartford School District,Barnard-Brown School,162,171,333,2007-08
0640411,0640011,Hartford School District,Batchelder School,277,301,578,2007-08
0642811,0640011,Hartford School District,Betances Early Reading Lab Magnet School,190,213,403,2007-08
0643311,0640011,Hartford School District,Breakthrough Magnet School,162,158,320,2007-08
0646111,0640011,Hartford School District,Bulkeley High School Lower School,741,743,1484,2007-08
0640611,0640011,Hartford School District,Burns Latino Studies Academy,274,259,533,2007-08
0642311,0640011,Hartford School District,Burr School,265,272,537,2007-08
0646911,0640011,Hartford School District,Capital Preparatory Magnet School,146,120,266,2007-08
0642411,0640011,Hartford School District,Clark School,192,250,442,2007-08
0646411,0640011,Hartford School District,Classical Magnet School,353,267,620,2007-08
0645311,0640011,Hartford School District,Dr. Joseph Bellizzi Middle School,223,224,447,2007-08
0640911,0640011,Hartford School District,Environmental Sciences Magnet at Hooker School,183,220,403,2007-08
0643211,0640011,Hartford School District,Expeditionary Learning Academy at Moylan School,284,314,598,2007-08
0645111,0640011,Hartford School District,Fox Middle School,228,233,461,2007-08
0645411,0640011,Hartford School District,Hartford Magnet Trinity College Academy,319,283,602,2007-08
0646211,0640011,Hartford School District,Hartford Public High School,756,813,1569,2007-08
0649011,0640011,Hartford School District,Hartford Transitional Learning Academy (Elementary),6,58,64,2007-08
0649111,0640011,Hartford School District,Hartford Transitional Learning Academy (Secondary),12,43,55,2007-08
0641011,0640011,Hartford School District,Kennelly School,426,383,809,2007-08
0641111,0640011,Hartford School District,Kinsella Magnet School of Performing Arts,253,264,517,2007-08
0648011,0640011,Hartford School District,Little Owls Learning Center,*,*,12,2007-08
0640811,0640011,Hartford School District,M. D. Fox School,380,444,824,2007-08
0641611,0640011,Hartford School District,"M. L. King, Jr. School",297,303,600,2007-08
0641211,0640011,Hartford School District,McDonough Middle School,206,234,440,2007-08
0641911,0640011,Hartford School District,Milner School,165,195,360,2007-08
0641411,0640011,Hartford School District,Naylor/CCSU Leadership Academy,279,285,564,2007-08
0641511,0640011,Hartford School District,Parkville Community School,308,288,596,2007-08
0646611,0640011,Hartford School District,Pathways Academy of Technology and Design,158,192,350,2007-08
0645211,0640011,Hartford School District,Quirk Middle School,275,300,575,2007-08
0641711,0640011,Hartford School District,Rawson School,266,320,586,2007-08
0640111,0640011,Hartford School District,SAND School,181,185,366,2007-08
0642511,0640011,Hartford School District,STEM Magnet at Fisher School,245,315,560,2007-08
0643011,0640011,Hartford School District,Sanchez School,284,296,580,2007-08
0642611,0640011,Hartford School District,Simpson-Waverly School,173,193,366,2007-08
0646511,0640011,Hartford School District,Sports and Medical Sciences Academy,223,172,395,2007-08
0641811,0640011,Hartford School District,Twain School,113,169,282,2007-08
0646711,0640011,Hartford School District,University High School of Science and Engineering,138,204,342,2007-08
0646311,0640011,Hartford School District,Weaver High School,612,647,1259,2007-08
0642011,0640011,Hartford School District,Webster Micro Society Magnet School,306,314,620,2007-08
0642111,0640011,Hartford School District,West Middle School,381,387,768,2007-08
0642211,0640011,Hartford School District,Wish Museum School,207,230,437,2007-08
0650111,0650011,Hartland School District,Hartland School,108,127,235,2007-08
0670211,0670011,Hebron School District,Gilead Hill School,231,276,507,2007-08
0670111,0670011,Hebron School District,Hebron Elementary School,326,371,697,2007-08
2860113,2860013,Highville Charter School District,Highville Charter School,142,135,277,2007-08
2640113,2640013,Integrated Day Charter School District,Integrated Day Charter School,154,176,330,2007-08
2655113,2650013,Interdistrict School for Arts and Comm District,Interdistrict School For Arts And Communication,87,94,181,2007-08
2610113,2610013,Jumoke Academy District,Jumoke Academy,200,169,369,2007-08
0680111,0680011,Kent School District,Kent Center School,131,126,257,2007-08
0698011,0690011,Killingly School District,Goodyear Early Childhood Center,30,41,71,2007-08
0690111,0690011,Killingly School District,Killingly Central School,217,238,455,2007-08
0696111,0690011,Killingly School District,Killingly High School,461,375,836,2007-08
0695211,0690011,Killingly School District,Killingly Intermediate School,363,456,819,2007-08
0690311,0690011,Killingly School District,Killingly Memorial School,262,269,531,2007-08
2459014,2450014,Learn,Learn Special Education,*,*,35,2007-08
2450114,2450014,Learn,Regional Multicultural Magnet School,276,252,528,2007-08
2450214,2450014,Learn,The Friendship School,246,268,514,2007-08
0710111,0710011,Lebanon School District,Lebanon Elementary School,241,271,512,2007-08
0715111,0710011,Lebanon School District,Lebanon Middle School,228,195,423,2007-08
0716211,0710011,Lebanon School District,Lyman Memorial High School,316,271,587,2007-08
0720211,0720011,Ledyard School District,Gales Ferry School,105,125,230,2007-08
0720411,0720011,Ledyard School District,Gallup Hill School,172,192,364,2007-08
0720311,0720011,Ledyard School District,Juliet W. Long School,184,201,385,2007-08
0720111,0720011,Ledyard School District,Ledyard Center School,217,206,423,2007-08
0726111,0720011,Ledyard School District,Ledyard High School,571,488,1059,2007-08
0725111,0720011,Ledyard School District,Ledyard Middle School,202,218,420,2007-08
0730111,0730011,Lisbon School District,Lisbon Central School,269,306,575,2007-08
0740211,0740011,Litchfield School District,Center School,173,164,337,2007-08
0746111,0740011,Litchfield School District,Litchfield High School,318,306,624,2007-08
0740311,0740011,Litchfield School District,Litchfield Intermediate School,130,120,250,2007-08
0766111,0760011,Madison School District,Daniel Hand High School,599,638,1237,2007-08
0760611,0760011,Madison School District,Dr. Robert H. Brown Middle School,302,298,600,2007-08
0760211,0760011,Madison School District,Island Avenue Elementary School,159,148,307,2007-08
0760111,0760011,Madison School District,J. Milton Jeffrey Elementary School,331,301,632,2007-08
0760311,0760011,Madison School District,Kathleen H. Ryerson Elementary School,151,197,348,2007-08
0765211,0760011,Madison School District,Walter C. Polson Upper Middle School,334,311,645,2007-08
0770911,0770011,Manchester School District,Nathan Hale School,171,172,343,2007-08
0770111,0770011,Manchester School District,Bowers School,214,276,490,2007-08
0770311,0770011,Manchester School District,Buckley School,164,207,371,2007-08
0770411,0770011,Manchester School District,Highland Park School,134,162,296,2007-08
0775311,0770011,Manchester School District,Illing Middle School,454,461,915,2007-08
0770611,0770011,Manchester School District,Keeney School,189,228,417,2007-08
0776111,0770011,Manchester School District,Manchester High School,1073,1004,2077,2007-08
0778011,0770011,Manchester School District,Manchester Preschool Center,23,23,46,2007-08
0779011,0770011,Manchester School District,Manchester Regional Academy,25,65,90,2007-08
0771611,0770011,Manchester School District,Martin School,110,117,227,2007-08
0771011,0770011,Manchester School District,Robertson School,188,225,413,2007-08
0771211,0770011,Manchester School District,Verplanck School,184,206,390,2007-08
0771311,0770011,Manchester School District,Waddell School,187,173,360,2007-08
0771411,0770011,Manchester School District,Washington School,198,197,395,2007-08
0780411,0780011,Mansfield School District,Annie E. Vinton School,120,142,262,2007-08
0780211,0780011,Mansfield School District,Dorothy C. Goodwin School,99,103,202,2007-08
0785111,0780011,Mansfield School District,Mansfield Middle School,281,313,594,2007-08
0780511,0780011,Mansfield School District,Southeast Elementary School,121,123,244,2007-08
0790111,0790011,Marlborough School District,Elmer Thienes-Mary Hall Elementary School,345,315,660,2007-08
0800711,0800011,Meriden School District,Nathan Hale School,300,322,622,2007-08
0800111,0800011,Meriden School District,Benjamin Franklin School,220,214,434,2007-08
0801111,0800011,Meriden School District,Casimir Pulaski School,364,369,733,2007-08
0806111,0800011,Meriden School District,Francis T. Maloney High School,646,675,1321,2007-08
0800311,0800011,Meriden School District,Hanover School,264,325,589,2007-08
0800411,0800011,Meriden School District,Israel Putnam School,275,348,623,2007-08
0800511,0800011,Meriden School District,John Barry School,270,268,538,2007-08
0805211,0800011,Meriden School District,Lincoln Middle School,378,399,777,2007-08
0806211,0800011,Meriden School District,Orville H. Platt High School,616,597,1213,2007-08
0800811,0800011,Meriden School District,Roger Sherman School,288,302,590,2007-08
0801011,0800011,Meriden School District,Thomas Hooker School,238,269,507,2007-08
0805411,0800011,Meriden School District,Washington Middle School,421,447,868,2007-08
0830211,0830011,Middletown School District,Bielefield School,168,183,351,2007-08
0839011,0830011,Middletown School District,DEAL Program,*,*,24,2007-08
0830511,0830011,Middletown School District,Farm Hill School,148,161,309,2007-08
0831511,0830011,Middletown School District,Keigwin Middle School,177,180,357,2007-08
0831311,0830011,Middletown School District,Lawrence School,131,155,286,2007-08
0830911,0830011,Middletown School District,MacDonough School,117,103,220,2007-08
0836211,0830011,Middletown School District,Middletown High School,674,663,1337,2007-08
0831211,0830011,Middletown School District,Moody School,189,202,391,2007-08
0831111,0830011,Middletown School District,Snow School,178,172,350,2007-08
0830111,0830011,Middletown School District,Spencer School,197,187,384,2007-08
0831411,0830011,Middletown School District,Wesley School,157,179,336,2007-08
0835411,0830011,Middletown School District,Woodrow Wilson Middle School,327,373,700,2007-08
0840111,0840011,Milford School District,Calf Pen Meadow School,171,174,345,2007-08
0845111,0840011,Milford School District,East Shore Middle School,292,327,619,2007-08
0845211,0840011,Milford School District,Harborside Middle School,278,270,548,2007-08
0841911,0840011,Milford School District,J. F. Kennedy School,185,206,391,2007-08
0846211,0840011,Milford School District,Jonathan Law High School,516,517,1033,2007-08
0846311,0840011,Milford School District,Joseph A. Foran High School,556,456,1012,2007-08
0841611,0840011,Milford School District,Live Oaks School,155,194,349,2007-08
0841711,0840011,Milford School District,Mathewson School,235,258,493,2007-08
0840711,0840011,Milford School District,Meadowside School,181,177,358,2007-08
0840811,0840011,Milford School District,Orange Avenue School,232,265,497,2007-08
0841811,0840011,Milford School District,Orchard Hills School,194,245,439,2007-08
0841011,0840011,Milford School District,Pumpkin Delight School,130,152,282,2007-08
0841411,0840011,Milford School District,Simon Lake School,182,197,379,2007-08
0846411,0840011,Milford School District,The Academy,39,48,87,2007-08
0845311,0840011,Milford School District,West Shore Middle School,271,279,550,2007-08
0850611,0850011,Monroe School District,Chalk Hill School,333,346,679,2007-08
0850511,0850011,Monroe School District,Fawn Hollow Elementary School,290,308,598,2007-08
0855211,0850011,Monroe School District,Jockey Hollow School,321,347,668,2007-08
0856111,0850011,Monroe School District,Masuk High School,698,704,1402,2007-08
0850111,0850011,Monroe School District,Monroe Elementary School,155,206,361,2007-08
0850311,0850011,Monroe School District,Stepney Elementary School,239,274,513,2007-08
0860711,0860011,Montville School District,Dr. Charles E. Murphy School,209,210,419,2007-08
0865111,0860011,Montville School District,Leonard J. Tyl Middle School,324,389,713,2007-08
0860111,0860011,Montville School District,Mohegan School,210,196,406,2007-08
0866111,0860011,Montville School District,Montville High School,426,402,828,2007-08
0860511,0860011,Montville School District,Oakdale School,217,253,470,2007-08
0869011,0860011,Montville School District,Palmer Academy,10,20,30,2007-08
0880811,0880011,Naugatuck School District,Andrew Avenue School,101,127,228,2007-08
0880111,0880011,Naugatuck School District,Central Avenue School,147,146,293,2007-08
0885111,0880011,Naugatuck School District,City Hill Middle School,232,275,507,2007-08
0880211,0880011,Naugatuck School District,Cross Street Intermediate School,197,203,400,2007-08
0888111,0880011,Naugatuck School District,Head Start,48,58,106,2007-08
0880411,0880011,Naugatuck School District,Hillside Intermediate School,184,200,384,2007-08
0885211,0880011,Naugatuck School District,Hillside Middle School,144,157,301,2007-08
0880511,0880011,Naugatuck School District,Hop Brook Elementary School,170,169,339,2007-08
0880311,0880011,Naugatuck School District,Maple Hill School,199,236,435,2007-08
0886111,0880011,Naugatuck School District,Naugatuck High School,664,746,1410,2007-08
0880611,0880011,Naugatuck School District,Salem School,118,135,253,2007-08
0880711,0880011,Naugatuck School District,Western School,118,144,262,2007-08
2800113,2800013,New Beginnings Inc Family Academy District,New Beginnings Inc Family Academy,197,165,362,2007-08
0890311,0890011,New Britain School District,Chamberlain  Elementary School,291,289,580,2007-08
0891111,0890011,New Britain School District,Frank J. DiLoreto School,346,311,657,2007-08
0890511,0890011,New Britain School District,Gaffney School,173,261,434,2007-08
0890611,0890011,New Britain School District,Holmes School,187,235,422,2007-08
0895411,0890011,New Britain School District,House of Arts Letters and Science (HALS)  Academy,80,75,155,2007-08
0890711,0890011,New Britain School District,Jefferson School,185,225,410,2007-08
0890811,0890011,New Britain School District,Lincoln School,336,320,656,2007-08
0896111,0890011,New Britain School District,New Britain High School,1525,1605,3130,2007-08
0890911,0890011,New Britain School District,Northend School,150,137,287,2007-08
0895311,0890011,New Britain School District,Pulaski Middle School,364,456,820,2007-08
0895111,0890011,New Britain School District,Roosevelt Middle School,255,287,542,2007-08
0895211,0890011,New Britain School District,Slade Middle School,354,343,697,2007-08
0891211,0890011,New Britain School District,Smalley Academy,346,326,672,2007-08
0891311,0890011,New Britain School District,Smith School,307,354,661,2007-08
0891511,0890011,New Britain School District,Vance School,242,252,494,2007-08
0900411,0900011,New Canaan School District,East School,274,268,542,2007-08
0906111,0900011,New Canaan School District,New Canaan High School,579,644,1223,2007-08
0905111,0900011,New Canaan School District,Saxe Middle School,667,638,1305,2007-08
0900211,0900011,New Canaan School District,South School,244,276,520,2007-08
0900311,0900011,New Canaan School District,West School,268,258,526,2007-08
0910111,0910011,New Fairfield School District,Consolidated School,316,348,664,2007-08
0910211,0910011,New Fairfield School District,Meeting House Hill School,319,380,699,2007-08
0916111,0910011,New Fairfield School District,New Fairfield High School,439,499,938,2007-08
0915211,0910011,New Fairfield School District,New Fairfield Middle School,376,367,743,2007-08
0920311,0920011,New Hartford School District,Ann Antolini School,174,173,347,2007-08
0920111,0920011,New Hartford School District,Bakerville Consolidated School,82,78,160,2007-08
0929011,0920011,New Hartford School District,Bridges I,*,*,*,2007-08
0920211,0920011,New Hartford School District,New Hartford Elementary School,51,55,106,2007-08
0931211,0930011,New Haven School District,Edgewood School,228,220,448,2007-08
0931411,0930011,New Haven School District,Nathan Hale School,283,279,562,2007-08
0931511,0930011,New Haven School District,Augusta Lewis Troup School,160,189,349,2007-08
0930211,0930011,New Haven School District,Barnard Environmental Magnet School,218,235,453,2007-08
0930311,0930011,New Haven School District,Beecher School,186,223,409,2007-08
0931811,0930011,New Haven School District,Benjamin Jepson Magnet School,213,246,459,2007-08
0935511,0930011,New Haven School District,Betsy Ross Arts Magnet School,317,171,488,2007-08
0934311,0930011,New Haven School District,Bishop Woods Architecture and Design Magnet School,136,162,298,2007-08
0934811,0930011,New Haven School District,"Celentano BioTech, Health and Medical Magnet School",263,321,584,2007-08
0930511,0930011,New Haven School District,Clarence Rogers School,64,71,135,2007-08
0930611,0930011,New Haven School District,Clinton Avenue School,249,263,512,2007-08
0934111,0930011,New Haven School District,Columbus Family Academy,155,130,285,2007-08
0933111,0930011,New Haven School District,Conte/West Hills Magnet School,337,305,642,2007-08
0936411,0930011,New Haven School District,Cooperative High School,283,134,417,2007-08
0936811,0930011,New Haven School District,Cortlandt V.R. Creed Health and Sport Sciences High School,47,157,204,2007-08
0930911,0930011,New Haven School District,Davis 21st Century Magnet Elementary School,184,177,361,2007-08
0938211,0930011,New Haven School District,Dwight Early Childhood Program,16,24,40,2007-08
0938111,0930011,New Haven School District,Early Learning Center,58,67,125,2007-08
0934611,0930011,New Haven School District,East Rock Community Magnet School,296,317,613,2007-08
0931611,0930011,New Haven School District,Fair Haven School,251,295,546,2007-08
0938011,0930011,New Haven School District,Headstart,206,208,414,2007-08
0938311,0930011,New Haven School District,Helene Grant HeadStart,193,204,397,2007-08
0936611,0930011,New Haven School District,High School In The Community,198,131,329,2007-08
0930711,0930011,New Haven School District,Hill Central Music Academy,209,224,433,2007-08
0936311,0930011,New Haven School District,Hill Regional Career High School,471,270,741,2007-08
0936211,0930011,New Haven School District,James Hillhouse High School,523,564,1087,2007-08
0931311,0930011,New Haven School District,John C. Daniels,257,232,489,2007-08
0930811,0930011,New Haven School District,John S. Martinez Sea and Sky STEM School,348,285,633,2007-08
0930411,0930011,New Haven School District,Katherine Brennan School,87,119,206,2007-08
0933011,0930011,New Haven School District,King/Robinson Magnet School,183,206,389,2007-08
0932011,0930011,New Haven School District,Lincoln-Bassett School,175,189,364,2007-08
0936011,0930011,New Haven School District,Metropolitan Business Academy,76,97,173,2007-08
0937011,0930011,New Haven School District,New Haven Academy,102,81,183,2007-08
0936511,0930011,New Haven School District,Polly T. McCabe Center,*,*,34,2007-08
0936911,0930011,New Haven School District,Riverside Education Academy,83,97,180,2007-08
0934211,0930011,New Haven School District,Roberto Clemente Leadership Academy for Global Awareness,210,239,449,2007-08
0931011,0930011,New Haven School District,Ross/Woodward School,302,332,634,2007-08
0935311,0930011,New Haven School District,Sheridan Communications and Technology Magnet School,83,166,249,2007-08
0936711,0930011,New Haven School District,Sound School,144,185,329,2007-08
0931111,0930011,New Haven School District,Timothy Dwight School,131,167,298,2007-08
0932911,0930011,New Haven School District,Truman School,309,311,620,2007-08
0935111,0930011,New Haven School District,Urban Youth Center Middle School,6,28,34,2007-08
0932511,0930011,New Haven School District,"Vincent E. Mauro Elementary Math, Science and Technology Magnet School",187,223,410,2007-08
0934911,0930011,New Haven School District,West Rock Authors Academy,92,115,207,2007-08
0933211,0930011,New Haven School District,Wexler/Grant Community School,219,229,448,2007-08
0936111,0930011,New Haven School District,Wilbur Cross High School,820,975,1795,2007-08
0933811,0930011,New Haven School District,Worthington Hooker School,204,185,389,2007-08
0950311,0950011,New London School District,Jennings School,174,178,352,2007-08
0955111,0950011,New London School District,Bennie Dover Jackson Middle School,288,340,628,2007-08
0955211,0950011,New London School District,Dual Language Arts Academy/Academia Bilingue de las Artes,21,10,31,2007-08
0950211,0950011,New London School District,Harbor School,174,219,393,2007-08
0950911,0950011,New London School District,Nathan Hale Arts Magnet School,176,193,369,2007-08
0959111,0950011,New London School District,New London Clinical Day Program,*,*,25,2007-08
0956111,0950011,New London School District,New London High School,358,440,798,2007-08
0950811,0950011,New London School District,Winthrop STEM Elementary Magnet School,133,183,316,2007-08
0960511,0960011,New Milford School District,Hill And Plain School,237,246,483,2007-08
0960711,0960011,New Milford School District,John Pettibone School,217,273,490,2007-08
0966111,0960011,New Milford School District,New Milford High School,791,800,1591,2007-08
0960811,0960011,New Milford School District,Northville Elementary School,247,300,547,2007-08
0960911,0960011,New Milford School District,Sarah Noble Intermediate School,572,547,1119,2007-08
0965211,0960011,New Milford School District,Schaghticoke Middle School,378,404,782,2007-08
0940611,0940011,Newington School District,Anna Reynolds School,217,223,440,2007-08
0940211,0940011,Newington School District,Elizabeth Green School,142,171,313,2007-08
0940811,0940011,Newington School District,John Paterson School,224,231,455,2007-08
0945311,0940011,Newington School District,John Wallace Middle School,375,383,758,2007-08
0945111,0940011,Newington School District,Martin Kellogg Middle School,321,345,666,2007-08
0946111,0940011,Newington School District,Newington High School,738,790,1528,2007-08
0940711,0940011,Newington School District,Ruth Chaffee School,200,188,388,2007-08
0970111,0970011,Newtown School District,Hawley Elementary School,204,214,418,2007-08
0970411,0970011,Newtown School District,Head O'Meadow Elementary School,204,239,443,2007-08
0970311,0970011,Newtown School District,Middle Gate Elementary School,253,278,531,2007-08
0976111,0970011,Newtown School District,Newtown High School,862,857,1719,2007-08
0975111,0970011,Newtown School District,Newtown Middle School,448,482,930,2007-08
0978011,0970011,Newtown School District,Newtown Preschool,25,37,62,2007-08
0970511,0970011,Newtown School District,Reed Intermediate School,431,455,886,2007-08
0970211,0970011,Newtown School District,Sandy Hook Elementary School,292,347,639,2007-08
0980111,0980011,Norfolk School District,Botelle Elementary School,82,82,164,2007-08
0989011,0980011,Norfolk School District,IEP Program,*,*,*,2007-08
0990411,0990011,North Branford School District,Jerome Harrison School,166,189,355,2007-08
0996111,0990011,North Branford School District,North Branford High School,360,370,730,2007-08
0995111,0990011,North Branford School District,North Branford Intermediate School,290,280,570,2007-08
0990511,0990011,North Branford School District,Stanley T. Williams School,142,126,268,2007-08
0990611,0990011,North Branford School District,Totoket Valley Elementary School,254,254,508,2007-08
1000111,1000011,North Canaan School District,North Canaan Elementary School,190,169,359,2007-08
1010811,1010011,North Haven School District,Clintonville Elementary School,158,215,373,2007-08
1010711,1010011,North Haven School District,Green Acres Elementary School,216,221,437,2007-08
1010211,1010011,North Haven School District,Montowese Elementary School,232,229,461,2007-08
1016111,1010011,North Haven School District,North Haven High School,639,601,1240,2007-08
1015211,1010011,North Haven School District,North Haven Middle School,446,471,917,2007-08
1010311,1010011,North Haven School District,Ridge Road Elementary School,201,234,435,2007-08
1020111,1020011,North Stonington School District,North Stonington Elementary School,164,209,373,2007-08
1026111,1020011,North Stonington School District,Wheeler High School,119,126,245,2007-08
1025111,1020011,North Stonington School District,Wheeler Middle School,85,102,187,2007-08
1036211,1030011,Norwalk School District,Brien McMahon High School,811,851,1662,2007-08
1030211,1030011,Norwalk School District,Brookside Elementary School,194,208,402,2007-08
1030311,1030011,Norwalk School District,Columbus Magnet School,184,172,356,2007-08
1030411,1030011,Norwalk School District,Cranbury Elementary School,212,252,464,2007-08
1032011,1030011,Norwalk School District,Fox Run Elementary School,209,239,448,2007-08
1030711,1030011,Norwalk School District,Jefferson Magnet School,245,249,494,2007-08
1030811,1030011,Norwalk School District,Kendall Elementary School,211,273,484,2007-08
1032211,1030011,Norwalk School District,Marvin Elementary School,231,235,466,2007-08
1032111,1030011,Norwalk School District,Naramake Elementary School,203,194,397,2007-08
1035211,1030011,Norwalk School District,Nathan Hale Middle School,235,271,506,2007-08
1036111,1030011,Norwalk School District,Norwalk High School,753,805,1558,2007-08
1036311,1030011,Norwalk School District,Norwalk Pathways Academy at Briggs,47,49,96,2007-08
1035311,1030011,Norwalk School District,Ponus Ridge Middle School,298,344,642,2007-08
1035511,1030011,Norwalk School District,Roton Middle School,215,210,425,2007-08
1031311,1030011,Norwalk School District,Rowayton School,203,221,424,2007-08
1032311,1030011,Norwalk School District,Silvermine Elementary School,176,198,374,2007-08
1031411,1030011,Norwalk School District,Tracey School,195,218,413,2007-08
1035411,1030011,Norwalk School District,West Rocks Middle School,326,367,693,2007-08
1032411,1030011,Norwalk School District,Wolfpit School,147,161,308,2007-08
9016122,9010022,Norwich Free Academy District,Norwich Free Academy,1285,1164,2449,2007-08
1040111,1040011,Norwich School District,Bishop School Early Learning Center,87,85,172,2007-08
1049111,1040011,Norwich School District,Deborah-Tennant Zinewicz  School,9,35,44,2007-08
1040611,1040011,Norwich School District,Greeneville School,165,177,342,2007-08
1049011,1040011,Norwich School District,Hickory Street School,*,*,15,2007-08
1041411,1040011,Norwich School District,John B. Stanton Network School,134,148,282,2007-08
1045111,1040011,Norwich School District,Kelly Middle School,389,357,746,2007-08
1042011,1040011,Norwich School District,Moriarty Magnet School,167,202,369,2007-08
1040811,1040011,Norwich School District,Samuel Huntington School,188,210,398,2007-08
1045211,1040011,Norwich School District,Teachers' Memorial Middle School,263,277,540,2007-08
1046111,1040011,Norwich School District,Thames River Academy,35,44,79,2007-08
1041711,1040011,Norwich School District,Thomas W. Mahan School,152,127,279,2007-08
1041911,1040011,Norwich School District,Uncas Network School,89,104,193,2007-08
1041811,1040011,Norwich School District,Veterans' Memorial School,123,155,278,2007-08
1041511,1040011,Norwich School District,Wequonnoc Magnet School,137,118,255,2007-08
2635113,2630013,Odyssey Community School District,Odyssey Community School,100,77,177,2007-08
1060211,1060011,Old Saybrook School District,Kathleen E. Goodwin School,237,241,478,2007-08
1065211,1060011,Old Saybrook School District,Old Saybrook Middle School,334,318,652,2007-08
1066111,1060011,Old Saybrook School District,Old Saybrook Senior High School,238,245,483,2007-08
1070211,1070011,Orange School District,Mary L. Tracy School,90,107,197,2007-08
1070511,1070011,Orange School District,Peck Place School,221,218,439,2007-08
1070311,1070011,Orange School District,Race Brook School,201,216,417,2007-08
1070411,1070011,Orange School District,Turkey Hill School,158,161,319,2007-08
1085111,1080011,Oxford School District,Great Oak School,253,267,520,2007-08
1080111,1080011,Oxford School District,Oxford Center School,246,253,499,2007-08
1086011,1080011,Oxford School District,Oxford High School,123,143,266,2007-08
1080311,1080011,Oxford School District,Quaker Farms School,277,288,565,2007-08
2835113,2830013,Park City Prep Charter School District,Park City Prep Charter School,106,100,206,2007-08
1090511,1090011,Plainfield School District,Early Childhood Center,126,140,266,2007-08
1090111,1090011,Plainfield School District,Moosup Elementary School,153,148,301,2007-08
1095111,1090011,Plainfield School District,Plainfield Central School,273,299,572,2007-08
1096111,1090011,Plainfield School District,Plainfield High School,467,449,916,2007-08
1090311,1090011,Plainfield School District,Plainfield Memorial School,172,214,386,2007-08
1090411,1090011,Plainfield School District,Shepard Hill Elementary School,148,173,321,2007-08
1100411,1100011,Plainville School District,Frank T. Wheeler School,149,179,328,2007-08
1100211,1100011,Plainville School District,Linden Street School,192,196,388,2007-08
1100511,1100011,Plainville School District,Louis Toffolon School,157,173,330,2007-08
1105211,1100011,Plainville School District,Middle School of Plainville,314,308,622,2007-08
1106111,1100011,Plainville School District,Plainville High School,433,465,898,2007-08
1108011,1100011,Plainville School District,Prekindergarten Program,13,22,35,2007-08
1115111,1110011,Plymouth School District,Eli Terry Jr. Middle School,212,272,484,2007-08
1110111,1110011,Plymouth School District,Main Street School,80,101,181,2007-08
1110211,1110011,Plymouth School District,Plymouth Center School,236,270,506,2007-08
1110311,1110011,Plymouth School District,Prospect Street School,85,88,173,2007-08
1116111,1110011,Plymouth School District,Terryville High School,260,293,553,2007-08
1120111,1120011,Pomfret School District,Pomfret Community School,291,249,540,2007-08
1130511,1130011,Portland School District,Brownstone Intermediate School,111,129,240,2007-08
1130411,1130011,Portland School District,Gildersleeve School,122,118,240,2007-08
1136111,1130011,Portland School District,Portland High School,187,177,364,2007-08
1135111,1130011,Portland School District,Portland Middle School,95,120,215,2007-08
1130211,1130011,Portland School District,Valley View School,191,179,370,2007-08
1145111,1140011,Preston School District,Preston Plains School,101,90,191,2007-08
1140411,1140011,Preston School District,Preston Veterans' Memorial School,151,161,312,2007-08
1160311,1160011,Putnam School District,Putnam Elementary School,296,333,629,2007-08
1166111,1160011,Putnam School District,Putnam High School,211,183,394,2007-08
1165111,1160011,Putnam School District,Putnam Middle School,123,161,284,2007-08
1175111,1170011,Redding School District,John Read Middle School,293,281,574,2007-08
1170111,1170011,Redding School District,Redding Elementary School,358,376,734,2007-08
2016112,2010012,Regional School District 01,Housatonic Valley Regional High School,274,288,562,2007-08
2045112,2040012,Regional School District 04,John Winthrop Middle School,181,157,338,2007-08
2046112,2040012,Regional School District 04,Valley Regional High School,308,308,616,2007-08
2055112,2050012,Regional School District 05,Amity Middle School: Bethany,194,210,404,2007-08
2055212,2050012,Regional School District 05,Amity Middle School: Orange,198,217,415,2007-08
2056112,2050012,Regional School District 05,Amity Regional High School,833,816,1649,2007-08
2060112,2060012,Regional School District 06,Goshen Center School,114,104,218,2007-08
2060212,2060012,Regional School District 06,James Morris School,93,118,211,2007-08
2068012,2060012,Regional School District 06,Stepping Stones Preschool Program,*,*,14,2007-08
2066112,2060012,Regional School District 06,Wamogo Regional High School,299,274,573,2007-08
2060312,2060012,Regional School District 06,Warren Elementary School,52,56,108,2007-08
2079112,2070012,Regional School District 07,AIM,*,*,7,2007-08
2079012,2070012,Regional School District 07,FLEX,*,*,6,2007-08
2079212,2070012,Regional School District 07,Links,11,12,23,2007-08
2076112,2070012,Regional School District 07,Northwestern Regional High School,405,343,748,2007-08
2075112,2070012,Regional School District 07,Northwestern Regional Middle School,176,175,351,2007-08
2079312,2070012,Regional School District 07,STEP,6,9,15,2007-08
2086112,2080012,Regional School District 08,RHAM High School,498,521,1019,2007-08
2085112,2080012,Regional School District 08,RHAM Middle School,295,349,644,2007-08
2096112,2090012,Regional School District 09,Joel Barlow High School,492,471,963,2007-08
2105112,2100012,Regional School District 10,Har-Bur Middle School,450,479,929,2007-08
2100312,2100012,Regional School District 10,Harwinton Consolidated School,243,289,532,2007-08
2100212,2100012,Regional School District 10,Lake Garda Elementary School,280,325,605,2007-08
2106112,2100012,Regional School District 10,Lewis S. Mills High School,389,389,778,2007-08
2116112,2110012,Regional School District 11,Parish Hill High School,145,146,291,2007-08
2120212,2120012,Regional School District 12,Booth Free School,59,70,129,2007-08
2128012,2120012,Regional School District 12,Early Childhood Education Center,12,9,21,2007-08
2126112,2120012,Regional School District 12,Shepaug Valley High School,198,195,393,2007-08
2125112,2120012,Regional School District 12,Shepaug Valley Middle School,103,129,232,2007-08
2120112,2120012,Regional School District 12,The Burnham School,49,57,106,2007-08
2120412,2120012,Regional School District 12,Washington Primary School,79,98,177,2007-08
2136112,2130012,Regional School District 13,Coginchaug Regional High School,298,289,587,2007-08
2130212,2130012,Regional School District 13,Francis E. Korn School,96,117,213,2007-08
2135112,2130012,Regional School District 13,Frank Ward Strong School,183,177,360,2007-08
2130112,2130012,Regional School District 13,Frederick Brewster School,132,170,302,2007-08
2130512,2130012,Regional School District 13,John Lyman School,175,158,333,2007-08
2130412,2130012,Regional School District 13,Middlefield Memorial School,178,172,350,2007-08
2140112,2140012,Regional School District 14,Bethlehem Elementary School,186,194,380,2007-08
2148012,2140012,Regional School District 14,Integrated Star Preschool Program,6,10,16,2007-08
2140212,2140012,Regional School District 14,Mitchell Elementary School,227,217,444,2007-08
2146112,2140012,Regional School District 14,Nonnewaug High School,482,384,866,2007-08
2145112,2140012,Regional School District 14,Woodbury Middle School,256,242,498,2007-08
2150412,2150012,Regional School District 15,Gainfield Elementary School,209,258,467,2007-08
2150712,2150012,Regional School District 15,Long Meadow Elementary School,291,324,615,2007-08
2155212,2150012,Regional School District 15,Memorial Middle School,248,273,521,2007-08
2150612,2150012,Regional School District 15,Middlebury Elementary School,226,230,456,2007-08
2156212,2150012,Regional School District 15,Pomperaug Regional High School,680,735,1415,2007-08
2150512,2150012,Regional School District 15,Pomperaug School,255,286,541,2007-08
2155112,2150012,Regional School District 15,Rochambeau Middle School,272,283,555,2007-08
2160312,2160012,Regional School District 16,Algonquin School,265,232,497,2007-08
2160212,2160012,Regional School District 16,Community School,128,119,247,2007-08
2160112,2160012,Regional School District 16,Laurel Ledge School,242,252,494,2007-08
2165112,2160012,Regional School District 16,Long River Middle School,307,324,631,2007-08
2166012,2160012,Regional School District 16,Woodland Regional High School,397,419,816,2007-08
2170212,2170012,Regional School District 17,Burr District Elementary School,129,150,279,2007-08
2170112,2170012,Regional School District 17,Haddam Elementary School,133,133,266,2007-08
2176112,2170012,Regional School District 17,Haddam-Killingworth High School,339,377,716,2007-08
2175112,2170012,Regional School District 17,Haddam-Killingworth Middle School,397,446,843,2007-08
2170312,2170012,Regional School District 17,Killingworth Elementary School,245,207,452,2007-08
2180312,2180012,Regional School District 18,Center School,95,138,233,2007-08
2180112,2180012,Regional School District 18,Lyme Consolidated School,78,84,162,2007-08
2186112,2180012,Regional School District 18,Lyme-Old Lyme High School,239,232,471,2007-08
2185112,2180012,Regional School District 18,Lyme-Old Lyme Middle School,179,192,371,2007-08
2180212,2180012,Regional School District 18,Mile Creek School,151,144,295,2007-08
2196112,2190012,Regional School District 19,E. O. Smith High School,619,565,1184,2007-08
1180811,1180011,Ridgefield School District,Barlow Mountain Elementary School,192,254,446,2007-08
1180611,1180011,Ridgefield School District,Branchville Elementary School,214,224,438,2007-08
1185111,1180011,Ridgefield School District,East Ridge Middle School,342,401,743,2007-08
1180411,1180011,Ridgefield School District,Farmingville Elementary School,182,202,384,2007-08
1180311,1180011,Ridgefield School District,Ridgebury Elementary School,228,237,465,2007-08
1186111,1180011,Ridgefield School District,Ridgefield High School,900,851,1751,2007-08
1180511,1180011,Ridgefield School District,Scotland Elementary School,187,203,390,2007-08
1185211,1180011,Ridgefield School District,Scotts Ridge Middle School,278,299,577,2007-08
1180211,1180011,Ridgefield School District,Veterans Park Elementary School,162,182,344,2007-08
1195111,1190011,Rocky Hill School District,Albert D. Griswold Middle School,299,312,611,2007-08
1190211,1190011,Rocky Hill School District,Dr. Oran A. Moser School,43,46,89,2007-08
1190411,1190011,Rocky Hill School District,Myrtle H. Stevens School,238,282,520,2007-08
1196111,1190011,Rocky Hill School District,Rocky Hill High School,372,383,755,2007-08
1190511,1190011,Rocky Hill School District,West Hill School,315,316,631,2007-08
1210111,1210011,Salem School District,Salem Elementary School,249,257,506,2007-08
1220111,1220011,Salisbury School District,Salisbury Central School,144,163,307,2007-08
1230111,1230011,Scotland School District,Scotland Elementary School,92,98,190,2007-08
1240311,1240011,Seymour School District,Anna L. Lopresti School,170,169,339,2007-08
1240111,1240011,Seymour School District,Bungay School,262,300,562,2007-08
1240411,1240011,Seymour School District,Paul E. Chatfield School,149,135,284,2007-08
1246111,1240011,Seymour School District,Seymour High School,447,415,862,2007-08
1245111,1240011,Seymour School District,Seymour Middle School,280,278,558,2007-08
1250111,1250011,Sharon School District,Sharon Center School,106,113,219,2007-08
1260911,1260011,Shelton School District,Mohegan School,324,305,629,2007-08
1261011,1260011,Shelton School District,Booth Hill School,252,242,494,2007-08
1260511,1260011,Shelton School District,Elizabeth Shelton School,259,294,553,2007-08
1265111,1260011,Shelton School District,Intermediate School,439,468,907,2007-08
1260411,1260011,Shelton School District,Lafayette School,182,204,386,2007-08
1260811,1260011,Shelton School District,Long Hill School,310,299,609,2007-08
1266111,1260011,Shelton School District,Shelton High School,795,892,1687,2007-08
1260611,1260011,Shelton School District,Sunnyside School,162,217,379,2007-08
1270111,1270011,Sherman School District,Sherman School,226,230,456,2007-08
2700113,2700013,Side By Side Charter School District,Side By Side Charter School,112,118,230,2007-08
1280111,1280011,Simsbury School District,Central School,208,232,440,2007-08
1285111,1280011,Simsbury School District,Henry James Memorial School,392,424,816,2007-08
1280611,1280011,Simsbury School District,Latimer Lane School,258,274,532,2007-08
1286111,1280011,Simsbury School District,Simsbury High School,719,816,1535,2007-08
1280711,1280011,Simsbury School District,Squadron Line School,385,417,802,2007-08
1280311,1280011,Simsbury School District,Tariffville School,118,140,258,2007-08
1280411,1280011,Simsbury School District,Tootin' Hills School,249,317,566,2007-08
1295111,1290011,Somers School District,Mabelle B. Avery Middle School,215,212,427,2007-08
1290411,1290011,Somers School District,Somers Elementary School,332,397,729,2007-08
1296111,1290011,Somers School District,Somers High School,288,279,567,2007-08
1320211,1320011,South Windsor School District,Pleasant Valley School,229,219,448,2007-08
1320711,1320011,South Windsor School District,Eli Terry School,201,232,433,2007-08
1320611,1320011,South Windsor School District,Orchard Hill School,242,265,507,2007-08
1320111,1320011,South Windsor School District,Philip R. Smith School,213,223,436,2007-08
1326211,1320011,South Windsor School District,South Windsor High School,789,862,1651,2007-08
1325111,1320011,South Windsor School District,Timothy Edwards School,538,611,1149,2007-08
1320411,1320011,South Windsor School District,Wapping Elementary School,147,163,310,2007-08
1315311,1310011,Southington School District,John F. Kennedy Middle School,394,403,797,2007-08
1311511,1310011,Southington School District,Derynoski Elementary School,360,342,702,2007-08
1311311,1310011,Southington School District,Flanders Elementary School,176,158,334,2007-08
1310211,1310011,Southington School District,Hatton Elementary School,194,236,430,2007-08
1315111,1310011,Southington School District,Joseph A. Depaolo Middle School,371,364,735,2007-08
1310611,1310011,Southington School District,Plantsville Elementary School,91,124,215,2007-08
1310711,1310011,Southington School District,South End Elementary School,94,113,207,2007-08
1316211,1310011,Southington School District,Southington High School,1075,1089,2164,2007-08
1310811,1310011,Southington School District,Strong Elementary School,226,240,466,2007-08
1310911,1310011,Southington School District,Thalberg Elementary School,203,227,430,2007-08
1311411,1310011,Southington School District,Urbin T. Kelley School,192,222,414,2007-08
1330111,1330011,Sprague School District,Sayles School,180,171,351,2007-08
1340611,1340011,Stafford School District,Stafford Elementary School,278,248,526,2007-08
1346111,1340011,Stafford School District,Stafford High School,260,261,521,2007-08
1345211,1340011,Stafford School District,Stafford Middle School,223,254,477,2007-08
1340311,1340011,Stafford School District,Staffordville School,79,99,178,2007-08
1340411,1340011,Stafford School District,West Stafford School,99,106,205,2007-08
2826013,2820013,Stamford Academy District,Stamford Academy,54,77,131,2007-08
1355611,1350011,Stamford School District,Cloonan School,294,300,594,2007-08
1352011,1350011,Stamford School District,Davenport Ridge School,276,239,515,2007-08
1355311,1350011,Stamford School District,Dolan School,309,316,625,2007-08
1352211,1350011,Stamford School District,Hart School,190,230,420,2007-08
1351211,1350011,Stamford School District,Julia A. Stark School,273,328,601,2007-08
1350511,1350011,Stamford School District,K. T. Murphy School,269,279,548,2007-08
1350611,1350011,Stamford School District,Newfield School,292,340,632,2007-08
1351811,1350011,Stamford School District,Northeast School,414,400,814,2007-08
1358011,1350011,Stamford School District,Preschool Team,22,61,83,2007-08
1355811,1350011,Stamford School District,Rippowam Middle School,397,410,807,2007-08
1350811,1350011,Stamford School District,Rogers International School,257,268,525,2007-08
1350911,1350011,Stamford School District,Roxbury School,295,359,654,2007-08
1355711,1350011,Stamford School District,Scofield Middle School,294,310,604,2007-08
1351111,1350011,Stamford School District,Springdale School,271,294,565,2007-08
1356111,1350011,Stamford School District,Stamford High School,884,913,1797,2007-08
1352111,1350011,Stamford School District,Stillmeadow School,280,321,601,2007-08
1356411,1350011,Stamford School District,The Academy of Information Technology,162,316,478,2007-08
1351911,1350011,Stamford School District,Toquam Magnet School,214,239,453,2007-08
1355511,1350011,Stamford School District,Turn of River School,294,315,609,2007-08
1356311,1350011,Stamford School District,Westhill High School,1137,1194,2331,2007-08
1351411,1350011,Stamford School District,Westover School,314,324,638,2007-08
1360311,1360011,Sterling School District,Sterling Community School,219,284,503,2007-08
1370511,1370011,Stonington School District,Deans Mill School,260,269,529,2007-08
1375211,1370011,Stonington School District,Mystic Middle School,204,231,435,2007-08
1375111,1370011,Stonington School District,Pawcatuck Middle School,163,169,332,2007-08
1378011,1370011,Stonington School District,Special Needs Preschool Program,11,7,18,2007-08
1376111,1370011,Stonington School District,Stonington High School,388,423,811,2007-08
1370411,1370011,Stonington School District,West Broad Street School,82,93,175,2007-08
1370611,1370011,Stonington School District,West Vine Street School,116,120,236,2007-08
1381311,1380011,Stratford School District,Eli Whitney School,251,265,516,2007-08
1386211,1380011,Stratford School District,Bunnell High School,696,691,1387,2007-08
1380311,1380011,Stratford School District,Chapel School,241,264,505,2007-08
1385211,1380011,Stratford School District,David Wooster Middle School,292,278,570,2007-08
1380411,1380011,Stratford School District,Franklin School,194,202,396,2007-08
1385311,1380011,Stratford School District,Harry B. Flood Middle School,284,285,569,2007-08
1380811,1380011,Stratford School District,Lordship School,110,115,225,2007-08
1380911,1380011,Stratford School District,Nichols School,195,235,430,2007-08
1381011,1380011,Stratford School District,Second Hill Lane School,327,361,688,2007-08
1381511,1380011,Stratford School District,Stratford Academy - Johnson House,360,360,720,2007-08
1386111,1380011,Stratford School District,Stratford High School,500,471,971,2007-08
1389011,1380011,Stratford School District,Strive-Stratford,*,*,8,2007-08
1381411,1380011,Stratford School District,Wilcoxson School,203,195,398,2007-08
1390411,1390011,Suffield School District,A. Ward Spaulding School,271,270,541,2007-08
1390311,1390011,Suffield School District,McAlister Intermediate School,261,311,572,2007-08
1396111,1390011,Suffield School District,Suffield High School,460,385,845,2007-08
1395111,1390011,Suffield School District,Suffield Middle School,311,325,636,2007-08
2696113,2690013,The Bridge Academy District,The Bridge Academy,139,121,260,2007-08
9026122,9020022,The Gilbert School District,The Gilbert School,206,202,408,2007-08
1400111,1400011,Thomaston School District,Black Rock School,193,194,387,2007-08
1400211,1400011,Thomaston School District,Thomaston Center School,142,152,294,2007-08
1406211,1400011,Thomaston School District,Thomaston High School,282,303,585,2007-08
1410111,1410011,Thompson School District,Mary R. Fisher Elementary School,288,286,574,2007-08
1415111,1410011,Thompson School District,Thompson Middle School,235,268,503,2007-08
1416111,1410011,Thompson School District,Tourtellotte Memorial High School,204,195,399,2007-08
1420111,1420011,Tolland School District,Birch Grove Primary School,369,391,760,2007-08
1426111,1420011,Tolland School District,Tolland High School,421,428,849,2007-08
1420211,1420011,Tolland School District,Tolland Intermediate School,247,260,507,2007-08
1425111,1420011,Tolland School District,Tolland Middle School,479,534,1013,2007-08
1430111,1430011,Torrington School District,East School,236,245,481,2007-08
1430211,1430011,Torrington School District,Forbes School,188,195,383,2007-08
1430811,1430011,Torrington School District,Southwest School,150,155,305,2007-08
1430911,1430011,Torrington School District,Torringford School,316,367,683,2007-08
1436111,1430011,Torrington School District,Torrington High School,625,670,1295,2007-08
1435111,1430011,Torrington School District,Torrington Middle School,548,614,1162,2007-08
1431311,1430011,Torrington School District,Vogel-Wetmore School,189,259,448,2007-08
2785113,2780013,Trailblazers Academy District,Trailblazers Academy,54,96,150,2007-08
1440111,1440011,Trumbull School District,Booth Hill School,256,258,514,2007-08
1440811,1440011,Trumbull School District,Daniels Farm School,253,260,513,2007-08
1441011,1440011,Trumbull School District,Frenchtown Elementary School,287,314,601,2007-08
1445211,1440011,Trumbull School District,Hillcrest Middle School,349,394,743,2007-08
1440411,1440011,Trumbull School District,Jane Ryan School,206,217,423,2007-08
1445111,1440011,Trumbull School District,Madison Middle School,455,425,880,2007-08
1440311,1440011,Trumbull School District,Middlebrook School,219,254,473,2007-08
1440911,1440011,Trumbull School District,Tashua School,222,239,461,2007-08
1448011,1440011,Trumbull School District,Trumbull Early Childhood Education Center,87,113,200,2007-08
1446111,1440011,Trumbull School District,Trumbull High School,1102,993,2095,2007-08
3361715,3360015,Unified School District #1,Bergin Correctional Institution,0,38,38,2007-08
3360115,3360015,Unified School District #1,Bridgeport Correctional Center,0,32,32,2007-08
3360215,3360015,Unified School District #1,Brooklyn Correctional Institution,0,13,13,2007-08
3360315,3360015,Unified School District #1,Cheshire Correctional Institution,0,29,29,2007-08
3362415,3360015,Unified School District #1,Corrigan/Radgowski Correctional Institution,0,70,70,2007-08
3360415,3360015,Unified School District #1,Enfield Correctional Institution,0,22,22,2007-08
3361915,3360015,Unified School District #1,Garner Correctional Institution,0,28,28,2007-08
3360515,3360015,Unified School District #1,Gates Correctional Institution,0,38,38,2007-08
3360615,3360015,Unified School District #1,Hartford Correctional Center,0,69,69,2007-08
3362215,3360015,Unified School District #1,MacDougall/Walker Correctional Institution,0,78,78,2007-08
3361115,3360015,Unified School District #1,Manson Youth Institution,0,551,551,2007-08
3360915,3360015,Unified School District #1,New Haven Correctional Center,0,25,25,2007-08
3362615,3360015,Unified School District #1,Northern Correctional Institution,0,28,28,2007-08
3361215,3360015,Unified School District #1,Osborn Correctional Institution,0,36,36,2007-08
3361315,3360015,Unified School District #1,Robinson Correctional Institution,0,29,29,2007-08
3361415,3360015,Unified School District #1,Webster Correctional Institution,0,12,12,2007-08
3361515,3360015,Unified School District #1,Willard/Cybulski Correctional Institution,0,38,38,2007-08
3362515,3360015,Unified School District #1,York Correctional Institution,59,0,59,2007-08
3470115,3470015,Unified School District #2,Children's Place School,22,17,39,2007-08
3476515,3470015,Unified School District #2,High Meadows,0,30,30,2007-08
3470315,3470015,Unified School District #2,Riverview School,28,39,67,2007-08
3476715,3470015,Unified School District #2,Walter G. Cady School,0,90,90,2007-08
1450111,1450011,Union School District,Union Elementary School,38,34,72,2007-08
1460311,1460011,Vernon School District,Northeast School,146,167,313,2007-08
1461411,1460011,Vernon School District,Center Road School,210,239,449,2007-08
1460111,1460011,Vernon School District,Lake Street School,111,125,236,2007-08
1460211,1460011,Vernon School District,Maple Street School,166,173,339,2007-08
1466111,1460011,Vernon School District,Rockville High School,655,559,1214,2007-08
1461011,1460011,Vernon School District,Skinner Road School,158,169,327,2007-08
1465111,1460011,Vernon School District,Vernon Center Middle School,390,429,819,2007-08
1470111,1470011,Voluntown School District,Voluntown Elementary School,168,141,309,2007-08
1480211,1480011,Wallingford School District,Highland School,187,148,335,2007-08
1489011,1480011,Wallingford School District,A.R.T.S. Academy,*,*,21,2007-08
1481011,1480011,Wallingford School District,Cook Hill School,197,203,400,2007-08
1485211,1480011,Wallingford School District,Dag Hammarskjold Middle School,385,360,745,2007-08
1480911,1480011,Wallingford School District,Evarts C. Stevens School,212,193,405,2007-08
1485311,1480011,Wallingford School District,James H. Moran Middle School,423,424,847,2007-08
1486111,1480011,Wallingford School District,Lyman Hall High School,629,546,1175,2007-08
1486211,1480011,Wallingford School District,Mark T. Sheehan High School,494,497,991,2007-08
1480111,1480011,Wallingford School District,Moses Y. Beach School,175,156,331,2007-08
1480311,1480011,Wallingford School District,Parker Farms School,161,191,352,2007-08
1481211,1480011,Wallingford School District,Pond Hill School,159,169,328,2007-08
1480411,1480011,Wallingford School District,Rock Hill School,170,177,347,2007-08
1480811,1480011,Wallingford School District,Yalesville School,263,271,534,2007-08
1511011,1510011,Waterbury School District,Brooklyn Elementary School,102,127,229,2007-08
1515211,1510011,Waterbury School District,West Side Middle School,559,638,1197,2007-08
1512311,1510011,Waterbury School District,Washington School,155,158,313,2007-08
1512111,1510011,Waterbury School District,B. W. Tinker School,263,311,574,2007-08
1510311,1510011,Waterbury School District,Barnard School,136,134,270,2007-08
1510511,1510011,Waterbury School District,Bucks Hill School,270,315,585,2007-08
1510611,1510011,Waterbury School District,Bunker Hill School,263,256,519,2007-08
1512711,1510011,Waterbury School District,Carrington School,253,262,515,2007-08
1516211,1510011,Waterbury School District,Crosby High School,692,676,1368,2007-08
1510911,1510011,Waterbury School District,Driggs School,260,290,550,2007-08
1519111,1510011,Waterbury School District,Enlightenment School,70,96,166,2007-08
1511411,1510011,Waterbury School District,F. J. Kingsbury School,245,250,495,2007-08
1512611,1510011,Waterbury School District,Gilmartin School,105,134,239,2007-08
1510711,1510011,Waterbury School District,H. S. Chase School,404,394,798,2007-08
1511311,1510011,Waterbury School District,Hopeville School,256,209,465,2007-08
1516411,1510011,Waterbury School District,John F. Kennedy High School,685,628,1313,2007-08
1513111,1510011,Waterbury School District,Maloney Interdistrict Magnet School,295,298,593,2007-08
1511111,1510011,Waterbury School District,Margaret M. Generali Elementary School,286,277,563,2007-08
1515111,1510011,Waterbury School District,Michael F. Wallace Middle School,622,721,1343,2007-08
1515311,1510011,Waterbury School District,North End Middle School,599,660,1259,2007-08
1512811,1510011,Waterbury School District,Regan School,157,156,313,2007-08
1513311,1510011,Waterbury School District,Rotella Interdistrict Magnet School,308,306,614,2007-08
1518011,1510011,Waterbury School District,Special Education Preschool,82,117,199,2007-08
1512011,1510011,Waterbury School District,Sprague School,250,238,488,2007-08
1519011,1510011,Waterbury School District,State Street School,10,67,77,2007-08
1512211,1510011,Waterbury School District,Walsh School,266,285,551,2007-08
1516011,1510011,Waterbury School District,Waterbury Arts Magnet School (High),312,173,485,2007-08
1515011,1510011,Waterbury School District,Waterbury Arts Magnet School (Middle),167,146,313,2007-08
1510811,1510011,Waterbury School District,Wendell L. Cross School,175,174,349,2007-08
1516311,1510011,Waterbury School District,Wilby High School,592,612,1204,2007-08
1513211,1510011,Waterbury School District,Woodrow Wilson School,186,171,357,2007-08
1525111,1520011,Waterford School District,Clark Lane Middle School,343,387,730,2007-08
1520111,1520011,Waterford School District,Cohanzie Elementary School,182,205,387,2007-08
1520211,1520011,Waterford School District,Great Neck Elementary School,133,147,280,2007-08
1520611,1520011,Waterford School District,Oswegatchie Elementary School,141,145,286,2007-08
1520511,1520011,Waterford School District,Southwest Elementary School,108,128,236,2007-08
1526111,1520011,Waterford School District,Waterford High School,534,479,1013,2007-08
1530311,1530011,Watertown School District,Fletcher W. Judson School,187,193,380,2007-08
1530611,1530011,Watertown School District,Heminway Park School,139,133,272,2007-08
1530211,1530011,Watertown School District,John Trumbull Primary School,388,410,798,2007-08
1530411,1530011,Watertown School District,Polk School,170,186,356,2007-08
1535111,1530011,Watertown School District,Swift Middle School,299,303,602,2007-08
1536111,1530011,Watertown School District,Watertown High School,493,497,990,2007-08
1551711,1550011,West Hartford School District,Smith School,177,203,380,2007-08
1551611,1550011,West Hartford School District,Aiken School,230,227,457,2007-08
1550211,1550011,West Hartford School District,Braeburn School,219,221,440,2007-08
1555311,1550011,West Hartford School District,Bristow Middle School,213,196,409,2007-08
1550411,1550011,West Hartford School District,Bugbee School,188,196,384,2007-08
1550511,1550011,West Hartford School District,Charter Oak International Academy,168,173,341,2007-08
1556111,1550011,West Hartford School District,Conard High School,737,724,1461,2007-08
1550611,1550011,West Hartford School District,Duffy School,261,296,557,2007-08
1556211,1550011,West Hartford School District,Hall High School,769,799,1568,2007-08
1555111,1550011,West Hartford School District,King Philip Middle School,436,471,907,2007-08
1550911,1550011,West Hartford School District,Morley School,184,183,367,2007-08
1551011,1550011,West Hartford School District,Norfeldt School,225,219,444,2007-08
1555211,1550011,West Hartford School District,Sedgwick Middle School,412,453,865,2007-08
1551211,1550011,West Hartford School District,Webster Hill School,218,218,436,2007-08
1551311,1550011,West Hartford School District,Whiting Lane School,215,289,504,2007-08
1551511,1550011,West Hartford School District,Wolcott School,237,233,470,2007-08
1561211,1560011,West Haven School District,Washington School,191,209,400,2007-08
1560811,1560011,West Haven School District,Alma E. Pagels School,171,187,358,2007-08
1561311,1560011,West Haven School District,Anna V. Molloy School,143,123,266,2007-08
1565311,1560011,West Haven School District,Carrigan 5/6 Intermediate School,362,382,744,2007-08
1561011,1560011,West Haven School District,Clarence E. Thompson School,156,197,353,2007-08
1560611,1560011,West Haven School District,Edith E. Mackrille School,200,184,384,2007-08
1560311,1560011,West Haven School District,Forest School,213,231,444,2007-08
1565111,1560011,West Haven School District,Harry M. Bailey Middle School,350,360,710,2007-08
1561411,1560011,West Haven School District,Savin Rock Community School,220,232,452,2007-08
1560411,1560011,West Haven School District,Seth G. Haley School,262,266,528,2007-08
1566111,1560011,West Haven School District,West Haven High School,885,873,1758,2007-08
1540211,1540011,Westbrook School District,Daisy Ingraham School,175,181,356,2007-08
1546111,1540011,Westbrook School District,Westbrook High School,148,162,310,2007-08
1545111,1540011,Westbrook School District,Westbrook Middle School,153,161,314,2007-08
1570111,1570011,Weston School District,Hurlbutt Elementary School,286,309,595,2007-08
1576111,1570011,Weston School District,Weston High School,415,389,804,2007-08
1570211,1570011,Weston School District,Weston Intermediate School,275,304,579,2007-08
1575111,1570011,Weston School District,Weston Middle School,284,303,587,2007-08
1585111,1580011,Westport School District,Bedford Middle School,425,415,840,2007-08
1580311,1580011,Westport School District,Coleytown Elementary School,237,223,460,2007-08
1585311,1580011,Westport School District,Coleytown Middle School,245,259,504,2007-08
1580411,1580011,Westport School District,Green's Farms School,244,251,495,2007-08
1580511,1580011,Westport School District,King's Highway Elementary School,245,251,496,2007-08
1580711,1580011,Westport School District,Long Lots School,279,315,594,2007-08
1580811,1580011,Westport School District,Saugatuck Elementary School,255,254,509,2007-08
1586111,1580011,Westport School District,Staples High School,815,909,1724,2007-08
1588011,1580011,Westport School District,Stepping Stones Preschool,18,38,56,2007-08
1590811,1590011,Wethersfield School District,Alfred W. Hanmer School,175,202,377,2007-08
1591011,1590011,Wethersfield School District,Charles Wright School,147,159,306,2007-08
1590211,1590011,Wethersfield School District,Emerson-Williams School,226,235,461,2007-08
1591111,1590011,Wethersfield School District,Highcrest School,202,240,442,2007-08
1591211,1590011,Wethersfield School District,Samuel B. Webb Elementary School,208,241,449,2007-08
1595211,1590011,Wethersfield School District,Silas Deane Middle School,289,275,564,2007-08
1596111,1590011,Wethersfield School District,Wethersfield High School,603,609,1212,2007-08
1600111,1600011,Willington School District,Center School,117,131,248,2007-08
1605111,1600011,Willington School District,Hall Memorial School,176,175,351,2007-08
1615211,1610011,Wilton School District,Middlebrook School,486,529,1015,2007-08
1610711,1610011,Wilton School District,Cider Mill School,510,536,1046,2007-08
1610611,1610011,Wilton School District,Ina E. Driscoll School,247,263,510,2007-08
1610511,1610011,Wilton School District,Miller-Driscoll School,271,265,536,2007-08
1616111,1610011,Wilton School District,Wilton High School,592,664,1256,2007-08
1629011,1620011,Winchester School District,ABLE,*,*,7,2007-08
1620411,1620011,Winchester School District,Batcheller Early Education Center,143,185,328,2007-08
1629111,1620011,Winchester School District,Bridges 2,0,*,*,2007-08
1626111,1620011,Winchester School District,Joy D. Rice School,*,*,11,2007-08
1620211,1620011,Winchester School District,Mary P. Hinsdale School,166,206,372,2007-08
1625111,1620011,Winchester School District,Pearson Middle School,169,172,341,2007-08
1638011,1630011,Windham School District,Early Headstart,31,66,97,2007-08
1639011,1630011,Windham School District,Eastern Regional Academy/Windham,11,45,56,2007-08
1630111,1630011,Windham School District,Natchaug School,145,165,310,2007-08
1630311,1630011,Windham School District,North Windham School,217,228,445,2007-08
1630611,1630011,Windham School District,W. B. Sweeney School,159,183,342,2007-08
1630511,1630011,Windham School District,Windham Center School,134,125,259,2007-08
1638311,1630011,Windham School District,Windham Early Childhood Prospect Street,87,90,177,2007-08
1636111,1630011,Windham School District,Windham High School,471,515,986,2007-08
1635111,1630011,Windham School District,Windham Middle School,449,511,960,2007-08
1650111,1650011,Windsor Locks School District,North Street School,191,219,410,2007-08
1650411,1650011,Windsor Locks School District,South Elementary School,193,236,429,2007-08
1656111,1650011,Windsor Locks School District,Windsor Locks High School,271,313,584,2007-08
1655111,1650011,Windsor Locks School District,Windsor Locks Middle School,216,189,405,2007-08
1640111,1640011,Windsor School District,Clover Street School,129,152,281,2007-08
1640811,1640011,Windsor School District,John F. Kennedy School,181,215,396,2007-08
1640911,1640011,Windsor School District,Oliver Ellsworth School,213,237,450,2007-08
1640511,1640011,Windsor School District,Poquonock Elementary School,166,147,313,2007-08
1641011,1640011,Windsor School District,Roger Wolcott Early Child Center,123,134,257,2007-08
1645311,1640011,Windsor School District,Sage Park Middle School,459,462,921,2007-08
1646111,1640011,Windsor School District,Windsor High School,655,817,1472,2007-08
1660611,1660011,Wolcott School District,Alcott School,192,202,394,2007-08
1660211,1660011,Wolcott School District,Frisbie School,189,205,394,2007-08
1665111,1660011,Wolcott School District,Tyrrell Middle School,375,383,758,2007-08
1660511,1660011,Wolcott School District,Wakelee School,221,235,456,2007-08
1666111,1660011,Wolcott School District,Wolcott High School,448,468,916,2007-08
1670211,1670011,Woodbridge School District,Beecher Road Intermediate School,226,241,467,2007-08
1670111,1670011,Woodbridge School District,Beecher Road Primary School,142,177,319,2007-08
9036122,9030022,Woodstock Academy District,Woodstock Academy,576,577,1153,2007-08
1690211,1690011,Woodstock School District,Woodstock Elementary School,240,256,496,2007-08
1695111,1690011,Woodstock School District,Woodstock Middle School,206,242,448,2007-08
2880113,2880013,Achievement First Hartford Academy Inc. District,Achievement First Hartford Academy Inc.,115,146,261,2008-09
2795113,2790013,Amistad Academy District,Amistad Academy,312,329,641,2008-09
0010111,0010011,Andover School District,Andover Elementary School,148,186,334,2008-09
0026111,0020011,Ansonia School District,Ansonia High School,354,363,717,2008-09
0025111,0020011,Ansonia School District,Ansonia Middle School,275,307,582,2008-09
0020311,0020011,Ansonia School District,Mead School,278,338,616,2008-09
0029011,0020011,Ansonia School District,Pine Academy,14,25,39,2008-09
0020811,0020011,Ansonia School District,Prendergast School,369,390,759,2008-09
2449014,2440014,Area Cooperative Educational Services,A. C. E. S. Special Education Town Campus Learning Center,*,*,12,2008-09
2446114,2440014,Area Cooperative Educational Services,Collaborative Alternative Magnet School,37,73,110,2008-09
2449414,2440014,Area Cooperative Educational Services,Mill Road School,28,142,170,2008-09
2445114,2440014,Area Cooperative Educational Services,Thomas Edison Magnet Middle School,369,379,748,2008-09
2449514,2440014,Area Cooperative Educational Services,Village School,50,126,176,2008-09
2449214,2440014,Area Cooperative Educational Services,Whitney High School East,29,99,128,2008-09
2449114,2440014,Area Cooperative Educational Services,Whitney High School North,23,70,93,2008-09
2449314,2440014,Area Cooperative Educational Services,Whitney High School West,21,35,56,2008-09
2440314,2440014,Area Cooperative Educational Services,Wintergreen Interdistrict  Magnet School,320,285,605,2008-09
0030111,0030011,Ashford School District,Ashford School,224,261,485,2008-09
0046111,0040011,Avon School District,Avon High School,521,531,1052,2008-09
0045111,0040011,Avon School District,Avon Middle School,296,293,589,2008-09
0040411,0040011,Avon School District,Pine Grove School,291,319,610,2008-09
0040311,0040011,Avon School District,Roaring Brook School,387,363,750,2008-09
0040511,0040011,Avon School District,Thompson Brook School,255,302,557,2008-09
0050111,0050011,Barkhamsted School District,Barkhamsted Elementary School,145,196,341,2008-09
0058011,0050011,Barkhamsted School District,Shared Services Integrated Preschool,9,12,21,2008-09
0076111,0070011,Berlin School District,Berlin High School,509,518,1027,2008-09
0075111,0070011,Berlin School District,Catherine M. McGee Middle School,354,388,742,2008-09
0070411,0070011,Berlin School District,Emma Hart Willard School,265,336,601,2008-09
0070511,0070011,Berlin School District,Mary E. Griswold School,285,299,584,2008-09
0070111,0070011,Berlin School District,Richard D. Hubbard School,110,154,264,2008-09
0080111,0080011,Bethany School District,Bethany Community School,263,286,549,2008-09
0090411,0090011,Bethel School District,Anna H. Rockwell School,199,224,423,2008-09
0096111,0090011,Bethel School District,Bethel High School,522,488,1010,2008-09
0095111,0090011,Bethel School District,Bethel Middle School,351,355,706,2008-09
0090111,0090011,Bethel School District,Frank A. Berry School,218,262,480,2008-09
0090511,0090011,Bethel School District,Ralph M. T. Johnson School,228,226,454,2008-09
0116111,0110011,Bloomfield School District,Bloomfield High School,302,344,646,2008-09
0110711,0110011,Bloomfield School District,Carmen Arace Intermediate School,142,171,313,2008-09
0115211,0110011,Bloomfield School District,Carmen Arace Middle School,151,151,302,2008-09
0110311,0110011,Bloomfield School District,J. P. Vincent School,135,181,316,2008-09
0110611,0110011,Bloomfield School District,Laurel School,113,152,265,2008-09
0110511,0110011,Bloomfield School District,Metacomet School,114,118,232,2008-09
0116211,0110011,Bloomfield School District,The Big Picture High School,53,30,83,2008-09
0120111,0120011,Bolton School District,Bolton Center School,284,299,583,2008-09
0126111,0120011,Bolton School District,Bolton High School,153,125,278,2008-09
0130111,0130011,Bozrah School District,Fields Memorial School,135,121,256,2008-09
0146111,0140011,Branford School District,Branford High School,562,549,1111,2008-09
0145111,0140011,Branford School District,Francis Walsh Intermediate School,551,532,1083,2008-09
0148011,0140011,Branford School District,Indian Neck School,33,44,77,2008-09
0141611,0140011,Branford School District,John B. Sliney School,174,189,363,2008-09
0141511,0140011,Branford School District,Mary R. Tisko School,212,224,436,2008-09
0141411,0140011,Branford School District,Mary T. Murphy School,199,210,409,2008-09
2850113,2850013,Bridgeport Achievement First District,Achievement First Bridgeport Academy,89,71,160,2008-09
0150111,0150011,Bridgeport School District,Barnum School,307,293,600,2008-09
0156111,0150011,Bridgeport School District,Bassick High School,581,676,1257,2008-09
0150211,0150011,Bridgeport School District,Beardsley School,202,190,392,2008-09
0150311,0150011,Bridgeport School District,Black Rock School,126,108,234,2008-09
0154011,0150011,Bridgeport School District,Blackham School,497,562,1059,2008-09
0159011,0150011,Bridgeport School District,Bridgeport Learning Center,16,41,57,2008-09
0150411,0150011,Bridgeport School District,Bryant School,226,214,440,2008-09
0156211,0150011,Bridgeport School District,Central High School,1164,1123,2287,2008-09
0151411,0150011,Bridgeport School District,Cesar Batalla School,511,582,1093,2008-09
0152111,0150011,Bridgeport School District,Classical Studies Academy,173,170,343,2008-09
0150511,0150011,Bridgeport School District,Columbus School,314,315,629,2008-09
0153911,0150011,Bridgeport School District,Cross School,165,208,373,2008-09
0154211,0150011,Bridgeport School District,Curiale School,260,302,562,2008-09
0154111,0150011,Bridgeport School District,Dunbar School,213,184,397,2008-09
0150711,0150011,Bridgeport School District,Edison School,157,160,317,2008-09
0153211,0150011,Bridgeport School District,Geraldine Johnson School,333,438,771,2008-09
0151111,0150011,Bridgeport School District,Hall School,120,153,273,2008-09
0151211,0150011,Bridgeport School District,Hallen School,176,178,354,2008-09
0156311,0150011,Bridgeport School District,Harding High School,835,817,1652,2008-09
0154511,0150011,Bridgeport School District,High Horizons Magnet School,241,200,441,2008-09
0151311,0150011,Bridgeport School District,Hooker School,212,258,470,2008-09
0152211,0150011,Bridgeport School District,Jettie S. Tisdale School,297,299,596,2008-09
0151911,0150011,Bridgeport School District,Longfellow School,207,206,413,2008-09
0151011,0150011,Bridgeport School District,Luis Munoz Marin School,419,435,854,2008-09
0152011,0150011,Bridgeport School District,Madison School,233,298,531,2008-09
0159511,0150011,Bridgeport School District,Make The Grade,13,29,42,2008-09
0154611,0150011,Bridgeport School District,Multicultural Magnet School,243,202,445,2008-09
0159411,0150011,Bridgeport School District,New Start Program,19,19,38,2008-09
0159211,0150011,Bridgeport School District,Park City Academy,7,27,34,2008-09
0151711,0150011,Bridgeport School District,Park City Magnet School,255,246,501,2008-09
0152511,0150011,Bridgeport School District,Read School,424,495,919,2008-09
0152611,0150011,Bridgeport School District,Roosevelt School,248,302,550,2008-09
0154411,0150011,Bridgeport School District,Skane Center,95,115,210,2008-09
0159111,0150011,Bridgeport School District,The University School,*,*,24,2008-09
0153011,0150011,Bridgeport School District,Waltersville School,265,296,561,2008-09
0153611,0150011,Bridgeport School District,Winthrop School,377,352,729,2008-09
0179011,0170011,Bristol School District,Alternative Special Education Program (ASEP),*,*,23,2008-09
0176111,0170011,Bristol School District,Bristol Central High School,662,755,1417,2008-09
0176211,0170011,Bristol School District,Bristol Eastern High School,670,648,1318,2008-09
0175111,0170011,Bristol School District,Chippens Hill Middle School,433,448,881,2008-09
0170711,0170011,Bristol School District,Clara T. O'Connell School,183,189,372,2008-09
0170111,0170011,Bristol School District,Clarence A. Bingham School,115,127,242,2008-09
0170311,0170011,Bristol School District,Edgewood School,163,196,359,2008-09
0171411,0170011,Bristol School District,Ellen P. Hubbell School,246,246,492,2008-09
0170511,0170011,Bristol School District,Greene-Hills School,175,192,367,2008-09
0171911,0170011,Bristol School District,Ivy Drive School,177,205,382,2008-09
0170611,0170011,Bristol School District,John J. Jennings School,171,195,366,2008-09
0175311,0170011,Bristol School District,Memorial Boulevard Middle School,264,279,543,2008-09
0171711,0170011,Bristol School District,Mountain View School,178,213,391,2008-09
0175211,0170011,Bristol School District,Northeast Middle School,257,309,566,2008-09
0171111,0170011,Bristol School District,South Side School,262,313,575,2008-09
0171211,0170011,Bristol School District,Stafford School,263,254,517,2008-09
0186111,0180011,Brookfield School District,Brookfield High School,498,518,1016,2008-09
0180311,0180011,Brookfield School District,Center Elementary School,200,206,406,2008-09
0180411,0180011,Brookfield School District,Huckleberry Hill Elementary School,301,308,609,2008-09
0185311,0180011,Brookfield School District,Whisconier Middle School,458,457,915,2008-09
0190111,0190011,Brooklyn School District,Brooklyn Elementary School,291,290,581,2008-09
0195111,0190011,Brooklyn School District,Brooklyn Middle School,199,201,400,2008-09
0210111,0210011,Canaan School District,Lee H. Kellogg School,45,40,85,2008-09
0220211,0220011,Canterbury School District,Canterbury Elementary School,156,201,357,2008-09
0225111,0220011,Canterbury School District,Dr. Helen Baldwin Middle School,107,135,242,2008-09
0236111,0230011,Canton School District,Canton High School,254,268,522,2008-09
0230311,0230011,Canton School District,Canton Intermediate School,188,206,394,2008-09
0235111,0230011,Canton School District,Canton Middle School,137,142,279,2008-09
0230211,0230011,Canton School District,Cherry Brook Primary School,295,258,553,2008-09
2415114,2410014,Capitol Region Education Council,Academy of Aerospace and Engineering,30,48,78,2008-09
2419214,2410014,Capitol Region Education Council,Farmington Valley Regional Diagnostic Center,*,*,16,2008-09
2410114,2410014,Capitol Region Education Council,Glastonbury/East Hartford Magnet School,122,129,251,2008-09
2416314,2410014,Capitol Region Education Council,Great Path Academy at MCC,97,67,164,2008-09
2416414,2410014,Capitol Region Education Council,Greater Hartford Academy of  the Arts High School - Full Time,87,60,147,2008-09
2419414,2410014,Capitol Region Education Council,Integrated Program Models,8,10,18,2008-09
2410414,2410014,Capitol Region Education Council,International Magnet School for Global Citizenship,55,69,124,2008-09
2419014,2410014,Capitol Region Education Council,John J. Allison Polaris Center,20,48,68,2008-09
2416114,2410014,Capitol Region Education Council,Metropolitan Learning Center for Global and International Studies,344,339,683,2008-09
2413114,2410014,Capitol Region Education Council,Montessori Magnet School,179,153,332,2008-09
2415214,2410014,Capitol Region Education Council,Public Safety Academy,41,64,105,2008-09
2410314,2410014,Capitol Region Education Council,Reggio Magnet School of the Arts,71,78,149,2008-09
2419514,2410014,Capitol Region Education Council,River Street Early Learning Center (Site 2),12,41,53,2008-09
2419314,2410014,Capitol Region Education Council,River Street School,23,126,149,2008-09
2419114,2410014,Capitol Region Education Council,Soundbridge,57,41,98,2008-09
2415014,2410014,Capitol Region Education Council,Two Rivers Magnet Middle School,301,288,589,2008-09
2410214,2410014,Capitol Region Education Council,University of Hartford Magnet School,204,208,412,2008-09
0240211,0240011,Chaplin School District,Chaplin Elementary School,84,94,178,2008-09
2870113,2870013,Charter School for Young Children on Asylum Hill District,Charter School for Young Children on Asylum Hill  Inc.,70,66,136,2008-09
0250111,0250011,Cheshire School District,Chapman School,171,158,329,2008-09
0256111,0250011,Cheshire School District,Cheshire High School,762,817,1579,2008-09
0250211,0250011,Cheshire School District,Darcey School,189,196,385,2008-09
0255111,0250011,Cheshire School District,Dodd Middle School,395,423,818,2008-09
0250611,0250011,Cheshire School District,Doolittle School,254,278,532,2008-09
0250411,0250011,Cheshire School District,Highland School,409,460,869,2008-09
0259011,0250011,Cheshire School District,Humiston School,7,17,24,2008-09
0250511,0250011,Cheshire School District,Norton School,243,227,470,2008-09
0260111,0260011,Chester School District,Chester Elementary School,171,148,319,2008-09
0270111,0270011,Clinton School District,Abraham Pierson School,166,147,313,2008-09
0275111,0270011,Clinton School District,Jared Eliot School,234,258,492,2008-09
0270311,0270011,Clinton School District,Lewin G. Joel Jr. School,349,340,689,2008-09
0276111,0270011,Clinton School District,The Morgan School,303,287,590,2008-09
0286111,0280011,Colchester School District,Bacon Academy,494,474,968,2008-09
0280411,0280011,Colchester School District,Colchester Elementary School,347,392,739,2008-09
0280211,0280011,Colchester School District,Jack Jackter Intermediate School,356,354,710,2008-09
0285111,0280011,Colchester School District,William J. Johnston Middle School,391,372,763,2008-09
0290111,0290011,Colebrook School District,Colebrook Consolidated School,60,56,116,2008-09
0300111,0300011,Columbia School District,Horace W. Porter School,283,290,573,2008-09
2686113,2680013,Common Ground High School District,Common Ground High School,79,76,155,2008-09
9001516,9000016,Connecticut Technical High School System,A. I. Prince Technical High School,338,277,615,2008-09
9001116,9000016,Connecticut Technical High School System,Bullard-Havens Technical High School,455,420,875,2008-09
9001916,9000016,Connecticut Technical High School System,E. C. Goodwin Technical High School,184,307,491,2008-09
9001416,9000016,Connecticut Technical High School System,Eli Whitney Technical High School,262,262,524,2008-09
9002716,9000016,Connecticut Technical High School System,Ella T. Grasso Southeastern Technical High School,253,365,618,2008-09
9002516,9000016,Connecticut Technical High School System,Emmett O'Brien Technical High School,166,354,520,2008-09
9001716,9000016,Connecticut Technical High School System,H. C. Wilcox Technical High School,272,455,727,2008-09
9001316,9000016,Connecticut Technical High School System,H. H. Ellis Technical High School,157,411,568,2008-09
9001216,9000016,Connecticut Technical High School System,Henry Abbott Technical High School,176,402,578,2008-09
9001616,9000016,Connecticut Technical High School System,Howell Cheney Technical High School,106,491,597,2008-09
9002116,9000016,Connecticut Technical High School System,J. M. Wright Technical High School,98,127,225,2008-09
9002016,9000016,Connecticut Technical High School System,Norwich Technical High School,145,328,473,2008-09
9002216,9000016,Connecticut Technical High School System,Oliver Wolcott Technical High School,250,491,741,2008-09
9002616,9000016,Connecticut Technical High School System,Platt Technical High School,287,597,884,2008-09
9001816,9000016,Connecticut Technical High School System,Vinal Technical High School,152,431,583,2008-09
9002316,9000016,Connecticut Technical High School System,W. F. Kaynor Technical High School,273,443,716,2008-09
9002416,9000016,Connecticut Technical High School System,Windham Technical High School,181,341,522,2008-09
2439014,2430014,Cooperative Educational Services,C. E. S. Special Education,72,198,270,2008-09
2438014,2430014,Cooperative Educational Services,School Readiness,28,26,54,2008-09
2430114,2430014,Cooperative Educational Services,Six-Six Magnet School,223,207,430,2008-09
0310111,0310011,Cornwall School District,Cornwall Consolidated School,60,62,122,2008-09
0325111,0320011,Coventry School District,Capt. Nathan Hale School,253,261,514,2008-09
0328011,0320011,Coventry School District,Coventry Early Intervention Services,*,*,14,2008-09
0320211,0320011,Coventry School District,Coventry Grammar School,214,196,410,2008-09
0326111,0320011,Coventry School District,Coventry High School,269,284,553,2008-09
0320411,0320011,Coventry School District,George Hersey Robertson School,216,245,461,2008-09
0336111,0330011,Cromwell School District,Cromwell High School,299,274,573,2008-09
0335111,0330011,Cromwell School District,Cromwell Middle School,226,236,462,2008-09
0330211,0330011,Cromwell School District,Edna C. Stevens School,225,263,488,2008-09
0330311,0330011,Cromwell School District,Woodside Intermediate School,230,264,494,2008-09
0346211,0340011,Danbury School District,Alternative Center For Excellence,53,33,86,2008-09
0345111,0340011,Danbury School District,Broadview Middle School,531,574,1105,2008-09
0346111,0340011,Danbury School District,Danbury High School,1437,1402,2839,2008-09
0341411,0340011,Danbury School District,Ellsworth Avenue School,179,172,351,2008-09
0341111,0340011,Danbury School District,Great Plain School,148,153,301,2008-09
0340211,0340011,Danbury School District,Hayestown Avenue School,194,212,406,2008-09
0341711,0340011,Danbury School District,King Street Intermediate School,159,158,317,2008-09
0341311,0340011,Danbury School District,King Street Primary School,164,170,334,2008-09
0341811,0340011,Danbury School District,Mill Ridge Educational Center,151,201,352,2008-09
0340511,0340011,Danbury School District,Mill Ridge Primary School,152,144,296,2008-09
0340611,0340011,Danbury School District,Morris Street School,158,188,346,2008-09
0340811,0340011,Danbury School District,Park Avenue School,203,197,400,2008-09
0341511,0340011,Danbury School District,Pembroke School,148,188,336,2008-09
0345211,0340011,Danbury School District,Rogers Park Middle School,493,527,1020,2008-09
0341211,0340011,Danbury School District,Shelter Rock School,193,182,375,2008-09
0341011,0340011,Danbury School District,South Street School,163,172,335,2008-09
0341611,0340011,Danbury School District,Stadley Rough School,240,230,470,2008-09
0341911,0340011,Danbury School District,Western CT Academy of International Studies Elementary Magnet School,169,202,371,2008-09
0356111,0350011,Darien School District,Darien High School,626,610,1236,2008-09
0350211,0350011,Darien School District,Hindley Elementary School,255,263,518,2008-09
0350711,0350011,Darien School District,Holmes Elementary School,219,256,475,2008-09
0355111,0350011,Darien School District,Middlesex Middle School,551,581,1132,2008-09
0351311,0350011,Darien School District,Ox Ridge Elementary School,243,252,495,2008-09
0350511,0350011,Darien School District,Royle Elementary School,186,254,440,2008-09
0350611,0350011,Darien School District,Tokeneke Elementary School,179,246,425,2008-09
0360111,0360011,Deep River School District,Deep River Elementary School,177,176,353,2008-09
3370315,3370015,Department of Mental Health and Addiction Services,Cedarcrest Regional Hosp - Blue Hills Hosp. Substance Ab,*,*,*,2008-09
3370215,3370015,Department of Mental Health and Addiction Services,Connecticut Valley Hospital,0,*,*,2008-09
3370515,3370015,Department of Mental Health and Addiction Services,Greater Bridgeport Community Mental Health Center,*,0,*,2008-09
0370611,0370011,Derby School District,Bradley School,187,196,383,2008-09
0376111,0370011,Derby School District,Derby High School,308,333,641,2008-09
0370411,0370011,Derby School District,Irving School,214,224,438,2008-09
0400111,0400011,East Granby School District,Allgrove School,160,128,288,2008-09
0406111,0400011,East Granby School District,East Granby High School,129,123,252,2008-09
0405111,0400011,East Granby School District,East Granby Middle School,96,120,216,2008-09
0400211,0400011,East Granby School District,R. Dudley Seymour School,69,73,142,2008-09
0410111,0410011,East Haddam School District,East Haddam Elementary School,188,245,433,2008-09
0416111,0410011,East Haddam School District,Nathan Hale-Ray High School,224,194,418,2008-09
0415111,0410011,East Haddam School District,Nathan Hale-Ray Middle School,283,289,572,2008-09
0420311,0420011,East Hampton School District,Center School,187,163,350,2008-09
0426111,0420011,East Hampton School District,East Hampton High School,311,284,595,2008-09
0425111,0420011,East Hampton School District,East Hampton Middle School,238,236,474,2008-09
0420111,0420011,East Hampton School District,Memorial School,281,348,629,2008-09
0429011,0420011,East Hampton School District,The Learning Center at East Hampton,*,*,7,2008-09
0430911,0430011,East Hartford School District,Anna E. Norris School,144,178,322,2008-09
0436311,0430011,East Hartford School District,Connecticut IB Academy,110,59,169,2008-09
0430611,0430011,East Hartford School District,Dr. Franklin H. Mayberry School,212,198,410,2008-09
0432211,0430011,East Hartford School District,Dr. John A. Langford School,154,178,332,2008-09
0431011,0430011,East Hartford School District,Dr. Thomas S. O'Connell School,171,151,322,2008-09
0436211,0430011,East Hartford School District,East Hartford High School,917,981,1898,2008-09
0435111,0430011,East Hartford School District,East Hartford Middle School,437,530,967,2008-09
0432011,0430011,East Hartford School District,Governor William Pitkin School,183,170,353,2008-09
0430511,0430011,East Hartford School District,Hockanum School,152,181,333,2008-09
0430411,0430011,East Hartford School District,Joseph O. Goodwin School,158,173,331,2008-09
0431811,0430011,East Hartford School District,Robert J. O'Brien School,204,210,414,2008-09
0431211,0430011,East Hartford School District,Silver Lane School,150,147,297,2008-09
0436411,0430011,East Hartford School District,Stevens Alternate High School,58,90,148,2008-09
0432411,0430011,East Hartford School District,Sunset Ridge Middle School,247,245,492,2008-09
0438011,0430011,East Hartford School District,Willowbrook Early Childhood,124,154,278,2008-09
0439011,0430011,East Hartford School District,Woodland School,26,143,169,2008-09
0441711,0440011,East Haven School District,Carbone School/East Haven Academy,124,104,228,2008-09
0441411,0440011,East Haven School District,D. C. Moore School,117,116,233,2008-09
0440111,0440011,East Haven School District,Deer Run School,157,180,337,2008-09
0441311,0440011,East Haven School District,Dominick H. Ferrara School,91,98,189,2008-09
0446111,0440011,East Haven School District,East Haven High School,516,498,1014,2008-09
0441011,0440011,East Haven School District,Grove J. Tuttle School,105,107,212,2008-09
0441911,0440011,East Haven School District,Hays School,67,96,163,2008-09
0445111,0440011,East Haven School District,Joseph Melillo Middle School,225,274,499,2008-09
0440711,0440011,East Haven School District,Momauguin School,85,119,204,2008-09
0441811,0440011,East Haven School District,Overbrook Elementary School,77,82,159,2008-09
0449011,0440011,East Haven School District,Pathways,13,33,46,2008-09
0441611,0440011,East Haven School District,Robert W. Carbone School,150,142,292,2008-09
0456111,0450011,East Lyme School District,East Lyme High School,639,608,1247,2008-09
0455111,0450011,East Lyme School District,East Lyme Middle School,433,437,870,2008-09
0450111,0450011,East Lyme School District,Flanders School,172,196,368,2008-09
0458011,0450011,East Lyme School District,Integrated Preschool,25,25,50,2008-09
0450411,0450011,East Lyme School District,Lillie B. Haynes School,176,190,366,2008-09
0450211,0450011,East Lyme School District,Niantic Center School,123,124,247,2008-09
0470111,0470011,East Windsor School District,Broad Brook Elementary School,296,304,600,2008-09
0476111,0470011,East Windsor School District,East Windsor High School,196,215,411,2008-09
0475411,0470011,East Windsor School District,East Windsor Middle School,208,216,424,2008-09
2536014,2530014,Eastern Connecticut Regional Educational Service Center (EASTCONN),Arts at the Capitol Theater Magnet School (ACT),46,19,65,2008-09
2539014,2530014,Eastern Connecticut Regional Educational Service Center (EASTCONN),EastConn Special Education,8,40,48,2008-09
2536114,2530014,Eastern Connecticut Regional Educational Service Center (EASTCONN),Quinebaug Middle College,19,15,34,2008-09
0390111,0390011,Eastford School District,Eastford Elementary School,86,99,185,2008-09
0465111,0460011,Easton School District,Helen Keller Middle School,205,182,387,2008-09
0460111,0460011,Easton School District,Samuel Staples Elementary School,336,433,769,2008-09
2428014,2420014,EdAdvance,EdAdvance Headstart,74,93,167,2008-09
2429014,2420014,EdAdvance,The ACCESS School at The Danuta M. Thibodeau Education Center,11,16,27,2008-09
0480111,0480011,Ellington School District,Center School,207,222,429,2008-09
0480211,0480011,Ellington School District,Crystal Lake School,103,118,221,2008-09
0486111,0480011,Ellington School District,Ellington High School,388,390,778,2008-09
0485111,0480011,Ellington School District,Ellington Middle School,201,189,390,2008-09
0480711,0480011,Ellington School District,Windermere Intermediate School,221,185,406,2008-09
0480611,0480011,Ellington School District,Windermere School,190,220,410,2008-09
2810113,2810013,Elm City College Preparatory School,Elm City College Preparatory School,258,251,509,2008-09
0491311,0490011,Enfield School District,Edgar H. Parkman School,172,167,339,2008-09
0491611,0490011,Enfield School District,Eli Whitney School,191,213,404,2008-09
0496111,0490011,Enfield School District,Enfield High School,442,451,893,2008-09
0490211,0490011,Enfield School District,Enfield Street School,177,171,348,2008-09
0499011,0490011,Enfield School District,Enfield Transitional Learning Academy,*,*,8,2008-09
0496211,0490011,Enfield School District,Enrico Fermi High School,591,583,1174,2008-09
0491211,0490011,Enfield School District,Harriet Beecher Stowe School,142,141,283,2008-09
0490411,0490011,Enfield School District,Hazardville Memorial School,183,222,405,2008-09
0498011,0490011,Enfield School District,Head Start Program,48,56,104,2008-09
0491811,0490011,Enfield School District,Henry Barnard School,190,228,418,2008-09
0495211,0490011,Enfield School District,John F. Kennedy Middle School,438,485,923,2008-09
0491111,0490011,Enfield School District,Nathan Hale School,123,140,263,2008-09
0491511,0490011,Enfield School District,Prudence Crandall School,226,209,435,2008-09
0491711,0490011,Enfield School District,Thomas G. Alcorn School,149,150,299,2008-09
0500111,0500011,Essex School District,Essex Elementary School,288,306,594,2008-09
2726113,2720013,Explorations District,Explorations,49,36,85,2008-09
0510211,0510011,Fairfield School District,Burr Elementary School,231,238,469,2008-09
0510111,0510011,Fairfield School District,Dwight Elementary School,164,158,322,2008-09
0518011,0510011,Fairfield School District,Early Childhood Center,39,87,126,2008-09
0516011,0510011,Fairfield School District,Fairfield Ludlowe High School,734,658,1392,2008-09
0516211,0510011,Fairfield School District,Fairfield Warde High School,660,613,1273,2008-09
0515211,0510011,Fairfield School District,Fairfield Woods Middle School,291,314,605,2008-09
0510411,0510011,Fairfield School District,Holland Hill School,179,171,350,2008-09
0511711,0510011,Fairfield School District,Jennings School,164,192,356,2008-09
0510611,0510011,Fairfield School District,McKinley School,205,231,436,2008-09
0510711,0510011,Fairfield School District,Mill Hill School,222,248,470,2008-09
0511611,0510011,Fairfield School District,North Stratfield School,237,265,502,2008-09
0511811,0510011,Fairfield School District,Osborn Hill School,256,271,527,2008-09
0511211,0510011,Fairfield School District,Riverfield School,220,258,478,2008-09
0515311,0510011,Fairfield School District,Roger Ludlowe Middle School,440,449,889,2008-09
0511311,0510011,Fairfield School District,Sherman School,213,233,446,2008-09
0511411,0510011,Fairfield School District,Stratfield School,278,264,542,2008-09
0515111,0510011,Fairfield School District,Tomlinson Middle School,400,370,770,2008-09
0520411,0520011,Farmington School District,East Farms School,196,232,428,2008-09
0528011,0520011,Farmington School District,Farmington Collaborative PK,25,47,72,2008-09
0526111,0520011,Farmington School District,Farmington High School,676,684,1360,2008-09
0525111,0520011,Farmington School District,Irving A. Robbins Middle School,313,358,671,2008-09
0520211,0520011,Farmington School District,Noah Wallace School,161,184,345,2008-09
0520111,0520011,Farmington School District,Union School,135,160,295,2008-09
0520311,0520011,Farmington School District,West District School,172,173,345,2008-09
0520511,0520011,Farmington School District,West Woods Upper Elementary School,332,344,676,2008-09
0530111,0530011,Franklin School District,Franklin Elementary School,103,122,225,2008-09
0540211,0540011,Glastonbury School District,Buttonball Lane School,291,284,575,2008-09
0540311,0540011,Glastonbury School District,Eastbury School,170,172,342,2008-09
0540811,0540011,Glastonbury School District,Gideon Welles School,261,269,530,2008-09
0546111,0540011,Glastonbury School District,Glastonbury High School,1018,1048,2066,2008-09
0540411,0540011,Glastonbury School District,Hebron Avenue School,283,242,525,2008-09
0540611,0540011,Glastonbury School District,Hopewell School,261,269,530,2008-09
0540711,0540011,Glastonbury School District,Naubuc School,246,242,488,2008-09
0540911,0540011,Glastonbury School District,Nayaug Elementary School,336,328,664,2008-09
0545211,0540011,Glastonbury School District,Smith Middle School,568,560,1128,2008-09
0560111,0560011,Granby School District,Frank M. Kearns Primary School,224,249,473,2008-09
0566111,0560011,Granby School District,Granby Memorial High School,337,400,737,2008-09
0565111,0560011,Granby School District,Granby Memorial Middle School,195,184,379,2008-09
0560411,0560011,Granby School District,Kelly Lane Primary School,166,184,350,2008-09
0560311,0560011,Granby School District,Wells Road Intermediate School,160,170,330,2008-09
0575111,0570011,Greenwich School District,Central Middle School,325,365,690,2008-09
0570211,0570011,Greenwich School District,Cos Cob School,207,208,415,2008-09
0575211,0570011,Greenwich School District,Eastern Middle School,383,364,747,2008-09
0570411,0570011,Greenwich School District,Glenville School,135,148,283,2008-09
0576111,0570011,Greenwich School District,Greenwich High School,1257,1420,2677,2008-09
0570511,0570011,Greenwich School District,Hamilton Avenue School,196,185,381,2008-09
0571311,0570011,Greenwich School District,International School At Dundee,181,194,375,2008-09
0570311,0570011,Greenwich School District,Julian Curtiss School,165,173,338,2008-09
0570611,0570011,Greenwich School District,New Lebanon School,108,119,227,2008-09
0570711,0570011,Greenwich School District,North Mianus School,237,220,457,2008-09
0570811,0570011,Greenwich School District,North Street School,229,268,497,2008-09
0570911,0570011,Greenwich School District,Old Greenwich School,217,224,441,2008-09
0571111,0570011,Greenwich School District,Parkway School,139,189,328,2008-09
0571011,0570011,Greenwich School District,Riverside School,228,289,517,2008-09
0575311,0570011,Greenwich School District,Western Middle School,231,263,494,2008-09
0580311,0580011,Griswold School District,Griswold Elementary School,457,474,931,2008-09
0586211,0580011,Griswold School District,Griswold High School,388,378,766,2008-09
0585111,0580011,Griswold School District,Griswold Middle School,198,220,418,2008-09
0595311,0590011,Groton School District,Carl C. Cutler Middle School,186,188,374,2008-09
0592011,0590011,Groton School District,Catherine Kolnaski Magnet School,233,235,468,2008-09
0591811,0590011,Groton School District,Charles Barnum School,215,219,434,2008-09
0590311,0590011,Groton School District,Claude Chester School,174,195,369,2008-09
0595111,0590011,Groton School District,Fitch Middle School,221,211,432,2008-09
0591711,0590011,Groton School District,Mary Morrisson School,156,170,326,2008-09
0591911,0590011,Groton School District,Northeast Academy Elementary School,211,201,412,2008-09
0591211,0590011,Groton School District,Pleasant Valley School,165,157,322,2008-09
0596111,0590011,Groton School District,Robert E. Fitch High School,712,676,1388,2008-09
0590111,0590011,Groton School District,S. B. Butler School,172,172,344,2008-09
0595211,0590011,Groton School District,West Side Middle School,143,122,265,2008-09
0600711,0600011,Guilford School District,A. Baldwin Middle School,257,317,574,2008-09
0600611,0600011,Guilford School District,A. W. Cox School,165,154,319,2008-09
0600411,0600011,Guilford School District,Calvin Leete School,179,156,335,2008-09
0605111,0600011,Guilford School District,E. C. Adams Middle School,295,309,604,2008-09
0606111,0600011,Guilford School District,Guilford High School,597,541,1138,2008-09
0600211,0600011,Guilford School District,Guilford Lakes School,207,231,438,2008-09
0600311,0600011,Guilford School District,Melissa Jones School,177,180,357,2008-09
0628011,0620011,Hamden School District,Alice Peck Learning Center,33,58,91,2008-09
0621211,0620011,Hamden School District,Bear Path School,227,237,464,2008-09
0620211,0620011,Hamden School District,Church Street School,198,210,408,2008-09
0620311,0620011,Hamden School District,Dunbar Hill School,157,175,332,2008-09
0626111,0620011,Hamden School District,Hamden High School,1019,1094,2113,2008-09
0625211,0620011,Hamden School District,Hamden Middle School,418,448,866,2008-09
0620411,0620011,Hamden School District,Helen Street School,132,174,306,2008-09
0621111,0620011,Hamden School District,Ridge Hill School,139,175,314,2008-09
0620111,0620011,Hamden School District,Shepherd Glen School,159,164,323,2008-09
0621011,0620011,Hamden School District,Spring Glen School,161,186,347,2008-09
0621411,0620011,Hamden School District,West Woods School,236,265,501,2008-09
0630111,0630011,Hampton School District,Hampton Elementary School,62,87,149,2008-09
0640711,0640011,Hartford School District,Asian Studies Academy at Bellizzi School,165,190,355,2008-09
0640411,0640011,Hartford School District,Batchelder School,256,290,546,2008-09
0642811,0640011,Hartford School District,Betances Early Reading Lab Magnet School,212,227,439,2008-09
0643511,0640011,Hartford School District,Breakthrough II Magnet School,53,49,102,2008-09
0643311,0640011,Hartford School District,Breakthrough Magnet School,171,171,342,2008-09
0646111,0640011,Hartford School District,Bulkeley High School Lower School,658,723,1381,2008-09
0640611,0640011,Hartford School District,Burns Latino Studies Academy,286,248,534,2008-09
0642311,0640011,Hartford School District,Burr School,246,274,520,2008-09
0646911,0640011,Hartford School District,Capital Preparatory Magnet School,148,123,271,2008-09
0642411,0640011,Hartford School District,Clark School,217,249,466,2008-09
0646411,0640011,Hartford School District,Classical Magnet School,393,304,697,2008-09
0646011,0640011,Hartford School District,Culinary Arts Academy at Weaver High School,107,114,221,2008-09
0645311,0640011,Hartford School District,Dr. Joseph Bellizzi Middle School,215,213,428,2008-09
0640911,0640011,Hartford School District,Environmental Sciences Magnet at Hooker School,200,207,407,2008-09
0643211,0640011,Hartford School District,Expeditionary Learning Academy at Moylan School,249,288,537,2008-09
0645111,0640011,Hartford School District,Fox Middle School,79,84,163,2008-09
0643611,0640011,Hartford School District,Global Communications Academy,104,104,208,2008-09
0645411,0640011,Hartford School District,Hartford Magnet Trinity College Academy,322,291,613,2008-09
0646211,0640011,Hartford School District,Hartford Public High School,766,773,1539,2008-09
0649011,0640011,Hartford School District,Hartford Transitional Learning Academy (Elementary),6,53,59,2008-09
0649111,0640011,Hartford School District,Hartford Transitional Learning Academy (Secondary),11,51,62,2008-09
0641011,0640011,Hartford School District,Kennelly School,421,378,799,2008-09
0641111,0640011,Hartford School District,Kinsella Magnet School of Performing Arts,302,267,569,2008-09
0648011,0640011,Hartford School District,Little Owls Learning Center,8,9,17,2008-09
0640811,0640011,Hartford School District,M. D. Fox School,370,413,783,2008-09
0641611,0640011,Hartford School District,"M. L. King, Jr. School",252,270,522,2008-09
0641211,0640011,Hartford School District,McDonough Middle School,190,206,396,2008-09
0641911,0640011,Hartford School District,Milner School,193,224,417,2008-09
0643711,0640011,Hartford School District,Montessori Magnet at Fisher School,48,53,101,2008-09
0641411,0640011,Hartford School District,Naylor/CCSU Leadership Academy,319,289,608,2008-09
0641511,0640011,Hartford School District,Parkville Community School,294,284,578,2008-09
0646611,0640011,Hartford School District,Pathways Academy of Technology and Design,165,226,391,2008-09
0645211,0640011,Hartford School District,Quirk Middle School,273,295,568,2008-09
0641711,0640011,Hartford School District,Rawson School,341,414,755,2008-09
0640111,0640011,Hartford School District,SAND School,231,211,442,2008-09
0642511,0640011,Hartford School District,STEM Magnet at Fisher School,168,208,376,2008-09
0643011,0640011,Hartford School District,Sanchez School,264,264,528,2008-09
0642611,0640011,Hartford School District,Simpson-Waverly School,171,176,347,2008-09
0646511,0640011,Hartford School District,Sports and Medical Sciences Academy,311,267,578,2008-09
0646711,0640011,Hartford School District,University High School of Science and Engineering,140,206,346,2008-09
0646311,0640011,Hartford School District,Weaver High School,423,448,871,2008-09
0642011,0640011,Hartford School District,Webster Micro Society Magnet School,294,316,610,2008-09
0642111,0640011,Hartford School District,West Middle School,333,337,670,2008-09
0642211,0640011,Hartford School District,Wish Museum School,200,224,424,2008-09
0650111,0650011,Hartland School District,Hartland School,110,128,238,2008-09
0670211,0670011,Hebron School District,Gilead Hill School,244,245,489,2008-09
0670111,0670011,Hebron School District,Hebron Elementary School,301,382,683,2008-09
2860113,2860013,Highville Charter School District,Highville Charter School,164,136,300,2008-09
2640113,2640013,Integrated Day Charter School District,Integrated Day Charter School,152,178,330,2008-09
2655113,2650013,Interdistrict School for Arts and Comm District,Interdistrict School For Arts And Communication,87,95,182,2008-09
2610113,2610013,Jumoke Academy District,Jumoke Academy,228,184,412,2008-09
0680111,0680011,Kent School District,Kent Center School,137,147,284,2008-09
0698011,0690011,Killingly School District,Goodyear Early Childhood Center,35,48,83,2008-09
0690111,0690011,Killingly School District,Killingly Central School,221,244,465,2008-09
0696111,0690011,Killingly School District,Killingly High School,437,357,794,2008-09
0695211,0690011,Killingly School District,Killingly Intermediate School,375,457,832,2008-09
0690311,0690011,Killingly School District,Killingly Memorial School,258,273,531,2008-09
2459014,2450014,Learn,Learn Special Education,*,*,29,2008-09
2450114,2450014,Learn,Regional Multicultural Magnet School,265,244,509,2008-09
2450214,2450014,Learn,The Friendship School,238,261,499,2008-09
0710111,0710011,Lebanon School District,Lebanon Elementary School,246,275,521,2008-09
0715111,0710011,Lebanon School District,Lebanon Middle School,215,198,413,2008-09
0716211,0710011,Lebanon School District,Lyman Memorial High School,332,267,599,2008-09
0720211,0720011,Ledyard School District,Gales Ferry School,91,117,208,2008-09
0720411,0720011,Ledyard School District,Gallup Hill School,165,180,345,2008-09
0720311,0720011,Ledyard School District,Juliet W. Long School,171,180,351,2008-09
0720111,0720011,Ledyard School District,Ledyard Center School,211,193,404,2008-09
0726111,0720011,Ledyard School District,Ledyard High School,529,448,977,2008-09
0725111,0720011,Ledyard School District,Ledyard Middle School,209,246,455,2008-09
0736011,0730011,Lisbon School District,Community Connection - The Big Picture High School,*,*,*,2008-09
0730111,0730011,Lisbon School District,Lisbon Central School,261,296,557,2008-09
0740211,0740011,Litchfield School District,Center School,173,175,348,2008-09
0746111,0740011,Litchfield School District,Litchfield High School,302,276,578,2008-09
0740311,0740011,Litchfield School District,Litchfield Intermediate School,136,140,276,2008-09
0766111,0760011,Madison School District,Daniel Hand High School,601,629,1230,2008-09
0760611,0760011,Madison School District,Dr. Robert H. Brown Middle School,302,291,593,2008-09
0760211,0760011,Madison School District,Island Avenue Elementary School,173,150,323,2008-09
0760111,0760011,Madison School District,J. Milton Jeffrey Elementary School,285,319,604,2008-09
0760311,0760011,Madison School District,Kathleen H. Ryerson Elementary School,149,171,320,2008-09
0765211,0760011,Madison School District,Walter C. Polson Upper Middle School,328,311,639,2008-09
0770911,0770011,Manchester School District,Nathan Hale School,150,161,311,2008-09
0770111,0770011,Manchester School District,Bowers School,180,232,412,2008-09
0770311,0770011,Manchester School District,Buckley School,157,156,313,2008-09
0771711,0770011,Manchester School District,Elisabeth M. Bennet Academy,220,247,467,2008-09
0770411,0770011,Manchester School District,Highland Park School,124,158,282,2008-09
0775311,0770011,Manchester School District,Illing Middle School,418,453,871,2008-09
0770611,0770011,Manchester School District,Keeney School,191,204,395,2008-09
0776111,0770011,Manchester School District,Manchester High School,1035,1002,2037,2008-09
0779011,0770011,Manchester School District,Manchester Regional Academy,17,75,92,2008-09
0771611,0770011,Manchester School District,Martin School,101,107,208,2008-09
0771011,0770011,Manchester School District,Robertson School,195,225,420,2008-09
0771211,0770011,Manchester School District,Verplanck School,192,203,395,2008-09
0771311,0770011,Manchester School District,Waddell School,158,178,336,2008-09
0771411,0770011,Manchester School District,Washington School,154,170,324,2008-09
0780411,0780011,Mansfield School District,Annie E. Vinton School,114,135,249,2008-09
0780211,0780011,Mansfield School District,Dorothy C. Goodwin School,91,111,202,2008-09
0785111,0780011,Mansfield School District,Mansfield Middle School,281,299,580,2008-09
0780511,0780011,Mansfield School District,Southeast Elementary School,122,125,247,2008-09
0790111,0790011,Marlborough School District,Elmer Thienes-Mary Hall Elementary School,357,316,673,2008-09
0800711,0800011,Meriden School District,Nathan Hale School,317,331,648,2008-09
0800111,0800011,Meriden School District,Benjamin Franklin School,212,254,466,2008-09
0801111,0800011,Meriden School District,Casimir Pulaski School,350,346,696,2008-09
0806111,0800011,Meriden School District,Francis T. Maloney High School,654,630,1284,2008-09
0800311,0800011,Meriden School District,Hanover School,233,287,520,2008-09
0800411,0800011,Meriden School District,Israel Putnam School,250,311,561,2008-09
0800511,0800011,Meriden School District,John Barry School,265,268,533,2008-09
0805211,0800011,Meriden School District,Lincoln Middle School,339,413,752,2008-09
0806211,0800011,Meriden School District,Orville H. Platt High School,596,586,1182,2008-09
0800811,0800011,Meriden School District,Roger Sherman School,249,305,554,2008-09
0801011,0800011,Meriden School District,Thomas Hooker School,244,262,506,2008-09
0805411,0800011,Meriden School District,Washington Middle School,450,461,911,2008-09
0830211,0830011,Middletown School District,Bielefield School,162,155,317,2008-09
0839011,0830011,Middletown School District,DEAL Program,*,*,25,2008-09
0830511,0830011,Middletown School District,Farm Hill School,148,155,303,2008-09
0831511,0830011,Middletown School District,Keigwin Middle School,183,192,375,2008-09
0831311,0830011,Middletown School District,Lawrence School,151,163,314,2008-09
0830911,0830011,Middletown School District,MacDonough School,111,107,218,2008-09
0836211,0830011,Middletown School District,Middletown High School,677,662,1339,2008-09
0831211,0830011,Middletown School District,Moody School,210,239,449,2008-09
0831111,0830011,Middletown School District,Snow School,172,180,352,2008-09
0830111,0830011,Middletown School District,Spencer School,181,187,368,2008-09
0831411,0830011,Middletown School District,Wesley School,172,177,349,2008-09
0835411,0830011,Middletown School District,Woodrow Wilson Middle School,341,388,729,2008-09
0840111,0840011,Milford School District,Calf Pen Meadow School,155,166,321,2008-09
0845111,0840011,Milford School District,East Shore Middle School,285,329,614,2008-09
0845211,0840011,Milford School District,Harborside Middle School,274,281,555,2008-09
0841911,0840011,Milford School District,J. F. Kennedy School,198,194,392,2008-09
0846211,0840011,Milford School District,Jonathan Law High School,542,513,1055,2008-09
0846311,0840011,Milford School District,Joseph A. Foran High School,541,490,1031,2008-09
0841611,0840011,Milford School District,Live Oaks School,154,191,345,2008-09
0841711,0840011,Milford School District,Mathewson School,228,244,472,2008-09
0840711,0840011,Milford School District,Meadowside School,176,184,360,2008-09
0840811,0840011,Milford School District,Orange Avenue School,236,249,485,2008-09
0841811,0840011,Milford School District,Orchard Hills School,197,230,427,2008-09
0841011,0840011,Milford School District,Pumpkin Delight School,134,176,310,2008-09
0841411,0840011,Milford School District,Simon Lake School,182,181,363,2008-09
0845311,0840011,Milford School District,West Shore Middle School,286,289,575,2008-09
0850611,0850011,Monroe School District,Chalk Hill School,308,331,639,2008-09
0850511,0850011,Monroe School District,Fawn Hollow Elementary School,269,296,565,2008-09
0855211,0850011,Monroe School District,Jockey Hollow School,329,330,659,2008-09
0856111,0850011,Monroe School District,Masuk High School,644,701,1345,2008-09
0850111,0850011,Monroe School District,Monroe Elementary School,157,191,348,2008-09
0850311,0850011,Monroe School District,Stepney Elementary School,236,253,489,2008-09
0860711,0860011,Montville School District,Dr. Charles E. Murphy School,192,204,396,2008-09
0865111,0860011,Montville School District,Leonard J. Tyl Middle School,298,345,643,2008-09
0860111,0860011,Montville School District,Mohegan School,227,198,425,2008-09
0866111,0860011,Montville School District,Montville High School,420,410,830,2008-09
0860511,0860011,Montville School District,Oakdale School,218,242,460,2008-09
0869011,0860011,Montville School District,Palmer Academy,8,15,23,2008-09
0880811,0880011,Naugatuck School District,Andrew Avenue School,88,139,227,2008-09
0880111,0880011,Naugatuck School District,Central Avenue School,165,140,305,2008-09
0885111,0880011,Naugatuck School District,City Hill Middle School,217,255,472,2008-09
0880211,0880011,Naugatuck School District,Cross Street Intermediate School,190,217,407,2008-09
0888111,0880011,Naugatuck School District,Head Start,49,53,102,2008-09
0880411,0880011,Naugatuck School District,Hillside Intermediate School,162,191,353,2008-09
0885211,0880011,Naugatuck School District,Hillside Middle School,150,155,305,2008-09
0880511,0880011,Naugatuck School District,Hop Brook Elementary School,158,152,310,2008-09
0880311,0880011,Naugatuck School District,Maple Hill School,218,237,455,2008-09
0886111,0880011,Naugatuck School District,Naugatuck High School,658,709,1367,2008-09
0880611,0880011,Naugatuck School District,Salem School,113,137,250,2008-09
0880711,0880011,Naugatuck School District,Western School,117,145,262,2008-09
2800113,2800013,New Beginnings Inc Family Academy District,New Beginnings Inc Family Academy,193,165,358,2008-09
0890311,0890011,New Britain School District,Chamberlain  Elementary School,187,251,438,2008-09
0891111,0890011,New Britain School District,Frank J. DiLoreto School,472,323,795,2008-09
0890511,0890011,New Britain School District,Gaffney School,194,296,490,2008-09
0890611,0890011,New Britain School District,Holmes School,214,279,493,2008-09
0895411,0890011,New Britain School District,House of Arts Letters and Science (HALS)  Academy,88,74,162,2008-09
0890711,0890011,New Britain School District,Jefferson School,172,227,399,2008-09
0890811,0890011,New Britain School District,Lincoln School,317,304,621,2008-09
0896111,0890011,New Britain School District,New Britain High School,1433,1539,2972,2008-09
0890911,0890011,New Britain School District,Northend School,146,149,295,2008-09
0895311,0890011,New Britain School District,Pulaski Middle School,317,387,704,2008-09
0895111,0890011,New Britain School District,Roosevelt Middle School,224,253,477,2008-09
0895211,0890011,New Britain School District,Slade Middle School,335,328,663,2008-09
0891211,0890011,New Britain School District,Smalley Academy,361,372,733,2008-09
0891311,0890011,New Britain School District,Smith School,297,341,638,2008-09
0891511,0890011,New Britain School District,Vance School,266,259,525,2008-09
0900411,0900011,New Canaan School District,East School,279,268,547,2008-09
0906111,0900011,New Canaan School District,New Canaan High School,605,617,1222,2008-09
0905111,0900011,New Canaan School District,Saxe Middle School,647,619,1266,2008-09
0900211,0900011,New Canaan School District,South School,255,280,535,2008-09
0900311,0900011,New Canaan School District,West School,256,263,519,2008-09
0910111,0910011,New Fairfield School District,Consolidated School,307,357,664,2008-09
0910211,0910011,New Fairfield School District,Meeting House Hill School,292,376,668,2008-09
0916111,0910011,New Fairfield School District,New Fairfield High School,470,502,972,2008-09
0915211,0910011,New Fairfield School District,New Fairfield Middle School,362,386,748,2008-09
0920311,0920011,New Hartford School District,Ann Antolini School,165,173,338,2008-09
0920111,0920011,New Hartford School District,Bakerville Consolidated School,80,79,159,2008-09
0929011,0920011,New Hartford School District,Bridges I,*,*,7,2008-09
0920211,0920011,New Hartford School District,New Hartford Elementary School,59,57,116,2008-09
0931211,0930011,New Haven School District,Edgewood School,221,230,451,2008-09
0931411,0930011,New Haven School District,Nathan Hale School,280,275,555,2008-09
0931511,0930011,New Haven School District,Augusta Lewis Troup School,251,298,549,2008-09
0930211,0930011,New Haven School District,Barnard Environmental Magnet School,226,253,479,2008-09
0930311,0930011,New Haven School District,Beecher School,226,266,492,2008-09
0931811,0930011,New Haven School District,Benjamin Jepson Magnet School,210,262,472,2008-09
0935511,0930011,New Haven School District,Betsy Ross Arts Magnet School,298,160,458,2008-09
0934311,0930011,New Haven School District,Bishop Woods Architecture and Design Magnet School,159,194,353,2008-09
0934811,0930011,New Haven School District,"Celentano BioTech, Health and Medical Magnet School",216,251,467,2008-09
0930511,0930011,New Haven School District,Clarence Rogers School,67,65,132,2008-09
0930611,0930011,New Haven School District,Clinton Avenue School,267,279,546,2008-09
0934111,0930011,New Haven School District,Columbus Family Academy,217,179,396,2008-09
0933111,0930011,New Haven School District,Conte/West Hills Magnet School,336,293,629,2008-09
0936411,0930011,New Haven School District,Cooperative High School,304,150,454,2008-09
0936811,0930011,New Haven School District,Cortlandt V.R. Creed Health and Sport Sciences High School,42,150,192,2008-09
0930911,0930011,New Haven School District,Davis 21st Century Magnet Elementary School,178,213,391,2008-09
0938211,0930011,New Haven School District,Dwight Early Childhood Program,21,22,43,2008-09
0938111,0930011,New Haven School District,Early Learning Center,51,56,107,2008-09
0934611,0930011,New Haven School District,East Rock Community Magnet School,268,322,590,2008-09
0931711,0930011,New Haven School District,Engineering - Science University Magnet School,23,57,80,2008-09
0931611,0930011,New Haven School District,Fair Haven School,273,288,561,2008-09
0938011,0930011,New Haven School District,Headstart,209,204,413,2008-09
0938311,0930011,New Haven School District,Helene Grant HeadStart,200,222,422,2008-09
0936611,0930011,New Haven School District,High School In The Community,183,128,311,2008-09
0930711,0930011,New Haven School District,Hill Central Music Academy,216,223,439,2008-09
0936311,0930011,New Haven School District,Hill Regional Career High School,437,272,709,2008-09
0936211,0930011,New Haven School District,James Hillhouse High School,502,513,1015,2008-09
0931311,0930011,New Haven School District,John C. Daniels,288,242,530,2008-09
0930811,0930011,New Haven School District,John S. Martinez Sea and Sky STEM School,311,269,580,2008-09
0930411,0930011,New Haven School District,Katherine Brennan School,89,105,194,2008-09
0933011,0930011,New Haven School District,King/Robinson Magnet School,209,232,441,2008-09
0932011,0930011,New Haven School District,Lincoln-Bassett School,147,176,323,2008-09
0936011,0930011,New Haven School District,Metropolitan Business Academy,74,70,144,2008-09
0937011,0930011,New Haven School District,New Haven Academy,112,88,200,2008-09
0936511,0930011,New Haven School District,Polly T. McCabe Center,33,0,33,2008-09
0936911,0930011,New Haven School District,Riverside Education Academy,78,80,158,2008-09
0934211,0930011,New Haven School District,Roberto Clemente Leadership Academy for Global Awareness,195,194,389,2008-09
0931011,0930011,New Haven School District,Ross/Woodward School,248,285,533,2008-09
0935311,0930011,New Haven School District,Sheridan Communications and Technology Magnet School,57,138,195,2008-09
0936711,0930011,New Haven School District,Sound School,152,180,332,2008-09
0932811,0930011,New Haven School District,Strong 21st Century Communications Magnet and SCSU Lab School,103,96,199,2008-09
0932911,0930011,New Haven School District,Truman School,285,271,556,2008-09
0935111,0930011,New Haven School District,Urban Youth Center Middle School,7,27,34,2008-09
0932511,0930011,New Haven School District,"Vincent E. Mauro Elementary Math, Science and Technology Magnet School",200,240,440,2008-09
0934911,0930011,New Haven School District,West Rock Authors Academy,106,120,226,2008-09
0933211,0930011,New Haven School District,Wexler/Grant Community School,222,230,452,2008-09
0936111,0930011,New Haven School District,Wilbur Cross High School,798,863,1661,2008-09
0933811,0930011,New Haven School District,Worthington Hooker School,206,199,405,2008-09
0950311,0950011,New London School District,Jennings School,285,288,573,2008-09
0955111,0950011,New London School District,Bennie Dover Jackson Middle School,275,346,621,2008-09
0955211,0950011,New London School District,Dual Language Arts Academy/Academia Bilingue de las Artes,32,18,50,2008-09
0950211,0950011,New London School District,Harbor School,156,176,332,2008-09
0950911,0950011,New London School District,Nathan Hale Arts Magnet School,142,164,306,2008-09
0959111,0950011,New London School District,New London Clinical Day Program,*,*,16,2008-09
0956111,0950011,New London School District,New London High School,388,483,871,2008-09
0950511,0950011,New London School District,Shoreline Academy,42,49,91,2008-09
0950811,0950011,New London School District,Winthrop STEM Elementary Magnet School,89,136,225,2008-09
0960511,0960011,New Milford School District,Hill And Plain School,210,251,461,2008-09
0960711,0960011,New Milford School District,John Pettibone School,226,253,479,2008-09
0966111,0960011,New Milford School District,New Milford High School,769,773,1542,2008-09
0960811,0960011,New Milford School District,Northville Elementary School,251,290,541,2008-09
0960911,0960011,New Milford School District,Sarah Noble Intermediate School,535,560,1095,2008-09
0965211,0960011,New Milford School District,Schaghticoke Middle School,407,369,776,2008-09
0940611,0940011,Newington School District,Anna Reynolds School,219,236,455,2008-09
0940211,0940011,Newington School District,Elizabeth Green School,145,163,308,2008-09
0940811,0940011,Newington School District,John Paterson School,221,250,471,2008-09
0945311,0940011,Newington School District,John Wallace Middle School,375,376,751,2008-09
0945111,0940011,Newington School District,Martin Kellogg Middle School,322,359,681,2008-09
0946111,0940011,Newington School District,Newington High School,702,763,1465,2008-09
0940711,0940011,Newington School District,Ruth Chaffee School,194,185,379,2008-09
0970111,0970011,Newtown School District,Hawley Elementary School,194,209,403,2008-09
0970411,0970011,Newtown School District,Head O'Meadow Elementary School,197,233,430,2008-09
0970311,0970011,Newtown School District,Middle Gate Elementary School,259,257,516,2008-09
0976111,0970011,Newtown School District,Newtown High School,860,844,1704,2008-09
0975111,0970011,Newtown School District,Newtown Middle School,446,483,929,2008-09
0978011,0970011,Newtown School District,Newtown Preschool,23,31,54,2008-09
0978111,0970011,Newtown School District,Newtown Preschool at RIS,9,21,30,2008-09
0970511,0970011,Newtown School District,Reed Intermediate School,443,459,902,2008-09
0970211,0970011,Newtown School District,Sandy Hook Elementary School,289,344,633,2008-09
0980111,0980011,Norfolk School District,Botelle Elementary School,75,79,154,2008-09
0989011,0980011,Norfolk School District,IEP Program,*,*,*,2008-09
0990411,0990011,North Branford School District,Jerome Harrison School,167,172,339,2008-09
0996111,0990011,North Branford School District,North Branford High School,352,349,701,2008-09
0995111,0990011,North Branford School District,North Branford Intermediate School,303,319,622,2008-09
0990511,0990011,North Branford School District,Stanley T. Williams School,132,118,250,2008-09
0990611,0990011,North Branford School District,Totoket Valley Elementary School,241,245,486,2008-09
1000111,1000011,North Canaan School District,North Canaan Elementary School,180,158,338,2008-09
1010811,1010011,North Haven School District,Clintonville Elementary School,151,202,353,2008-09
1010711,1010011,North Haven School District,Green Acres Elementary School,212,214,426,2008-09
1010211,1010011,North Haven School District,Montowese Elementary School,254,224,478,2008-09
1016111,1010011,North Haven School District,North Haven High School,630,592,1222,2008-09
1015211,1010011,North Haven School District,North Haven Middle School,445,464,909,2008-09
1010311,1010011,North Haven School District,Ridge Road Elementary School,201,218,419,2008-09
1020111,1020011,North Stonington School District,North Stonington Elementary School,174,207,381,2008-09
1026111,1020011,North Stonington School District,Wheeler High School,101,126,227,2008-09
1025111,1020011,North Stonington School District,Wheeler Middle School,89,97,186,2008-09
1036211,1030011,Norwalk School District,Brien McMahon High School,856,852,1708,2008-09
1030211,1030011,Norwalk School District,Brookside Elementary School,195,240,435,2008-09
1030311,1030011,Norwalk School District,Columbus Magnet School,176,162,338,2008-09
1030411,1030011,Norwalk School District,Cranbury Elementary School,214,252,466,2008-09
1032011,1030011,Norwalk School District,Fox Run Elementary School,202,250,452,2008-09
1030711,1030011,Norwalk School District,Jefferson Magnet School,253,265,518,2008-09
1030811,1030011,Norwalk School District,Kendall Elementary School,205,267,472,2008-09
1032211,1030011,Norwalk School District,Marvin Elementary School,216,233,449,2008-09
1032111,1030011,Norwalk School District,Naramake Elementary School,204,201,405,2008-09
1035211,1030011,Norwalk School District,Nathan Hale Middle School,258,275,533,2008-09
1036111,1030011,Norwalk School District,Norwalk High School,751,764,1515,2008-09
1036311,1030011,Norwalk School District,Norwalk Pathways Academy at Briggs,46,60,106,2008-09
1035311,1030011,Norwalk School District,Ponus Ridge Middle School,315,370,685,2008-09
1035511,1030011,Norwalk School District,Roton Middle School,218,194,412,2008-09
1031311,1030011,Norwalk School District,Rowayton School,217,227,444,2008-09
1032311,1030011,Norwalk School District,Silvermine Elementary School,179,177,356,2008-09
1031411,1030011,Norwalk School District,Tracey School,206,227,433,2008-09
1035411,1030011,Norwalk School District,West Rocks Middle School,344,363,707,2008-09
1032411,1030011,Norwalk School District,Wolfpit School,150,160,310,2008-09
9016122,9010022,Norwich Free Academy District,Norwich Free Academy,1286,1202,2488,2008-09
1040111,1040011,Norwich School District,Bishop School Early Learning Center,86,87,173,2008-09
1049111,1040011,Norwich School District,Deborah-Tennant Zinewicz  School,12,35,47,2008-09
1040611,1040011,Norwich School District,Greeneville School,157,169,326,2008-09
1049011,1040011,Norwich School District,Hickory Street School,*,*,14,2008-09
1041411,1040011,Norwich School District,John B. Stanton Network School,187,202,389,2008-09
1045111,1040011,Norwich School District,Kelly Middle School,349,329,678,2008-09
1042011,1040011,Norwich School District,Moriarty Magnet School,195,234,429,2008-09
1040811,1040011,Norwich School District,Samuel Huntington School,163,215,378,2008-09
1045211,1040011,Norwich School District,Teachers' Memorial Middle School,242,230,472,2008-09
1046111,1040011,Norwich School District,Thames River Academy,40,51,91,2008-09
1041711,1040011,Norwich School District,Thomas W. Mahan School,166,123,289,2008-09
1041911,1040011,Norwich School District,Uncas Network School,82,96,178,2008-09
1041811,1040011,Norwich School District,Veterans' Memorial School,101,133,234,2008-09
1041511,1040011,Norwich School District,Wequonnoc Magnet School,107,118,225,2008-09
2635113,2630013,Odyssey Community School District,Odyssey Community School,95,83,178,2008-09
1060211,1060011,Old Saybrook School District,Kathleen E. Goodwin School,244,243,487,2008-09
1065211,1060011,Old Saybrook School District,Old Saybrook Middle School,304,305,609,2008-09
1066111,1060011,Old Saybrook School District,Old Saybrook Senior High School,262,263,525,2008-09
1070211,1070011,Orange School District,Mary L. Tracy School,95,89,184,2008-09
1070511,1070011,Orange School District,Peck Place School,220,219,439,2008-09
1070311,1070011,Orange School District,Race Brook School,201,194,395,2008-09
1070411,1070011,Orange School District,Turkey Hill School,139,159,298,2008-09
1085111,1080011,Oxford School District,Great Oak School,247,243,490,2008-09
1080111,1080011,Oxford School District,Oxford Center School,264,269,533,2008-09
1086011,1080011,Oxford School District,Oxford High School,194,224,418,2008-09
1080311,1080011,Oxford School District,Quaker Farms School,274,299,573,2008-09
2835113,2830013,Park City Prep Charter School District,Park City Prep Charter School,110,114,224,2008-09
1090511,1090011,Plainfield School District,Early Childhood Center,136,141,277,2008-09
1090111,1090011,Plainfield School District,Moosup Elementary School,140,147,287,2008-09
1095111,1090011,Plainfield School District,Plainfield Central School,261,299,560,2008-09
1096111,1090011,Plainfield School District,Plainfield High School,449,424,873,2008-09
1090311,1090011,Plainfield School District,Plainfield Memorial School,195,203,398,2008-09
1090411,1090011,Plainfield School District,Shepard Hill Elementary School,145,163,308,2008-09
1100411,1100011,Plainville School District,Frank T. Wheeler School,147,167,314,2008-09
1100211,1100011,Plainville School District,Linden Street School,203,205,408,2008-09
1100511,1100011,Plainville School District,Louis Toffolon School,171,167,338,2008-09
1105211,1100011,Plainville School District,Middle School of Plainville,282,298,580,2008-09
1106111,1100011,Plainville School District,Plainville High School,406,435,841,2008-09
1108011,1100011,Plainville School District,Prekindergarten Program,17,22,39,2008-09
1115111,1110011,Plymouth School District,Eli Terry Jr. Middle School,202,273,475,2008-09
1110411,1110011,Plymouth School District,Harry S. Fisher Elementary School,209,191,400,2008-09
1110211,1110011,Plymouth School District,Plymouth Center School,175,242,417,2008-09
1116111,1110011,Plymouth School District,Terryville High School,267,289,556,2008-09
1120111,1120011,Pomfret School District,Pomfret Community School,287,253,540,2008-09
1130511,1130011,Portland School District,Brownstone Intermediate School,107,122,229,2008-09
1130411,1130011,Portland School District,Gildersleeve School,120,109,229,2008-09
1136111,1130011,Portland School District,Portland High School,181,181,362,2008-09
1135111,1130011,Portland School District,Portland Middle School,112,133,245,2008-09
1130211,1130011,Portland School District,Valley View School,190,174,364,2008-09
1145111,1140011,Preston School District,Preston Plains School,82,86,168,2008-09
1140411,1140011,Preston School District,Preston Veterans' Memorial School,157,163,320,2008-09
1169011,1160011,Putnam School District,Helping Hands,*,*,*,2008-09
1160311,1160011,Putnam School District,Putnam Elementary School,316,330,646,2008-09
1166111,1160011,Putnam School District,Putnam High School,164,161,325,2008-09
1165111,1160011,Putnam School District,Putnam Middle School,113,157,270,2008-09
1175111,1170011,Redding School District,John Read Middle School,315,272,587,2008-09
1170111,1170011,Redding School District,Redding Elementary School,351,363,714,2008-09
2016112,2010012,Regional School District 01,Housatonic Valley Regional High School,279,276,555,2008-09
2045112,2040012,Regional School District 04,John Winthrop Middle School,178,154,332,2008-09
2046112,2040012,Regional School District 04,Valley Regional High School,297,320,617,2008-09
2055112,2050012,Regional School District 05,Amity Middle School: Bethany,189,211,400,2008-09
2055212,2050012,Regional School District 05,Amity Middle School: Orange,201,230,431,2008-09
2056112,2050012,Regional School District 05,Amity Regional High School,810,847,1657,2008-09
2060112,2060012,Regional School District 06,Goshen Center School,116,99,215,2008-09
2060212,2060012,Regional School District 06,James Morris School,91,117,208,2008-09
2068012,2060012,Regional School District 06,Stepping Stones Preschool Program,*,*,10,2008-09
2066112,2060012,Regional School District 06,Wamogo Regional High School,282,277,559,2008-09
2060312,2060012,Regional School District 06,Warren Elementary School,45,45,90,2008-09
2079112,2070012,Regional School District 07,AIM,*,*,9,2008-09
2079012,2070012,Regional School District 07,FLEX,*,*,12,2008-09
2079412,2070012,Regional School District 07,Intensive Learning Program,0,*,*,2008-09
2079212,2070012,Regional School District 07,Links,11,10,21,2008-09
2076112,2070012,Regional School District 07,Northwestern Regional High School,421,332,753,2008-09
2075112,2070012,Regional School District 07,Northwestern Regional Middle School,188,170,358,2008-09
2079312,2070012,Regional School District 07,STEP,13,20,33,2008-09
2086112,2080012,Regional School District 08,RHAM High School,518,566,1084,2008-09
2085112,2080012,Regional School District 08,RHAM Middle School,305,355,660,2008-09
2096112,2090012,Regional School District 09,Joel Barlow High School,488,469,957,2008-09
2105112,2100012,Regional School District 10,Har-Bur Middle School,420,469,889,2008-09
2100312,2100012,Regional School District 10,Harwinton Consolidated School,244,264,508,2008-09
2100212,2100012,Regional School District 10,Lake Garda Elementary School,304,316,620,2008-09
2106112,2100012,Regional School District 10,Lewis S. Mills High School,403,427,830,2008-09
2116112,2110012,Regional School District 11,Parish Hill High School,154,155,309,2008-09
2120212,2120012,Regional School District 12,Booth Free School,60,61,121,2008-09
2128012,2120012,Regional School District 12,Early Childhood Education Center,14,7,21,2008-09
2126112,2120012,Regional School District 12,Shepaug Valley High School,171,176,347,2008-09
2125112,2120012,Regional School District 12,Shepaug Valley Middle School,112,132,244,2008-09
2120112,2120012,Regional School District 12,The Burnham School,39,55,94,2008-09
2120412,2120012,Regional School District 12,Washington Primary School,87,97,184,2008-09
2136112,2130012,Regional School District 13,Coginchaug Regional High School,285,284,569,2008-09
2130212,2130012,Regional School District 13,Francis E. Korn School,88,111,199,2008-09
2135112,2130012,Regional School District 13,Frank Ward Strong School,185,165,350,2008-09
2130112,2130012,Regional School District 13,Frederick Brewster School,122,187,309,2008-09
2130512,2130012,Regional School District 13,John Lyman School,175,171,346,2008-09
2130412,2130012,Regional School District 13,Middlefield Memorial School,179,174,353,2008-09
2140112,2140012,Regional School District 14,Bethlehem Elementary School,186,194,380,2008-09
2148012,2140012,Regional School District 14,Integrated Star Preschool Program,*,*,10,2008-09
2140212,2140012,Regional School District 14,Mitchell Elementary School,202,205,407,2008-09
2146112,2140012,Regional School District 14,Nonnewaug High School,450,393,843,2008-09
2145112,2140012,Regional School District 14,Woodbury Middle School,248,239,487,2008-09
2150412,2150012,Regional School District 15,Gainfield Elementary School,208,232,440,2008-09
2150712,2150012,Regional School District 15,Long Meadow Elementary School,300,317,617,2008-09
2155212,2150012,Regional School District 15,Memorial Middle School,252,267,519,2008-09
2150612,2150012,Regional School District 15,Middlebury Elementary School,221,246,467,2008-09
2156212,2150012,Regional School District 15,Pomperaug Regional High School,687,717,1404,2008-09
2150512,2150012,Regional School District 15,Pomperaug School,238,293,531,2008-09
2155112,2150012,Regional School District 15,Rochambeau Middle School,273,293,566,2008-09
2160312,2160012,Regional School District 16,Algonquin School,238,241,479,2008-09
2160212,2160012,Regional School District 16,Community School,136,120,256,2008-09
2160112,2160012,Regional School District 16,Laurel Ledge School,221,247,468,2008-09
2165112,2160012,Regional School District 16,Long River Middle School,312,309,621,2008-09
2166012,2160012,Regional School District 16,Woodland Regional High School,375,409,784,2008-09
2170212,2170012,Regional School District 17,Burr District Elementary School,139,155,294,2008-09
2170112,2170012,Regional School District 17,Haddam Elementary School,125,142,267,2008-09
2176112,2170012,Regional School District 17,Haddam-Killingworth High School,346,370,716,2008-09
2175112,2170012,Regional School District 17,Haddam-Killingworth Middle School,393,419,812,2008-09
2170312,2170012,Regional School District 17,Killingworth Elementary School,231,222,453,2008-09
2180312,2180012,Regional School District 18,Center School,116,123,239,2008-09
2180112,2180012,Regional School District 18,Lyme Consolidated School,80,77,157,2008-09
2186112,2180012,Regional School District 18,Lyme-Old Lyme High School,217,228,445,2008-09
2185112,2180012,Regional School District 18,Lyme-Old Lyme Middle School,165,171,336,2008-09
2180212,2180012,Regional School District 18,Mile Creek School,147,138,285,2008-09
2196112,2190012,Regional School District 19,E. O. Smith High School,595,575,1170,2008-09
1180811,1180011,Ridgefield School District,Barlow Mountain Elementary School,191,238,429,2008-09
1180611,1180011,Ridgefield School District,Branchville Elementary School,221,210,431,2008-09
1185111,1180011,Ridgefield School District,East Ridge Middle School,352,396,748,2008-09
1180411,1180011,Ridgefield School District,Farmingville Elementary School,180,189,369,2008-09
1180311,1180011,Ridgefield School District,Ridgebury Elementary School,217,238,455,2008-09
1186111,1180011,Ridgefield School District,Ridgefield High School,897,883,1780,2008-09
1180511,1180011,Ridgefield School District,Scotland Elementary School,180,215,395,2008-09
1185211,1180011,Ridgefield School District,Scotts Ridge Middle School,286,306,592,2008-09
1180211,1180011,Ridgefield School District,Veterans Park Elementary School,155,182,337,2008-09
1195111,1190011,Rocky Hill School District,Albert D. Griswold Middle School,304,291,595,2008-09
1190211,1190011,Rocky Hill School District,Dr. Oran A. Moser School,36,40,76,2008-09
1190411,1190011,Rocky Hill School District,Myrtle H. Stevens School,234,284,518,2008-09
1196111,1190011,Rocky Hill School District,Rocky Hill High School,389,387,776,2008-09
1190511,1190011,Rocky Hill School District,West Hill School,328,320,648,2008-09
1210111,1210011,Salem School District,Salem Elementary School,253,267,520,2008-09
1220111,1220011,Salisbury School District,Salisbury Central School,153,166,319,2008-09
1230111,1230011,Scotland School District,Scotland Elementary School,96,94,190,2008-09
1240311,1240011,Seymour School District,Anna L. Lopresti School,162,158,320,2008-09
1240111,1240011,Seymour School District,Bungay School,278,298,576,2008-09
1240411,1240011,Seymour School District,Paul E. Chatfield School,150,159,309,2008-09
1246111,1240011,Seymour School District,Seymour High School,406,387,793,2008-09
1245111,1240011,Seymour School District,Seymour Middle School,268,302,570,2008-09
1250111,1250011,Sharon School District,Sharon Center School,100,96,196,2008-09
1260911,1260011,Shelton School District,Mohegan School,314,325,639,2008-09
1261011,1260011,Shelton School District,Booth Hill School,243,259,502,2008-09
1260511,1260011,Shelton School District,Elizabeth Shelton School,283,322,605,2008-09
1265111,1260011,Shelton School District,Intermediate School,428,447,875,2008-09
1260411,1260011,Shelton School District,Lafayette School,176,188,364,2008-09
1260811,1260011,Shelton School District,Long Hill School,310,308,618,2008-09
1266111,1260011,Shelton School District,Shelton High School,810,843,1653,2008-09
1260611,1260011,Shelton School District,Sunnyside School,125,166,291,2008-09
1270111,1270011,Sherman School District,Sherman School,224,234,458,2008-09
2700113,2700013,Side By Side Charter School District,Side By Side Charter School,112,117,229,2008-09
1280111,1280011,Simsbury School District,Central School,215,228,443,2008-09
1285111,1280011,Simsbury School District,Henry James Memorial School,400,438,838,2008-09
1280611,1280011,Simsbury School District,Latimer Lane School,246,277,523,2008-09
1286111,1280011,Simsbury School District,Simsbury High School,730,832,1562,2008-09
1280711,1280011,Simsbury School District,Squadron Line School,387,391,778,2008-09
1280311,1280011,Simsbury School District,Tariffville School,115,142,257,2008-09
1280411,1280011,Simsbury School District,Tootin' Hills School,237,294,531,2008-09
1295111,1290011,Somers School District,Mabelle B. Avery Middle School,206,218,424,2008-09
1290411,1290011,Somers School District,Somers Elementary School,332,383,715,2008-09
1296111,1290011,Somers School District,Somers High School,295,282,577,2008-09
1320211,1320011,South Windsor School District,Pleasant Valley School,216,229,445,2008-09
1320711,1320011,South Windsor School District,Eli Terry School,208,225,433,2008-09
1320611,1320011,South Windsor School District,Orchard Hill School,228,240,468,2008-09
1320111,1320011,South Windsor School District,Philip R. Smith School,200,215,415,2008-09
1326211,1320011,South Windsor School District,South Windsor High School,769,844,1613,2008-09
1325111,1320011,South Windsor School District,Timothy Edwards School,542,572,1114,2008-09
1320411,1320011,South Windsor School District,Wapping Elementary School,148,159,307,2008-09
1315311,1310011,Southington School District,John F. Kennedy Middle School,375,433,808,2008-09
1311511,1310011,Southington School District,Derynoski Elementary School,370,321,691,2008-09
1311311,1310011,Southington School District,Flanders Elementary School,163,159,322,2008-09
1310211,1310011,Southington School District,Hatton Elementary School,200,234,434,2008-09
1315111,1310011,Southington School District,Joseph A. Depaolo Middle School,378,374,752,2008-09
1310611,1310011,Southington School District,Plantsville Elementary School,94,119,213,2008-09
1310711,1310011,Southington School District,South End Elementary School,101,111,212,2008-09
1316211,1310011,Southington School District,Southington High School,1057,1041,2098,2008-09
1310811,1310011,Southington School District,Strong Elementary School,224,236,460,2008-09
1310911,1310011,Southington School District,Thalberg Elementary School,203,220,423,2008-09
1311411,1310011,Southington School District,Urbin T. Kelley School,192,221,413,2008-09
1330111,1330011,Sprague School District,Sayles School,174,180,354,2008-09
1340611,1340011,Stafford School District,Stafford Elementary School,281,268,549,2008-09
1346111,1340011,Stafford School District,Stafford High School,276,271,547,2008-09
1345211,1340011,Stafford School District,Stafford Middle School,221,203,424,2008-09
1340311,1340011,Stafford School District,Staffordville School,77,112,189,2008-09
1340411,1340011,Stafford School District,West Stafford School,87,107,194,2008-09
2826013,2820013,Stamford Academy District,Stamford Academy,49,82,131,2008-09
1355611,1350011,Stamford School District,Cloonan School,267,307,574,2008-09
1352011,1350011,Stamford School District,Davenport Ridge School,279,232,511,2008-09
1355311,1350011,Stamford School District,Dolan School,307,329,636,2008-09
1352211,1350011,Stamford School District,Hart School,191,235,426,2008-09
1351211,1350011,Stamford School District,Julia A. Stark School,279,317,596,2008-09
1350511,1350011,Stamford School District,K. T. Murphy School,277,263,540,2008-09
1350611,1350011,Stamford School District,Newfield School,297,332,629,2008-09
1351811,1350011,Stamford School District,Northeast School,413,381,794,2008-09
1358011,1350011,Stamford School District,Preschool Team,21,43,64,2008-09
1355811,1350011,Stamford School District,Rippowam Middle School,353,393,746,2008-09
1350811,1350011,Stamford School District,Rogers International School,265,268,533,2008-09
1350911,1350011,Stamford School District,Roxbury School,308,354,662,2008-09
1355711,1350011,Stamford School District,Scofield Middle School,309,306,615,2008-09
1351111,1350011,Stamford School District,Springdale School,276,296,572,2008-09
1356111,1350011,Stamford School District,Stamford High School,835,827,1662,2008-09
1352111,1350011,Stamford School District,Stillmeadow School,304,323,627,2008-09
1356411,1350011,Stamford School District,The Academy of Information Technology,219,386,605,2008-09
1351911,1350011,Stamford School District,Toquam Magnet School,222,265,487,2008-09
1355511,1350011,Stamford School District,Turn of River School,291,304,595,2008-09
1356311,1350011,Stamford School District,Westhill High School,1159,1180,2339,2008-09
1351411,1350011,Stamford School District,Westover School,312,336,648,2008-09
1360311,1360011,Sterling School District,Sterling Community School,236,277,513,2008-09
1370511,1370011,Stonington School District,Deans Mill School,257,262,519,2008-09
1375211,1370011,Stonington School District,Mystic Middle School,203,216,419,2008-09
1375111,1370011,Stonington School District,Pawcatuck Middle School,184,178,362,2008-09
1378011,1370011,Stonington School District,Special Needs Preschool Program,7,8,15,2008-09
1376111,1370011,Stonington School District,Stonington High School,373,411,784,2008-09
1370411,1370011,Stonington School District,West Broad Street School,86,92,178,2008-09
1370611,1370011,Stonington School District,West Vine Street School,115,116,231,2008-09
1381311,1380011,Stratford School District,Eli Whitney School,255,263,518,2008-09
1386211,1380011,Stratford School District,Bunnell High School,666,646,1312,2008-09
1380311,1380011,Stratford School District,Chapel School,261,270,531,2008-09
1385211,1380011,Stratford School District,David Wooster Middle School,282,289,571,2008-09
1380411,1380011,Stratford School District,Franklin School,182,176,358,2008-09
1385311,1380011,Stratford School District,Harry B. Flood Middle School,292,316,608,2008-09
1380811,1380011,Stratford School District,Lordship School,109,107,216,2008-09
1380911,1380011,Stratford School District,Nichols School,193,205,398,2008-09
1381011,1380011,Stratford School District,Second Hill Lane School,342,361,703,2008-09
1381511,1380011,Stratford School District,Stratford Academy - Johnson House,336,353,689,2008-09
1386111,1380011,Stratford School District,Stratford High School,499,489,988,2008-09
1389011,1380011,Stratford School District,Strive-Stratford,*,*,11,2008-09
1381411,1380011,Stratford School District,Wilcoxson School,202,194,396,2008-09
1390411,1390011,Suffield School District,A. Ward Spaulding School,274,270,544,2008-09
1390311,1390011,Suffield School District,McAlister Intermediate School,268,305,573,2008-09
1396111,1390011,Suffield School District,Suffield High School,441,396,837,2008-09
1395111,1390011,Suffield School District,Suffield Middle School,310,305,615,2008-09
2696113,2690013,The Bridge Academy District,The Bridge Academy,152,110,262,2008-09
9026122,9020022,The Gilbert School District,The Gilbert School,203,197,400,2008-09
1400111,1400011,Thomaston School District,Black Rock School,188,194,382,2008-09
1400211,1400011,Thomaston School District,Thomaston Center School,143,139,282,2008-09
1406211,1400011,Thomaston School District,Thomaston High School,271,284,555,2008-09
1410111,1410011,Thompson School District,Mary R. Fisher Elementary School,270,268,538,2008-09
1415111,1410011,Thompson School District,Thompson Middle School,210,249,459,2008-09
1416111,1410011,Thompson School District,Tourtellotte Memorial High School,195,197,392,2008-09
1420111,1420011,Tolland School District,Birch Grove Primary School,343,373,716,2008-09
1426111,1420011,Tolland School District,Tolland High School,439,460,899,2008-09
1420211,1420011,Tolland School District,Tolland Intermediate School,379,382,761,2008-09
1425111,1420011,Tolland School District,Tolland Middle School,363,408,771,2008-09
1430111,1430011,Torrington School District,East School,218,242,460,2008-09
1430211,1430011,Torrington School District,Forbes School,193,204,397,2008-09
1430811,1430011,Torrington School District,Southwest School,141,154,295,2008-09
1430911,1430011,Torrington School District,Torringford School,305,364,669,2008-09
1436111,1430011,Torrington School District,Torrington High School,597,644,1241,2008-09
1435111,1430011,Torrington School District,Torrington Middle School,526,588,1114,2008-09
1431311,1430011,Torrington School District,Vogel-Wetmore School,208,251,459,2008-09
2785113,2780013,Trailblazers Academy District,Trailblazers Academy,53,97,150,2008-09
1440111,1440011,Trumbull School District,Booth Hill School,265,249,514,2008-09
1440811,1440011,Trumbull School District,Daniels Farm School,260,235,495,2008-09
1441011,1440011,Trumbull School District,Frenchtown Elementary School,286,332,618,2008-09
1445211,1440011,Trumbull School District,Hillcrest Middle School,330,425,755,2008-09
1440411,1440011,Trumbull School District,Jane Ryan School,196,221,417,2008-09
1445111,1440011,Trumbull School District,Madison Middle School,438,414,852,2008-09
1440311,1440011,Trumbull School District,Middlebrook School,215,251,466,2008-09
1440911,1440011,Trumbull School District,Tashua School,219,243,462,2008-09
1448011,1440011,Trumbull School District,Trumbull Early Childhood Education Center,105,127,232,2008-09
1446111,1440011,Trumbull School District,Trumbull High School,1139,984,2123,2008-09
3361715,3360015,Unified School District #1,Bergin Correctional Institution,0,39,39,2008-09
3360115,3360015,Unified School District #1,Bridgeport Correctional Center,0,18,18,2008-09
3360215,3360015,Unified School District #1,Brooklyn Correctional Institution,0,6,6,2008-09
3360315,3360015,Unified School District #1,Cheshire Correctional Institution,0,30,30,2008-09
3362415,3360015,Unified School District #1,Corrigan/Radgowski Correctional Institution,0,36,36,2008-09
3360415,3360015,Unified School District #1,Enfield Correctional Institution,0,19,19,2008-09
3361915,3360015,Unified School District #1,Garner Correctional Institution,0,15,15,2008-09
3360515,3360015,Unified School District #1,Gates Correctional Institution,0,30,30,2008-09
3360615,3360015,Unified School District #1,Hartford Correctional Center,0,72,72,2008-09
3362215,3360015,Unified School District #1,MacDougall/Walker Correctional Institution,0,69,69,2008-09
3361115,3360015,Unified School District #1,Manson Youth Institution,0,464,464,2008-09
3360915,3360015,Unified School District #1,New Haven Correctional Center,0,22,22,2008-09
3362615,3360015,Unified School District #1,Northern Correctional Institution,0,19,19,2008-09
3361215,3360015,Unified School District #1,Osborn Correctional Institution,0,39,39,2008-09
3361315,3360015,Unified School District #1,Robinson Correctional Institution,0,41,41,2008-09
3361415,3360015,Unified School District #1,Webster Correctional Institution,0,17,17,2008-09
3361515,3360015,Unified School District #1,Willard/Cybulski Correctional Institution,0,23,23,2008-09
3362515,3360015,Unified School District #1,York Correctional Institution,*,*,59,2008-09
3470115,3470015,Unified School District #2,Children's Place School,26,14,40,2008-09
3476515,3470015,Unified School District #2,High Meadows,0,25,25,2008-09
3470315,3470015,Unified School District #2,Riverview School,21,39,60,2008-09
3476715,3470015,Unified School District #2,Walter G. Cady School,0,86,86,2008-09
1450111,1450011,Union School District,Union Elementary School,41,37,78,2008-09
1460311,1460011,Vernon School District,Northeast School,137,152,289,2008-09
1461411,1460011,Vernon School District,Center Road School,222,246,468,2008-09
1460111,1460011,Vernon School District,Lake Street School,134,152,286,2008-09
1460211,1460011,Vernon School District,Maple Street School,136,129,265,2008-09
1469011,1460011,Vernon School District,Next Step Program (AACBP),*,*,10,2008-09
1466111,1460011,Vernon School District,Rockville High School,612,553,1165,2008-09
1461011,1460011,Vernon School District,Skinner Road School,153,160,313,2008-09
1465111,1460011,Vernon School District,Vernon Center Middle School,373,414,787,2008-09
1470111,1470011,Voluntown School District,Voluntown Elementary School,169,137,306,2008-09
1480211,1480011,Wallingford School District,Highland School,166,152,318,2008-09
1489011,1480011,Wallingford School District,A.R.T.S. Academy,*,*,18,2008-09
1481011,1480011,Wallingford School District,Cook Hill School,191,224,415,2008-09
1485211,1480011,Wallingford School District,Dag Hammarskjold Middle School,375,343,718,2008-09
1480911,1480011,Wallingford School District,Evarts C. Stevens School,215,208,423,2008-09
1485311,1480011,Wallingford School District,James H. Moran Middle School,428,408,836,2008-09
1486111,1480011,Wallingford School District,Lyman Hall High School,621,555,1176,2008-09
1486211,1480011,Wallingford School District,Mark T. Sheehan High School,495,492,987,2008-09
1480111,1480011,Wallingford School District,Moses Y. Beach School,183,167,350,2008-09
1480311,1480011,Wallingford School District,Parker Farms School,172,177,349,2008-09
1481211,1480011,Wallingford School District,Pond Hill School,161,151,312,2008-09
1480411,1480011,Wallingford School District,Rock Hill School,173,178,351,2008-09
1480811,1480011,Wallingford School District,Yalesville School,264,267,531,2008-09
1511011,1510011,Waterbury School District,Brooklyn Elementary School,96,109,205,2008-09
1515211,1510011,Waterbury School District,West Side Middle School,602,674,1276,2008-09
1512311,1510011,Waterbury School District,Washington School,167,146,313,2008-09
1512111,1510011,Waterbury School District,B. W. Tinker School,251,304,555,2008-09
1510311,1510011,Waterbury School District,Barnard School,132,135,267,2008-09
1510511,1510011,Waterbury School District,Bucks Hill School,272,285,557,2008-09
1510611,1510011,Waterbury School District,Bunker Hill School,261,261,522,2008-09
1512711,1510011,Waterbury School District,Carrington School,237,295,532,2008-09
1516211,1510011,Waterbury School District,Crosby High School,652,684,1336,2008-09
1510911,1510011,Waterbury School District,Driggs School,252,323,575,2008-09
1519111,1510011,Waterbury School District,Enlightenment School,76,103,179,2008-09
1511411,1510011,Waterbury School District,F. J. Kingsbury School,222,243,465,2008-09
1512611,1510011,Waterbury School District,Gilmartin School,100,144,244,2008-09
1510711,1510011,Waterbury School District,H. S. Chase School,394,408,802,2008-09
1511311,1510011,Waterbury School District,Hopeville School,222,214,436,2008-09
1516411,1510011,Waterbury School District,John F. Kennedy High School,675,631,1306,2008-09
1513111,1510011,Waterbury School District,Maloney Interdistrict Magnet School,295,304,599,2008-09
1511111,1510011,Waterbury School District,Margaret M. Generali Elementary School,294,302,596,2008-09
1515111,1510011,Waterbury School District,Michael F. Wallace Middle School,630,699,1329,2008-09
1515311,1510011,Waterbury School District,North End Middle School,601,625,1226,2008-09
1512811,1510011,Waterbury School District,Regan School,151,148,299,2008-09
1513311,1510011,Waterbury School District,Rotella Interdistrict Magnet School,312,302,614,2008-09
1518011,1510011,Waterbury School District,Special Education Preschool,87,137,224,2008-09
1512011,1510011,Waterbury School District,Sprague School,262,217,479,2008-09
1519011,1510011,Waterbury School District,State Street School,15,68,83,2008-09
1512211,1510011,Waterbury School District,Walsh School,278,280,558,2008-09
1516011,1510011,Waterbury School District,Waterbury Arts Magnet School (High),297,184,481,2008-09
1515011,1510011,Waterbury School District,Waterbury Arts Magnet School (Middle),174,145,319,2008-09
1510811,1510011,Waterbury School District,Wendell L. Cross School,175,177,352,2008-09
1516311,1510011,Waterbury School District,Wilby High School,588,604,1192,2008-09
1513211,1510011,Waterbury School District,Woodrow Wilson School,201,196,397,2008-09
1525111,1520011,Waterford School District,Clark Lane Middle School,324,370,694,2008-09
1520611,1520011,Waterford School District,Oswegatchie Elementary School,128,140,268,2008-09
1520711,1520011,Waterford School District,Quaker Hill Elementary School,188,227,415,2008-09
1520511,1520011,Waterford School District,Southwest Elementary School,252,262,514,2008-09
1526111,1520011,Waterford School District,Waterford High School,511,477,988,2008-09
1530311,1530011,Watertown School District,Fletcher W. Judson School,185,181,366,2008-09
1530211,1530011,Watertown School District,John Trumbull Primary School,364,389,753,2008-09
1530411,1530011,Watertown School District,Polk School,187,186,373,2008-09
1535111,1530011,Watertown School District,Swift Middle School,438,426,864,2008-09
1536111,1530011,Watertown School District,Watertown High School,483,497,980,2008-09
1551711,1550011,West Hartford School District,Smith School,180,199,379,2008-09
1559111,1550011,West Hartford School District,Achieve,*,*,*,2008-09
1551611,1550011,West Hartford School District,Aiken School,213,240,453,2008-09
1550211,1550011,West Hartford School District,Braeburn School,230,224,454,2008-09
1555311,1550011,West Hartford School District,Bristow Middle School,227,193,420,2008-09
1550411,1550011,West Hartford School District,Bugbee School,178,186,364,2008-09
1550511,1550011,West Hartford School District,Charter Oak International Academy,174,187,361,2008-09
1556111,1550011,West Hartford School District,Conard High School,749,717,1466,2008-09
1550611,1550011,West Hartford School District,Duffy School,289,300,589,2008-09
1556211,1550011,West Hartford School District,Hall High School,760,811,1571,2008-09
1555111,1550011,West Hartford School District,King Philip Middle School,435,466,901,2008-09
1550911,1550011,West Hartford School District,Morley School,187,177,364,2008-09
1551011,1550011,West Hartford School District,Norfeldt School,215,218,433,2008-09
1555211,1550011,West Hartford School District,Sedgwick Middle School,419,447,866,2008-09
1559011,1550011,West Hartford School District,WAAVE (W Hartford Applied Academic/Voc'l Experience),*,*,13,2008-09
1551211,1550011,West Hartford School District,Webster Hill School,219,219,438,2008-09
1551311,1550011,West Hartford School District,Whiting Lane School,210,285,495,2008-09
1551511,1550011,West Hartford School District,Wolcott School,249,262,511,2008-09
1561211,1560011,West Haven School District,Washington School,208,195,403,2008-09
1560811,1560011,West Haven School District,Alma E. Pagels School,164,191,355,2008-09
1561311,1560011,West Haven School District,Anna V. Molloy School,140,118,258,2008-09
1565311,1560011,West Haven School District,Carrigan 5/6 Intermediate School,325,368,693,2008-09
1561011,1560011,West Haven School District,Clarence E. Thompson School,169,184,353,2008-09
1560611,1560011,West Haven School District,Edith E. Mackrille School,198,185,383,2008-09
1560311,1560011,West Haven School District,Forest School,190,248,438,2008-09
1565111,1560011,West Haven School District,Harry M. Bailey Middle School,370,369,739,2008-09
1561411,1560011,West Haven School District,Savin Rock Community School,226,238,464,2008-09
1560411,1560011,West Haven School District,Seth G. Haley School,255,249,504,2008-09
1566111,1560011,West Haven School District,West Haven High School,825,815,1640,2008-09
1540211,1540011,Westbrook School District,Daisy Ingraham School,184,189,373,2008-09
1546111,1540011,Westbrook School District,Westbrook High School,142,150,292,2008-09
1545111,1540011,Westbrook School District,Westbrook Middle School,146,157,303,2008-09
1570111,1570011,Weston School District,Hurlbutt Elementary School,280,299,579,2008-09
1576111,1570011,Weston School District,Weston High School,426,381,807,2008-09
1570211,1570011,Weston School District,Weston Intermediate School,299,309,608,2008-09
1575111,1570011,Weston School District,Weston Middle School,265,309,574,2008-09
1585111,1580011,Westport School District,Bedford Middle School,423,428,851,2008-09
1580311,1580011,Westport School District,Coleytown Elementary School,246,231,477,2008-09
1585311,1580011,Westport School District,Coleytown Middle School,267,247,514,2008-09
1580411,1580011,Westport School District,Green's Farms School,234,241,475,2008-09
1580511,1580011,Westport School District,King's Highway Elementary School,250,252,502,2008-09
1580711,1580011,Westport School District,Long Lots School,292,318,610,2008-09
1580811,1580011,Westport School District,Saugatuck Elementary School,253,266,519,2008-09
1586111,1580011,Westport School District,Staples High School,861,899,1760,2008-09
1588011,1580011,Westport School District,Stepping Stones Preschool,18,38,56,2008-09
1590811,1590011,Wethersfield School District,Alfred W. Hanmer School,164,205,369,2008-09
1591011,1590011,Wethersfield School District,Charles Wright School,162,156,318,2008-09
1590211,1590011,Wethersfield School District,Emerson-Williams School,228,241,469,2008-09
1591111,1590011,Wethersfield School District,Highcrest School,207,237,444,2008-09
1591211,1590011,Wethersfield School District,Samuel B. Webb Elementary School,201,225,426,2008-09
1595211,1590011,Wethersfield School District,Silas Deane Middle School,266,296,562,2008-09
1596111,1590011,Wethersfield School District,Wethersfield High School,604,620,1224,2008-09
1600111,1600011,Willington School District,Center School,114,131,245,2008-09
1605111,1600011,Willington School District,Hall Memorial School,161,159,320,2008-09
1615211,1610011,Wilton School District,Middlebrook School,475,535,1010,2008-09
1610711,1610011,Wilton School District,Cider Mill School,529,521,1050,2008-09
1610611,1610011,Wilton School District,Ina E. Driscoll School,241,271,512,2008-09
1610511,1610011,Wilton School District,Miller-Driscoll School,255,254,509,2008-09
1616111,1610011,Wilton School District,Wilton High School,638,659,1297,2008-09
1620411,1620011,Winchester School District,Batcheller Early Education Center,123,184,307,2008-09
1620211,1620011,Winchester School District,Mary P. Hinsdale School,154,198,352,2008-09
1625111,1620011,Winchester School District,Pearson Middle School,159,177,336,2008-09
1638011,1630011,Windham School District,Early Headstart,9,21,30,2008-09
1639011,1630011,Windham School District,Eastern Regional Academy/Windham,10,33,43,2008-09
1630111,1630011,Windham School District,Natchaug School,140,159,299,2008-09
1630311,1630011,Windham School District,North Windham School,220,228,448,2008-09
1630611,1630011,Windham School District,W. B. Sweeney School,166,181,347,2008-09
1630511,1630011,Windham School District,Windham Center School,154,133,287,2008-09
1638311,1630011,Windham School District,Windham Early Childhood Prospect Street,85,107,192,2008-09
1636111,1630011,Windham School District,Windham High School,434,473,907,2008-09
1635111,1630011,Windham School District,Windham Middle School,447,478,925,2008-09
1650111,1650011,Windsor Locks School District,North Street School,207,234,441,2008-09
1650411,1650011,Windsor Locks School District,South Elementary School,188,230,418,2008-09
1656111,1650011,Windsor Locks School District,Windsor Locks High School,268,305,573,2008-09
1655111,1650011,Windsor Locks School District,Windsor Locks Middle School,211,202,413,2008-09
1640111,1640011,Windsor School District,Clover Street School,165,158,323,2008-09
1640811,1640011,Windsor School District,John F. Kennedy School,170,199,369,2008-09
1640911,1640011,Windsor School District,Oliver Ellsworth School,206,214,420,2008-09
1640511,1640011,Windsor School District,Poquonock Elementary School,145,158,303,2008-09
1641011,1640011,Windsor School District,Roger Wolcott Early Child Center,117,126,243,2008-09
1645311,1640011,Windsor School District,Sage Park Middle School,444,467,911,2008-09
1646111,1640011,Windsor School District,Windsor High School,661,739,1400,2008-09
1660611,1660011,Wolcott School District,Alcott School,185,196,381,2008-09
1660211,1660011,Wolcott School District,Frisbie School,189,196,385,2008-09
1665111,1660011,Wolcott School District,Tyrrell Middle School,358,368,726,2008-09
1660511,1660011,Wolcott School District,Wakelee School,229,238,467,2008-09
1666111,1660011,Wolcott School District,Wolcott High School,446,450,896,2008-09
1670211,1670011,Woodbridge School District,Beecher Road Intermediate School,216,231,447,2008-09
1670111,1670011,Woodbridge School District,Beecher Road Primary School,142,166,308,2008-09
9036122,9030022,Woodstock Academy District,Woodstock Academy,584,600,1184,2008-09
1690211,1690011,Woodstock School District,Woodstock Elementary School,243,252,495,2008-09
1695111,1690011,Woodstock School District,Woodstock Middle School,200,231,431,2008-09
2880113,2880013,Achievement First Hartford Academy Inc. District,Achievement First Hartford Academy Inc.,199,241,440,2009-10
2795113,2790013,Amistad Academy District,Amistad Academy,378,366,744,2009-10
0010111,0010011,Andover School District,Andover Elementary School,143,193,336,2009-10
0026111,0020011,Ansonia School District,Ansonia High School,383,394,777,2009-10
0025111,0020011,Ansonia School District,Ansonia Middle School,226,251,477,2009-10
0020311,0020011,Ansonia School District,Mead School,311,349,660,2009-10
0020811,0020011,Ansonia School District,Prendergast School,382,429,811,2009-10
2446114,2440014,Area Cooperative Educational Services,Collaborative Alternative Magnet School,47,63,110,2009-10
2449414,2440014,Area Cooperative Educational Services,Mill Road School,21,127,148,2009-10
2445114,2440014,Area Cooperative Educational Services,Thomas Edison Magnet Middle School,361,372,733,2009-10
2449514,2440014,Area Cooperative Educational Services,Village School,49,127,176,2009-10
2449214,2440014,Area Cooperative Educational Services,Whitney High School East,26,97,123,2009-10
2449114,2440014,Area Cooperative Educational Services,Whitney High School North,22,78,100,2009-10
2449314,2440014,Area Cooperative Educational Services,Whitney High School West,14,42,56,2009-10
2440314,2440014,Area Cooperative Educational Services,Wintergreen Interdistrict  Magnet School,331,299,630,2009-10
0030111,0030011,Ashford School District,Ashford School,219,256,475,2009-10
0046111,0040011,Avon School District,Avon High School,529,550,1079,2009-10
0045111,0040011,Avon School District,Avon Middle School,321,280,601,2009-10
0040411,0040011,Avon School District,Pine Grove School,313,342,655,2009-10
0040311,0040011,Avon School District,Roaring Brook School,351,331,682,2009-10
0040511,0040011,Avon School District,Thompson Brook School,265,303,568,2009-10
0050111,0050011,Barkhamsted School District,Barkhamsted Elementary School,143,202,345,2009-10
0058011,0050011,Barkhamsted School District,Shared Services Integrated Preschool,8,14,22,2009-10
0076111,0070011,Berlin School District,Berlin High School,513,509,1022,2009-10
0075111,0070011,Berlin School District,Catherine M. McGee Middle School,340,393,733,2009-10
0070411,0070011,Berlin School District,Emma Hart Willard School,252,336,588,2009-10
0070511,0070011,Berlin School District,Mary E. Griswold School,272,292,564,2009-10
0070111,0070011,Berlin School District,Richard D. Hubbard School,111,141,252,2009-10
0080111,0080011,Bethany School District,Bethany Community School,239,276,515,2009-10
0090411,0090011,Bethel School District,Anna H. Rockwell School,190,230,420,2009-10
0096111,0090011,Bethel School District,Bethel High School,506,481,987,2009-10
0095111,0090011,Bethel School District,Bethel Middle School,341,362,703,2009-10
0090111,0090011,Bethel School District,Frank A. Berry School,235,262,497,2009-10
0090511,0090011,Bethel School District,Ralph M. T. Johnson School,215,220,435,2009-10
0116111,0110011,Bloomfield School District,Bloomfield High School,290,339,629,2009-10
0110711,0110011,Bloomfield School District,Carmen Arace Intermediate School,137,157,294,2009-10
0115211,0110011,Bloomfield School District,Carmen Arace Middle School,160,154,314,2009-10
0110311,0110011,Bloomfield School District,J. P. Vincent School,116,138,254,2009-10
0110611,0110011,Bloomfield School District,Laurel School,121,143,264,2009-10
0110511,0110011,Bloomfield School District,Metacomet School,78,104,182,2009-10
0116211,0110011,Bloomfield School District,The Big Picture High School,52,36,88,2009-10
0110811,0110011,Bloomfield School District,Wintonbury Early Childhood Magnet School,120,134,254,2009-10
0120111,0120011,Bolton School District,Bolton Center School,296,287,583,2009-10
0126111,0120011,Bolton School District,Bolton High School,164,133,297,2009-10
0130111,0130011,Bozrah School District,Fields Memorial School,137,119,256,2009-10
0146111,0140011,Branford School District,Branford High School,582,527,1109,2009-10
0145111,0140011,Branford School District,Francis Walsh Intermediate School,532,581,1113,2009-10
0148011,0140011,Branford School District,Indian Neck School,22,36,58,2009-10
0141611,0140011,Branford School District,John B. Sliney School,185,176,361,2009-10
0141511,0140011,Branford School District,Mary R. Tisko School,215,213,428,2009-10
0141411,0140011,Branford School District,Mary T. Murphy School,217,216,433,2009-10
2850113,2850013,Bridgeport Achievement First District,Achievement First Bridgeport Academy,125,113,238,2009-10
0150111,0150011,Bridgeport School District,Barnum School,303,328,631,2009-10
0156111,0150011,Bridgeport School District,Bassick High School,525,628,1153,2009-10
0150211,0150011,Bridgeport School District,Beardsley School,183,192,375,2009-10
0150311,0150011,Bridgeport School District,Black Rock School,139,118,257,2009-10
0154011,0150011,Bridgeport School District,Blackham School,503,566,1069,2009-10
0159011,0150011,Bridgeport School District,Bridgeport Learning Center,9,44,53,2009-10
0150411,0150011,Bridgeport School District,Bryant School,193,208,401,2009-10
0156211,0150011,Bridgeport School District,Central High School,1110,1107,2217,2009-10
0151411,0150011,Bridgeport School District,Cesar Batalla School,515,546,1061,2009-10
0152111,0150011,Bridgeport School District,Classical Studies Academy,178,150,328,2009-10
0150511,0150011,Bridgeport School District,Columbus School,354,328,682,2009-10
0153911,0150011,Bridgeport School District,Cross School,178,202,380,2009-10
0154211,0150011,Bridgeport School District,Curiale School,278,301,579,2009-10
0154111,0150011,Bridgeport School District,Dunbar School,178,146,324,2009-10
0150711,0150011,Bridgeport School District,Edison School,132,134,266,2009-10
0153211,0150011,Bridgeport School District,Geraldine Johnson School,386,453,839,2009-10
0151111,0150011,Bridgeport School District,Hall School,118,159,277,2009-10
0151211,0150011,Bridgeport School District,Hallen School,149,191,340,2009-10
0156311,0150011,Bridgeport School District,Harding High School,774,771,1545,2009-10
0154511,0150011,Bridgeport School District,High Horizons Magnet School,237,195,432,2009-10
0151311,0150011,Bridgeport School District,Hooker School,198,263,461,2009-10
0152211,0150011,Bridgeport School District,Jettie S. Tisdale School,306,314,620,2009-10
0151911,0150011,Bridgeport School District,Longfellow School,208,214,422,2009-10
0151011,0150011,Bridgeport School District,Luis Munoz Marin School,439,428,867,2009-10
0152011,0150011,Bridgeport School District,Madison School,240,322,562,2009-10
0159511,0150011,Bridgeport School District,Make The Grade,23,31,54,2009-10
0154611,0150011,Bridgeport School District,Multicultural Magnet School,250,201,451,2009-10
0159411,0150011,Bridgeport School District,New Start Program,22,24,46,2009-10
0158011,0150011,Bridgeport School District,Parent-Children Program,*,0,*,2009-10
0159211,0150011,Bridgeport School District,Park City Academy,*,*,17,2009-10
0151711,0150011,Bridgeport School District,Park City Magnet School,254,258,512,2009-10
0152511,0150011,Bridgeport School District,Read School,395,468,863,2009-10
0152611,0150011,Bridgeport School District,Roosevelt School,242,284,526,2009-10
0154411,0150011,Bridgeport School District,Skane Center,109,134,243,2009-10
0159111,0150011,Bridgeport School District,The University School,*,*,28,2009-10
0153011,0150011,Bridgeport School District,Waltersville School,251,271,522,2009-10
0153611,0150011,Bridgeport School District,Winthrop School,361,363,724,2009-10
0179011,0170011,Bristol School District,Alternative Special Education Program (ASEP),*,*,19,2009-10
0176111,0170011,Bristol School District,Bristol Central High School,660,704,1364,2009-10
0176211,0170011,Bristol School District,Bristol Eastern High School,656,649,1305,2009-10
0175111,0170011,Bristol School District,Chippens Hill Middle School,442,468,910,2009-10
0170711,0170011,Bristol School District,Clara T. O'Connell School,173,202,375,2009-10
0170111,0170011,Bristol School District,Clarence A. Bingham School,107,129,236,2009-10
0179211,0170011,Bristol School District,Community/Vocational Program,*,*,13,2009-10
0170311,0170011,Bristol School District,Edgewood School,171,184,355,2009-10
0171411,0170011,Bristol School District,Ellen P. Hubbell School,250,261,511,2009-10
0170511,0170011,Bristol School District,Greene-Hills School,174,188,362,2009-10
0171911,0170011,Bristol School District,Ivy Drive School,168,191,359,2009-10
0170611,0170011,Bristol School District,John J. Jennings School,164,177,341,2009-10
0175311,0170011,Bristol School District,Memorial Boulevard Middle School,269,275,544,2009-10
0171711,0170011,Bristol School District,Mountain View School,171,196,367,2009-10
0175211,0170011,Bristol School District,Northeast Middle School,270,315,585,2009-10
0171111,0170011,Bristol School District,South Side School,252,314,566,2009-10
0171211,0170011,Bristol School District,Stafford School,240,240,480,2009-10
0186111,0180011,Brookfield School District,Brookfield High School,509,507,1016,2009-10
0180311,0180011,Brookfield School District,Center Elementary School,192,227,419,2009-10
0180411,0180011,Brookfield School District,Huckleberry Hill Elementary School,279,267,546,2009-10
0185311,0180011,Brookfield School District,Whisconier Middle School,444,473,917,2009-10
0190111,0190011,Brooklyn School District,Brooklyn Elementary School,296,280,576,2009-10
0195111,0190011,Brooklyn School District,Brooklyn Middle School,188,198,386,2009-10
0210111,0210011,Canaan School District,Lee H. Kellogg School,53,42,95,2009-10
0220211,0220011,Canterbury School District,Canterbury Elementary School,143,186,329,2009-10
0225111,0220011,Canterbury School District,Dr. Helen Baldwin Middle School,105,117,222,2009-10
0236111,0230011,Canton School District,Canton High School,240,274,514,2009-10
0230311,0230011,Canton School District,Canton Intermediate School,193,195,388,2009-10
0235111,0230011,Canton School District,Canton Middle School,139,152,291,2009-10
0230211,0230011,Canton School District,Cherry Brook Primary School,288,281,569,2009-10
2415114,2410014,Capitol Region Education Council,Academy of Aerospace and Engineering,66,102,168,2009-10
2419214,2410014,Capitol Region Education Council,Farmington Valley Regional Diagnostic Center,9,16,25,2009-10
2410114,2410014,Capitol Region Education Council,Glastonbury/East Hartford Magnet School,125,136,261,2009-10
2416314,2410014,Capitol Region Education Council,Great Path Academy at MCC,138,96,234,2009-10
2416414,2410014,Capitol Region Education Council,Greater Hartford Academy of  the Arts High School - Full Time,180,94,274,2009-10
2419414,2410014,Capitol Region Education Council,Integrated Program Models,*,*,9,2009-10
2410414,2410014,Capitol Region Education Council,International Magnet School for Global Citizenship,82,100,182,2009-10
2419014,2410014,Capitol Region Education Council,John J. Allison Polaris Center,17,36,53,2009-10
2419614,2410014,Capitol Region Education Council,Lincoln Academy Regional Interdistrict Collaborative,0,*,*,2009-10
2416114,2410014,Capitol Region Education Council,Metropolitan Learning Center for Global and International Studies,373,340,713,2009-10
2413114,2410014,Capitol Region Education Council,Montessori Magnet School,167,169,336,2009-10
2415214,2410014,Capitol Region Education Council,Public Safety Academy,72,144,216,2009-10
2410314,2410014,Capitol Region Education Council,Reggio Magnet School of the Arts,77,94,171,2009-10
2419514,2410014,Capitol Region Education Council,River Street Early Learning Center (Site 2),11,41,52,2009-10
2419314,2410014,Capitol Region Education Council,River Street School,24,128,152,2009-10
2419114,2410014,Capitol Region Education Council,Soundbridge,53,36,89,2009-10
2415014,2410014,Capitol Region Education Council,Two Rivers Magnet Middle School,277,315,592,2009-10
2410214,2410014,Capitol Region Education Council,University of Hartford Magnet School,197,221,418,2009-10
0240211,0240011,Chaplin School District,Chaplin Elementary School,83,90,173,2009-10
2870113,2870013,Charter School for Young Children on Asylum Hill District,Charter School for Young Children on Asylum Hill  Inc.,104,81,185,2009-10
0250111,0250011,Cheshire School District,Chapman School,171,154,325,2009-10
0256111,0250011,Cheshire School District,Cheshire High School,735,814,1549,2009-10
0250211,0250011,Cheshire School District,Darcey School,191,204,395,2009-10
0255111,0250011,Cheshire School District,Dodd Middle School,416,399,815,2009-10
0250611,0250011,Cheshire School District,Doolittle School,247,269,516,2009-10
0250411,0250011,Cheshire School District,Highland School,400,440,840,2009-10
0259011,0250011,Cheshire School District,Humiston School,7,10,17,2009-10
0250511,0250011,Cheshire School District,Norton School,252,240,492,2009-10
0260111,0260011,Chester School District,Chester Elementary School,163,136,299,2009-10
0270111,0270011,Clinton School District,Abraham Pierson School,167,133,300,2009-10
0275111,0270011,Clinton School District,Jared Eliot School,242,253,495,2009-10
0270311,0270011,Clinton School District,Lewin G. Joel Jr. School,317,354,671,2009-10
0276111,0270011,Clinton School District,The Morgan School,281,277,558,2009-10
0286111,0280011,Colchester School District,Bacon Academy,509,494,1003,2009-10
0280411,0280011,Colchester School District,Colchester Elementary School,337,397,734,2009-10
0280211,0280011,Colchester School District,Jack Jackter Intermediate School,342,364,706,2009-10
0285111,0280011,Colchester School District,William J. Johnston Middle School,389,372,761,2009-10
0290111,0290011,Colebrook School District,Colebrook Consolidated School,60,59,119,2009-10
0300111,0300011,Columbia School District,Horace W. Porter School,271,283,554,2009-10
2686113,2680013,Common Ground High School District,Common Ground High School,82,78,160,2009-10
9001516,9000016,Connecticut Technical High School System,A. I. Prince Technical High School,370,313,683,2009-10
9001116,9000016,Connecticut Technical High School System,Bullard-Havens Technical High School,460,426,886,2009-10
9001916,9000016,Connecticut Technical High School System,E. C. Goodwin Technical High School,200,344,544,2009-10
9001416,9000016,Connecticut Technical High School System,Eli Whitney Technical High School,246,265,511,2009-10
9002716,9000016,Connecticut Technical High School System,Ella T. Grasso Southeastern Technical High School,254,337,591,2009-10
9002516,9000016,Connecticut Technical High School System,Emmett O'Brien Technical High School,150,364,514,2009-10
9001716,9000016,Connecticut Technical High School System,H. C. Wilcox Technical High School,300,481,781,2009-10
9001316,9000016,Connecticut Technical High School System,H. H. Ellis Technical High School,147,419,566,2009-10
9001216,9000016,Connecticut Technical High School System,Henry Abbott Technical High School,207,464,671,2009-10
9001616,9000016,Connecticut Technical High School System,Howell Cheney Technical High School,109,514,623,2009-10
9002016,9000016,Connecticut Technical High School System,Norwich Technical High School,174,383,557,2009-10
9002216,9000016,Connecticut Technical High School System,Oliver Wolcott Technical High School,251,510,761,2009-10
9002616,9000016,Connecticut Technical High School System,Platt Technical High School,289,591,880,2009-10
9001816,9000016,Connecticut Technical High School System,Vinal Technical High School,176,431,607,2009-10
9002316,9000016,Connecticut Technical High School System,W. F. Kaynor Technical High School,300,437,737,2009-10
9002416,9000016,Connecticut Technical High School System,Windham Technical High School,201,356,557,2009-10
2439214,2430014,Cooperative Educational Services,Developmental Learning Center (DLC),28,48,76,2009-10
2439114,2430014,Cooperative Educational Services,Preschool-Primary Learning Center (PLC),14,44,58,2009-10
2439314,2430014,Cooperative Educational Services,RISE Transitional Program,*,*,10,2009-10
2438014,2430014,Cooperative Educational Services,School Readiness,31,22,53,2009-10
2430114,2430014,Cooperative Educational Services,Six-Six Magnet School,221,218,439,2009-10
2439414,2430014,Cooperative Educational Services,Therapeutic Day Program,23,119,142,2009-10
0310111,0310011,Cornwall School District,Cornwall Consolidated School,60,62,122,2009-10
0325111,0320011,Coventry School District,Capt. Nathan Hale School,228,253,481,2009-10
0328011,0320011,Coventry School District,Coventry Early Intervention Services,*,*,11,2009-10
0320211,0320011,Coventry School District,Coventry Grammar School,209,205,414,2009-10
0326111,0320011,Coventry School District,Coventry High School,279,284,563,2009-10
0320411,0320011,Coventry School District,George Hersey Robertson School,205,235,440,2009-10
0336111,0330011,Cromwell School District,Cromwell High School,314,291,605,2009-10
0335111,0330011,Cromwell School District,Cromwell Middle School,222,243,465,2009-10
0330211,0330011,Cromwell School District,Edna C. Stevens School,221,256,477,2009-10
0330311,0330011,Cromwell School District,Woodside Intermediate School,238,263,501,2009-10
0346211,0340011,Danbury School District,Alternative Center For Excellence,50,38,88,2009-10
0345111,0340011,Danbury School District,Broadview Middle School,553,555,1108,2009-10
0346111,0340011,Danbury School District,Danbury High School,1411,1443,2854,2009-10
0341411,0340011,Danbury School District,Ellsworth Avenue School,190,205,395,2009-10
0341111,0340011,Danbury School District,Great Plain School,147,160,307,2009-10
0340211,0340011,Danbury School District,Hayestown Avenue School,202,237,439,2009-10
0341711,0340011,Danbury School District,King Street Intermediate School,148,159,307,2009-10
0341311,0340011,Danbury School District,King Street Primary School,144,156,300,2009-10
0341811,0340011,Danbury School District,Mill Ridge Educational Center,168,184,352,2009-10
0340511,0340011,Danbury School District,Mill Ridge Primary School,147,149,296,2009-10
0340611,0340011,Danbury School District,Morris Street School,184,185,369,2009-10
0340811,0340011,Danbury School District,Park Avenue School,208,200,408,2009-10
0341511,0340011,Danbury School District,Pembroke School,153,172,325,2009-10
0345211,0340011,Danbury School District,Rogers Park Middle School,486,550,1036,2009-10
0341211,0340011,Danbury School District,Shelter Rock School,201,195,396,2009-10
0341011,0340011,Danbury School District,South Street School,172,172,344,2009-10
0341611,0340011,Danbury School District,Stadley Rough School,238,229,467,2009-10
0341911,0340011,Danbury School District,Western CT Academy of International Studies Elementary Magnet School,179,204,383,2009-10
0356111,0350011,Darien School District,Darien High School,637,627,1264,2009-10
0350211,0350011,Darien School District,Hindley Elementary School,271,275,546,2009-10
0350711,0350011,Darien School District,Holmes Elementary School,223,261,484,2009-10
0355111,0350011,Darien School District,Middlesex Middle School,549,607,1156,2009-10
0351311,0350011,Darien School District,Ox Ridge Elementary School,227,251,478,2009-10
0350511,0350011,Darien School District,Royle Elementary School,192,251,443,2009-10
0350611,0350011,Darien School District,Tokeneke Elementary School,183,226,409,2009-10
0360111,0360011,Deep River School District,Deep River Elementary School,173,176,349,2009-10
3370315,3370015,Department of Mental Health and Addiction Services,Cedarcrest Regional Hosp - Blue Hills Hosp. Substance Ab,*,*,*,2009-10
3370515,3370015,Department of Mental Health and Addiction Services,Greater Bridgeport Community Mental Health Center,*,0,*,2009-10
0370611,0370011,Derby School District,Bradley School,191,195,386,2009-10
0376111,0370011,Derby School District,Derby High School,296,328,624,2009-10
0370411,0370011,Derby School District,Irving School,204,235,439,2009-10
0400111,0400011,East Granby School District,Allgrove School,135,146,281,2009-10
0406111,0400011,East Granby School District,East Granby High School,126,130,256,2009-10
0405111,0400011,East Granby School District,East Granby Middle School,108,122,230,2009-10
0400211,0400011,East Granby School District,R. Dudley Seymour School,75,62,137,2009-10
0410111,0410011,East Haddam School District,East Haddam Elementary School,180,241,421,2009-10
0416111,0410011,East Haddam School District,Nathan Hale-Ray High School,225,181,406,2009-10
0415111,0410011,East Haddam School District,Nathan Hale-Ray Middle School,278,281,559,2009-10
0420311,0420011,East Hampton School District,Center School,154,147,301,2009-10
0426111,0420011,East Hampton School District,East Hampton High School,287,283,570,2009-10
0425111,0420011,East Hampton School District,East Hampton Middle School,258,241,499,2009-10
0420111,0420011,East Hampton School District,Memorial School,301,347,648,2009-10
0429011,0420011,East Hampton School District,The Learning Center at East Hampton,*,*,8,2009-10
0430911,0430011,East Hartford School District,Anna E. Norris School,138,181,319,2009-10
0436311,0430011,East Hartford School District,Connecticut IB Academy,106,61,167,2009-10
0430611,0430011,East Hartford School District,Dr. Franklin H. Mayberry School,203,205,408,2009-10
0432211,0430011,East Hartford School District,Dr. John A. Langford School,164,181,345,2009-10
0431011,0430011,East Hartford School District,Dr. Thomas S. O'Connell School,157,174,331,2009-10
0436211,0430011,East Hartford School District,East Hartford High School,942,961,1903,2009-10
0435111,0430011,East Hartford School District,East Hartford Middle School,445,460,905,2009-10
0432011,0430011,East Hartford School District,Governor William Pitkin School,187,189,376,2009-10
0430511,0430011,East Hartford School District,Hockanum School,144,196,340,2009-10
0430411,0430011,East Hartford School District,Joseph O. Goodwin School,163,192,355,2009-10
0431811,0430011,East Hartford School District,Robert J. O'Brien School,206,205,411,2009-10
0431211,0430011,East Hartford School District,Silver Lane School,173,161,334,2009-10
0436411,0430011,East Hartford School District,Stevens Alternate High School,48,69,117,2009-10
0432411,0430011,East Hartford School District,Sunset Ridge Middle School,237,225,462,2009-10
0438011,0430011,East Hartford School District,Willowbrook Early Childhood,141,144,285,2009-10
0439011,0430011,East Hartford School District,Woodland School,24,160,184,2009-10
0441711,0440011,East Haven School District,Carbone School/East Haven Academy,136,101,237,2009-10
0441411,0440011,East Haven School District,D. C. Moore School,111,115,226,2009-10
0440111,0440011,East Haven School District,Deer Run School,155,189,344,2009-10
0441311,0440011,East Haven School District,Dominick H. Ferrara School,91,106,197,2009-10
0446111,0440011,East Haven School District,East Haven High School,500,468,968,2009-10
0441011,0440011,East Haven School District,Grove J. Tuttle School,115,118,233,2009-10
0441911,0440011,East Haven School District,Hays School,75,79,154,2009-10
0445111,0440011,East Haven School District,Joseph Melillo Middle School,214,260,474,2009-10
0440711,0440011,East Haven School District,Momauguin School,98,114,212,2009-10
0441811,0440011,East Haven School District,Overbrook Elementary School,91,91,182,2009-10
0449011,0440011,East Haven School District,Pathways,9,23,32,2009-10
0441611,0440011,East Haven School District,Robert W. Carbone School,124,137,261,2009-10
0456111,0450011,East Lyme School District,East Lyme High School,617,604,1221,2009-10
0455111,0450011,East Lyme School District,East Lyme Middle School,425,418,843,2009-10
0450111,0450011,East Lyme School District,Flanders School,192,187,379,2009-10
0458011,0450011,East Lyme School District,Integrated Preschool,21,26,47,2009-10
0450411,0450011,East Lyme School District,Lillie B. Haynes School,169,198,367,2009-10
0450211,0450011,East Lyme School District,Niantic Center School,117,120,237,2009-10
0470111,0470011,East Windsor School District,Broad Brook Elementary School,297,304,601,2009-10
0476111,0470011,East Windsor School District,East Windsor High School,177,199,376,2009-10
0475411,0470011,East Windsor School District,East Windsor Middle School,187,215,402,2009-10
2536014,2530014,Eastern Connecticut Regional Educational Service Center (EASTCONN),Arts at the Capitol Theater Magnet School (ACT),66,22,88,2009-10
2539014,2530014,Eastern Connecticut Regional Educational Service Center (EASTCONN),EastConn Special Education,10,40,50,2009-10
2536114,2530014,Eastern Connecticut Regional Educational Service Center (EASTCONN),Quinebaug Middle College,35,35,70,2009-10
0390111,0390011,Eastford School District,Eastford Elementary School,75,95,170,2009-10
0465111,0460011,Easton School District,Helen Keller Middle School,201,183,384,2009-10
0460111,0460011,Easton School District,Samuel Staples Elementary School,324,406,730,2009-10
2428014,2420014,EdAdvance,EdAdvance Headstart,90,83,173,2009-10
2429014,2420014,EdAdvance,The ACCESS School at The Danuta M. Thibodeau Education Center,9,18,27,2009-10
0480111,0480011,Ellington School District,Center School,197,206,403,2009-10
0480211,0480011,Ellington School District,Crystal Lake School,102,119,221,2009-10
0486111,0480011,Ellington School District,Ellington High School,398,379,777,2009-10
0485111,0480011,Ellington School District,Ellington Middle School,200,205,405,2009-10
0480711,0480011,Ellington School District,Windermere Intermediate School,223,191,414,2009-10
0480611,0480011,Ellington School District,Windermere School,221,226,447,2009-10
2890113,2890013,Elm City College Preparatory School District,Elm City College Preparatory School,280,267,547,2009-10
0491311,0490011,Enfield School District,Edgar H. Parkman School,169,174,343,2009-10
0491611,0490011,Enfield School District,Eli Whitney School,186,238,424,2009-10
0496111,0490011,Enfield School District,Enfield High School,395,428,823,2009-10
0490211,0490011,Enfield School District,Enfield Street School,178,178,356,2009-10
0499011,0490011,Enfield School District,Enfield Transitional Learning Academy,*,*,*,2009-10
0496211,0490011,Enfield School District,Enrico Fermi High School,596,562,1158,2009-10
0491211,0490011,Enfield School District,Harriet Beecher Stowe School,126,132,258,2009-10
0490411,0490011,Enfield School District,Hazardville Memorial School,164,207,371,2009-10
0498011,0490011,Enfield School District,Head Start Program,50,54,104,2009-10
0491811,0490011,Enfield School District,Henry Barnard School,190,238,428,2009-10
0495211,0490011,Enfield School District,John F. Kennedy Middle School,425,447,872,2009-10
0491111,0490011,Enfield School District,Nathan Hale School,129,130,259,2009-10
0491511,0490011,Enfield School District,Prudence Crandall School,207,196,403,2009-10
0491711,0490011,Enfield School District,Thomas G. Alcorn School,149,144,293,2009-10
0500111,0500011,Essex School District,Essex Elementary School,303,290,593,2009-10
2726113,2720013,Explorations District,Explorations,51,29,80,2009-10
0510211,0510011,Fairfield School District,Burr Elementary School,209,210,419,2009-10
0510111,0510011,Fairfield School District,Dwight Elementary School,168,148,316,2009-10
0518011,0510011,Fairfield School District,Early Childhood Center,42,93,135,2009-10
0516011,0510011,Fairfield School District,Fairfield Ludlowe High School,759,693,1452,2009-10
0516211,0510011,Fairfield School District,Fairfield Warde High School,665,633,1298,2009-10
0515211,0510011,Fairfield School District,Fairfield Woods Middle School,329,343,672,2009-10
0510411,0510011,Fairfield School District,Holland Hill School,162,173,335,2009-10
0511711,0510011,Fairfield School District,Jennings School,163,189,352,2009-10
0510611,0510011,Fairfield School District,McKinley School,214,237,451,2009-10
0510711,0510011,Fairfield School District,Mill Hill School,230,248,478,2009-10
0511611,0510011,Fairfield School District,North Stratfield School,223,255,478,2009-10
0511811,0510011,Fairfield School District,Osborn Hill School,258,293,551,2009-10
0511211,0510011,Fairfield School District,Riverfield School,214,252,466,2009-10
0515311,0510011,Fairfield School District,Roger Ludlowe Middle School,483,483,966,2009-10
0511311,0510011,Fairfield School District,Sherman School,236,238,474,2009-10
0511411,0510011,Fairfield School District,Stratfield School,249,243,492,2009-10
0515111,0510011,Fairfield School District,Tomlinson Middle School,394,379,773,2009-10
0520411,0520011,Farmington School District,East Farms School,203,235,438,2009-10
0528011,0520011,Farmington School District,Farmington Collaborative PK,18,49,67,2009-10
0526111,0520011,Farmington School District,Farmington High School,654,670,1324,2009-10
0525111,0520011,Farmington School District,Irving A. Robbins Middle School,313,373,686,2009-10
0520211,0520011,Farmington School District,Noah Wallace School,160,175,335,2009-10
0520111,0520011,Farmington School District,Union School,149,145,294,2009-10
0520311,0520011,Farmington School District,West District School,177,173,350,2009-10
0520511,0520011,Farmington School District,West Woods Upper Elementary School,313,345,658,2009-10
0530111,0530011,Franklin School District,Franklin Elementary School,105,119,224,2009-10
0540211,0540011,Glastonbury School District,Buttonball Lane School,273,262,535,2009-10
0540311,0540011,Glastonbury School District,Eastbury School,150,168,318,2009-10
0540811,0540011,Glastonbury School District,Gideon Welles School,278,263,541,2009-10
0546111,0540011,Glastonbury School District,Glastonbury High School,1030,1072,2102,2009-10
0540411,0540011,Glastonbury School District,Hebron Avenue School,271,261,532,2009-10
0540611,0540011,Glastonbury School District,Hopewell School,260,266,526,2009-10
0540711,0540011,Glastonbury School District,Naubuc School,258,231,489,2009-10
0540911,0540011,Glastonbury School District,Nayaug Elementary School,317,328,645,2009-10
0545211,0540011,Glastonbury School District,Smith Middle School,568,560,1128,2009-10
0560111,0560011,Granby School District,Frank M. Kearns Primary School,222,247,469,2009-10
0566111,0560011,Granby School District,Granby Memorial High School,361,390,751,2009-10
0565111,0560011,Granby School District,Granby Memorial Middle School,189,165,354,2009-10
0560411,0560011,Granby School District,Kelly Lane Primary School,158,189,347,2009-10
0560311,0560011,Granby School District,Wells Road Intermediate School,169,185,354,2009-10
0575111,0570011,Greenwich School District,Central Middle School,292,339,631,2009-10
0570211,0570011,Greenwich School District,Cos Cob School,204,213,417,2009-10
0575211,0570011,Greenwich School District,Eastern Middle School,401,373,774,2009-10
0570411,0570011,Greenwich School District,Glenville School,140,156,296,2009-10
0576111,0570011,Greenwich School District,Greenwich High School,1271,1417,2688,2009-10
0570511,0570011,Greenwich School District,Hamilton Avenue School,207,203,410,2009-10
0571311,0570011,Greenwich School District,International School At Dundee,178,193,371,2009-10
0570311,0570011,Greenwich School District,Julian Curtiss School,171,172,343,2009-10
0570611,0570011,Greenwich School District,New Lebanon School,106,113,219,2009-10
0570711,0570011,Greenwich School District,North Mianus School,229,226,455,2009-10
0570811,0570011,Greenwich School District,North Street School,229,257,486,2009-10
0570911,0570011,Greenwich School District,Old Greenwich School,227,218,445,2009-10
0571111,0570011,Greenwich School District,Parkway School,139,180,319,2009-10
0571011,0570011,Greenwich School District,Riverside School,238,264,502,2009-10
0575311,0570011,Greenwich School District,Western Middle School,231,259,490,2009-10
0580311,0580011,Griswold School District,Griswold Elementary School,451,462,913,2009-10
0586211,0580011,Griswold School District,Griswold High School,371,369,740,2009-10
0585111,0580011,Griswold School District,Griswold Middle School,183,224,407,2009-10
0595311,0590011,Groton School District,Carl C. Cutler Middle School,168,182,350,2009-10
0592011,0590011,Groton School District,Catherine Kolnaski Magnet School,234,237,471,2009-10
0591811,0590011,Groton School District,Charles Barnum School,175,205,380,2009-10
0590311,0590011,Groton School District,Claude Chester School,191,197,388,2009-10
0595111,0590011,Groton School District,Fitch Middle School,202,207,409,2009-10
0591711,0590011,Groton School District,Mary Morrisson School,160,178,338,2009-10
0591911,0590011,Groton School District,Northeast Academy Elementary School,215,222,437,2009-10
0591211,0590011,Groton School District,Pleasant Valley School,146,166,312,2009-10
0596111,0590011,Groton School District,Robert E. Fitch High School,678,628,1306,2009-10
0590111,0590011,Groton School District,S. B. Butler School,171,191,362,2009-10
0595211,0590011,Groton School District,West Side Middle School,141,135,276,2009-10
0600711,0600011,Guilford School District,A. Baldwin Middle School,249,295,544,2009-10
0600611,0600011,Guilford School District,A. W. Cox School,177,144,321,2009-10
0600411,0600011,Guilford School District,Calvin Leete School,167,165,332,2009-10
0605111,0600011,Guilford School District,E. C. Adams Middle School,309,310,619,2009-10
0606111,0600011,Guilford School District,Guilford High School,570,545,1115,2009-10
0600211,0600011,Guilford School District,Guilford Lakes School,209,224,433,2009-10
0600311,0600011,Guilford School District,Melissa Jones School,172,175,347,2009-10
0628011,0620011,Hamden School District,Alice Peck Learning Center,36,60,96,2009-10
0621211,0620011,Hamden School District,Bear Path School,231,226,457,2009-10
0620211,0620011,Hamden School District,Church Street School,196,215,411,2009-10
0620311,0620011,Hamden School District,Dunbar Hill School,156,170,326,2009-10
0626111,0620011,Hamden School District,Hamden High School,934,1038,1972,2009-10
0625211,0620011,Hamden School District,Hamden Middle School,411,470,881,2009-10
0620411,0620011,Hamden School District,Helen Street School,127,172,299,2009-10
0621111,0620011,Hamden School District,Ridge Hill School,143,171,314,2009-10
0620111,0620011,Hamden School District,Shepherd Glen School,162,151,313,2009-10
0621011,0620011,Hamden School District,Spring Glen School,169,189,358,2009-10
0621411,0620011,Hamden School District,West Woods School,248,264,512,2009-10
0630111,0630011,Hampton School District,Hampton Elementary School,55,88,143,2009-10
0640711,0640011,Hartford School District,Asian Studies Academy at Bellizzi School,143,185,328,2009-10
0640411,0640011,Hartford School District,Batchelder School,270,298,568,2009-10
0642811,0640011,Hartford School District,Betances Early Reading Lab Magnet School,175,170,345,2009-10
0643511,0640011,Hartford School District,Breakthrough II Magnet School,65,64,129,2009-10
0643311,0640011,Hartford School District,Breakthrough Magnet School,176,176,352,2009-10
0647111,0640011,Hartford School District,Bulkeley High School,282,288,570,2009-10
0646111,0640011,Hartford School District,Bulkeley High School Lower School,328,438,766,2009-10
0640611,0640011,Hartford School District,Burns Latino Studies Academy,292,292,584,2009-10
0642311,0640011,Hartford School District,Burr School,291,334,625,2009-10
0646911,0640011,Hartford School District,Capital Preparatory Magnet School,155,121,276,2009-10
0642411,0640011,Hartford School District,Clark School,191,225,416,2009-10
0646411,0640011,Hartford School District,Classical Magnet School,403,310,713,2009-10
0646011,0640011,Hartford School District,Culinary Arts Academy at Weaver High School,130,135,265,2009-10
0645311,0640011,Hartford School District,Dr. Joseph Bellizzi Middle School,216,219,435,2009-10
0640911,0640011,Hartford School District,Environmental Sciences Magnet at Hooker School,175,170,345,2009-10
0643211,0640011,Hartford School District,Expeditionary Learning Academy at Moylan School,302,308,610,2009-10
0643611,0640011,Hartford School District,Global Communications Academy,185,191,376,2009-10
0647211,0640011,Hartford School District,HPHS Engineering and Green Technology Academy,86,292,378,2009-10
0647311,0640011,Hartford School District,HPHS Freshmen Academy,187,186,373,2009-10
0647411,0640011,Hartford School District,HPHS Law and Government Academy,203,168,371,2009-10
0647511,0640011,Hartford School District,HPHS Nursing and Health Sciences Academy,302,92,394,2009-10
0645411,0640011,Hartford School District,Hartford Magnet Trinity College Academy,316,295,611,2009-10
0649011,0640011,Hartford School District,Hartford Transitional Learning Academy (Elementary),*,*,35,2009-10
0649111,0640011,Hartford School District,Hartford Transitional Learning Academy (Secondary),14,61,75,2009-10
0647611,0640011,Hartford School District,"High School, Inc.",99,98,197,2009-10
0647711,0640011,Hartford School District,Journalism and Media Academy Magnet School,77,88,165,2009-10
0641011,0640011,Hartford School District,Kennelly School,421,374,795,2009-10
0641111,0640011,Hartford School District,Kinsella Magnet School of Performing Arts,357,261,618,2009-10
0640811,0640011,Hartford School District,M. D. Fox School,392,409,801,2009-10
0641611,0640011,Hartford School District,"M. L. King, Jr. School",252,260,512,2009-10
0641211,0640011,Hartford School District,McDonough Middle School,162,196,358,2009-10
0641911,0640011,Hartford School District,Milner School,196,204,400,2009-10
0643711,0640011,Hartford School District,Montessori Magnet at Fisher School,68,81,149,2009-10
0641411,0640011,Hartford School District,Naylor/CCSU Leadership Academy,354,348,702,2009-10
0647811,0640011,Hartford School District,OPPortunity High School,49,41,90,2009-10
0641511,0640011,Hartford School District,Parkville Community School,248,266,514,2009-10
0646611,0640011,Hartford School District,Pathways Academy of Technology and Design,148,203,351,2009-10
0645211,0640011,Hartford School District,Quirk Middle School,120,123,243,2009-10
0641711,0640011,Hartford School District,Rawson School,339,395,734,2009-10
0640111,0640011,Hartford School District,SAND School,219,194,413,2009-10
0642511,0640011,Hartford School District,STEM Magnet at Fisher School,112,141,253,2009-10
0643011,0640011,Hartford School District,Sanchez School,241,252,493,2009-10
0642611,0640011,Hartford School District,Simpson-Waverly School,220,217,437,2009-10
0646511,0640011,Hartford School District,Sports and Medical Sciences Academy,310,292,602,2009-10
0646711,0640011,Hartford School District,University High School of Science and Engineering,141,221,362,2009-10
0646311,0640011,Hartford School District,Weaver High School,165,170,335,2009-10
0642011,0640011,Hartford School District,Webster Micro Society Magnet School,293,326,619,2009-10
0642111,0640011,Hartford School District,West Middle School,349,349,698,2009-10
0642211,0640011,Hartford School District,Wish Museum School,200,226,426,2009-10
0650111,0650011,Hartland School District,Hartland School,108,119,227,2009-10
0670211,0670011,Hebron School District,Gilead Hill School,250,254,504,2009-10
0670111,0670011,Hebron School District,Hebron Elementary School,304,364,668,2009-10
2860113,2860013,Highville Charter School District,Highville Charter School,157,146,303,2009-10
2640113,2640013,Integrated Day Charter School District,Integrated Day Charter School,160,170,330,2009-10
2655113,2650013,Interdistrict School for Arts and Comm District,Interdistrict School For Arts And Communication,96,86,182,2009-10
2610113,2610013,Jumoke Academy District,Jumoke Academy,241,193,434,2009-10
0680111,0680011,Kent School District,Kent Center School,131,151,282,2009-10
0698011,0690011,Killingly School District,Goodyear Early Childhood Center,40,58,98,2009-10
0690111,0690011,Killingly School District,Killingly Central School,245,257,502,2009-10
0696111,0690011,Killingly School District,Killingly High School,418,371,789,2009-10
0695211,0690011,Killingly School District,Killingly Intermediate School,356,434,790,2009-10
0690311,0690011,Killingly School District,Killingly Memorial School,248,254,502,2009-10
2455014,2450014,Learn,Dual Language & Arts Magnet Middle School,43,24,67,2009-10
2459014,2450014,Learn,Learn Special Education,*,*,33,2009-10
2450114,2450014,Learn,Regional Multicultural Magnet School,273,251,524,2009-10
2450214,2450014,Learn,The Friendship School,224,273,497,2009-10
0710111,0710011,Lebanon School District,Lebanon Elementary School,232,262,494,2009-10
0715111,0710011,Lebanon School District,Lebanon Middle School,208,196,404,2009-10
0716211,0710011,Lebanon School District,Lyman Memorial High School,314,235,549,2009-10
0720211,0720011,Ledyard School District,Gales Ferry School,97,122,219,2009-10
0720411,0720011,Ledyard School District,Gallup Hill School,179,169,348,2009-10
0720311,0720011,Ledyard School District,Juliet W. Long School,154,161,315,2009-10
0720111,0720011,Ledyard School District,Ledyard Center School,200,205,405,2009-10
0726111,0720011,Ledyard School District,Ledyard High School,501,425,926,2009-10
0725111,0720011,Ledyard School District,Ledyard Middle School,211,237,448,2009-10
0736011,0730011,Lisbon School District,Community Connection - The Big Picture High School,14,8,22,2009-10
0730111,0730011,Lisbon School District,Lisbon Central School,254,291,545,2009-10
0740211,0740011,Litchfield School District,Center School,165,179,344,2009-10
0746111,0740011,Litchfield School District,Litchfield High School,291,277,568,2009-10
0740311,0740011,Litchfield School District,Litchfield Intermediate School,142,147,289,2009-10
0766111,0760011,Madison School District,Daniel Hand High School,630,634,1264,2009-10
0760611,0760011,Madison School District,Dr. Robert H. Brown Middle School,282,305,587,2009-10
0760211,0760011,Madison School District,Island Avenue Elementary School,165,152,317,2009-10
0760111,0760011,Madison School District,J. Milton Jeffrey Elementary School,261,287,548,2009-10
0760311,0760011,Madison School District,Kathleen H. Ryerson Elementary School,143,168,311,2009-10
0769011,0760011,Madison School District,Town Campus Learning Center,10,19,29,2009-10
0765211,0760011,Madison School District,Walter C. Polson Upper Middle School,310,298,608,2009-10
0770911,0770011,Manchester School District,Nathan Hale School,133,127,260,2009-10
0770111,0770011,Manchester School District,Bowers School,201,230,431,2009-10
0770311,0770011,Manchester School District,Buckley School,168,177,345,2009-10
0771711,0770011,Manchester School District,Elisabeth M. Bennet Academy,198,254,452,2009-10
0770411,0770011,Manchester School District,Highland Park School,110,168,278,2009-10
0775311,0770011,Manchester School District,Illing Middle School,440,509,949,2009-10
0770611,0770011,Manchester School District,Keeney School,204,197,401,2009-10
0776111,0770011,Manchester School District,Manchester High School,999,979,1978,2009-10
0778011,0770011,Manchester School District,Manchester Preschool Center,85,100,185,2009-10
0779011,0770011,Manchester School District,Manchester Regional Academy,28,70,98,2009-10
0771611,0770011,Manchester School District,Martin School,121,139,260,2009-10
0771011,0770011,Manchester School District,Robertson School,156,179,335,2009-10
0771211,0770011,Manchester School District,Verplanck School,146,145,291,2009-10
0771311,0770011,Manchester School District,Waddell School,152,159,311,2009-10
0771411,0770011,Manchester School District,Washington School,145,165,310,2009-10
0780411,0780011,Mansfield School District,Annie E. Vinton School,129,145,274,2009-10
0780211,0780011,Mansfield School District,Dorothy C. Goodwin School,87,109,196,2009-10
0785111,0780011,Mansfield School District,Mansfield Middle School,271,292,563,2009-10
0780511,0780011,Mansfield School District,Southeast Elementary School,116,122,238,2009-10
0790111,0790011,Marlborough School District,Elmer Thienes-Mary Hall Elementary School,345,324,669,2009-10
0800711,0800011,Meriden School District,Nathan Hale School,309,301,610,2009-10
0800111,0800011,Meriden School District,Benjamin Franklin School,195,263,458,2009-10
0801111,0800011,Meriden School District,Casimir Pulaski School,332,348,680,2009-10
0806111,0800011,Meriden School District,Francis T. Maloney High School,618,610,1228,2009-10
0800311,0800011,Meriden School District,Hanover School,258,295,553,2009-10
0800411,0800011,Meriden School District,Israel Putnam School,234,310,544,2009-10
0800511,0800011,Meriden School District,John Barry School,248,274,522,2009-10
0805211,0800011,Meriden School District,Lincoln Middle School,347,395,742,2009-10
0806211,0800011,Meriden School District,Orville H. Platt High School,582,532,1114,2009-10
0800811,0800011,Meriden School District,Roger Sherman School,239,287,526,2009-10
0801011,0800011,Meriden School District,Thomas Hooker School,250,261,511,2009-10
0805411,0800011,Meriden School District,Washington Middle School,413,460,873,2009-10
0830211,0830011,Middletown School District,Bielefield School,152,170,322,2009-10
0839011,0830011,Middletown School District,DEAL Program,*,*,16,2009-10
0830511,0830011,Middletown School District,Farm Hill School,136,171,307,2009-10
0831511,0830011,Middletown School District,Keigwin Middle School,180,189,369,2009-10
0831311,0830011,Middletown School District,Lawrence School,167,179,346,2009-10
0830911,0830011,Middletown School District,MacDonough School,110,101,211,2009-10
0836211,0830011,Middletown School District,Middletown High School,655,669,1324,2009-10
0831211,0830011,Middletown School District,Moody School,203,235,438,2009-10
0831111,0830011,Middletown School District,Snow School,182,171,353,2009-10
0830111,0830011,Middletown School District,Spencer School,193,186,379,2009-10
0831411,0830011,Middletown School District,Wesley School,177,195,372,2009-10
0835411,0830011,Middletown School District,Woodrow Wilson Middle School,361,383,744,2009-10
0840111,0840011,Milford School District,Calf Pen Meadow School,153,149,302,2009-10
0845111,0840011,Milford School District,East Shore Middle School,245,315,560,2009-10
0845211,0840011,Milford School District,Harborside Middle School,290,294,584,2009-10
0841911,0840011,Milford School District,J. F. Kennedy School,178,181,359,2009-10
0846211,0840011,Milford School District,Jonathan Law High School,497,509,1006,2009-10
0846311,0840011,Milford School District,Joseph A. Foran High School,541,511,1052,2009-10
0841611,0840011,Milford School District,Live Oaks School,155,173,328,2009-10
0841711,0840011,Milford School District,Mathewson School,231,257,488,2009-10
0840711,0840011,Milford School District,Meadowside School,176,182,358,2009-10
0840811,0840011,Milford School District,Orange Avenue School,218,251,469,2009-10
0841811,0840011,Milford School District,Orchard Hills School,199,215,414,2009-10
0841011,0840011,Milford School District,Pumpkin Delight School,134,156,290,2009-10
0841411,0840011,Milford School District,Simon Lake School,176,183,359,2009-10
0845311,0840011,Milford School District,West Shore Middle School,275,285,560,2009-10
0850611,0850011,Monroe School District,Chalk Hill School,279,298,577,2009-10
0850511,0850011,Monroe School District,Fawn Hollow Elementary School,245,285,530,2009-10
0855211,0850011,Monroe School District,Jockey Hollow School,329,348,677,2009-10
0856111,0850011,Monroe School District,Masuk High School,635,667,1302,2009-10
0850111,0850011,Monroe School District,Monroe Elementary School,162,196,358,2009-10
0850311,0850011,Monroe School District,Stepney Elementary School,217,233,450,2009-10
0860711,0860011,Montville School District,Dr. Charles E. Murphy School,172,192,364,2009-10
0865111,0860011,Montville School District,Leonard J. Tyl Middle School,322,337,659,2009-10
0860111,0860011,Montville School District,Mohegan School,219,193,412,2009-10
0866111,0860011,Montville School District,Montville High School,379,413,792,2009-10
0860511,0860011,Montville School District,Oakdale School,208,233,441,2009-10
0869011,0860011,Montville School District,Palmer Academy,9,12,21,2009-10
0880811,0880011,Naugatuck School District,Andrew Avenue School,107,120,227,2009-10
0880111,0880011,Naugatuck School District,Central Avenue School,150,134,284,2009-10
0885111,0880011,Naugatuck School District,City Hill Middle School,233,238,471,2009-10
0880211,0880011,Naugatuck School District,Cross Street Intermediate School,182,206,388,2009-10
0888111,0880011,Naugatuck School District,Head Start,47,57,104,2009-10
0880411,0880011,Naugatuck School District,Hillside Intermediate School,166,202,368,2009-10
0885211,0880011,Naugatuck School District,Hillside Middle School,142,164,306,2009-10
0880511,0880011,Naugatuck School District,Hop Brook Elementary School,160,160,320,2009-10
0880311,0880011,Naugatuck School District,Maple Hill School,221,238,459,2009-10
0886111,0880011,Naugatuck School District,Naugatuck High School,705,729,1434,2009-10
0880611,0880011,Naugatuck School District,Salem School,115,131,246,2009-10
0880711,0880011,Naugatuck School District,Western School,119,155,274,2009-10
2800113,2800013,New Beginnings Inc Family Academy District,New Beginnings Inc Family Academy,195,165,360,2009-10
0899211,0890011,New Britain School District,Academic Extension Center,7,14,21,2009-10
0899311,0890011,New Britain School District,Behavior Support Program,*,*,12,2009-10
0890311,0890011,New Britain School District,Chamberlain  Elementary School,202,273,475,2009-10
0891111,0890011,New Britain School District,Frank J. DiLoreto School,470,324,794,2009-10
0890511,0890011,New Britain School District,Gaffney School,227,295,522,2009-10
0890611,0890011,New Britain School District,Holmes School,212,256,468,2009-10
0895411,0890011,New Britain School District,House of Arts Letters and Science (HALS)  Academy,85,70,155,2009-10
0890711,0890011,New Britain School District,Jefferson School,187,236,423,2009-10
0890811,0890011,New Britain School District,Lincoln School,292,319,611,2009-10
0896111,0890011,New Britain School District,New Britain High School,1293,1466,2759,2009-10
0899011,0890011,New Britain School District,New Britain Transition Center,10,26,36,2009-10
0890911,0890011,New Britain School District,Northend School,134,162,296,2009-10
0895311,0890011,New Britain School District,Pulaski Middle School,291,358,649,2009-10
0895111,0890011,New Britain School District,Roosevelt Middle School,215,227,442,2009-10
0895211,0890011,New Britain School District,Slade Middle School,356,360,716,2009-10
0891211,0890011,New Britain School District,Smalley Academy,346,365,711,2009-10
0891311,0890011,New Britain School District,Smith School,295,316,611,2009-10
0891511,0890011,New Britain School District,Vance School,254,269,523,2009-10
0900411,0900011,New Canaan School District,East School,275,264,539,2009-10
0906111,0900011,New Canaan School District,New Canaan High School,655,632,1287,2009-10
0905111,0900011,New Canaan School District,Saxe Middle School,614,604,1218,2009-10
0900211,0900011,New Canaan School District,South School,270,271,541,2009-10
0900311,0900011,New Canaan School District,West School,233,259,492,2009-10
0910111,0910011,New Fairfield School District,Consolidated School,304,345,649,2009-10
0910211,0910011,New Fairfield School District,Meeting House Hill School,276,361,637,2009-10
0916111,0910011,New Fairfield School District,New Fairfield High School,502,518,1020,2009-10
0915211,0910011,New Fairfield School District,New Fairfield Middle School,346,377,723,2009-10
0920311,0920011,New Hartford School District,Ann Antolini School,175,186,361,2009-10
0920111,0920011,New Hartford School District,Bakerville Consolidated School,80,74,154,2009-10
0929011,0920011,New Hartford School District,Bridges I,*,*,6,2009-10
0920211,0920011,New Hartford School District,New Hartford Elementary School,57,53,110,2009-10
0931211,0930011,New Haven School District,Edgewood School,225,234,459,2009-10
0931411,0930011,New Haven School District,Nathan Hale School,259,274,533,2009-10
0931511,0930011,New Haven School District,Augusta Lewis Troup School,236,289,525,2009-10
0930211,0930011,New Haven School District,Barnard Environmental Magnet School,248,256,504,2009-10
0930311,0930011,New Haven School District,Beecher School,218,260,478,2009-10
0931811,0930011,New Haven School District,Benjamin Jepson Magnet School,223,273,496,2009-10
0935511,0930011,New Haven School District,Betsy Ross Arts Magnet School,299,174,473,2009-10
0934311,0930011,New Haven School District,Bishop Woods Architecture and Design Magnet School,220,227,447,2009-10
0934811,0930011,New Haven School District,"Celentano BioTech, Health and Medical Magnet School",217,248,465,2009-10
0930511,0930011,New Haven School District,Clarence Rogers School,66,84,150,2009-10
0930611,0930011,New Haven School District,Clinton Avenue School,221,234,455,2009-10
0934111,0930011,New Haven School District,Columbus Family Academy,234,193,427,2009-10
0933111,0930011,New Haven School District,Conte/West Hills Magnet School,324,311,635,2009-10
0936411,0930011,New Haven School District,Cooperative High School,376,165,541,2009-10
0936811,0930011,New Haven School District,Cortlandt V.R. Creed Health and Sport Sciences High School,41,151,192,2009-10
0930911,0930011,New Haven School District,Davis 21st Century Magnet Elementary School,192,221,413,2009-10
0938211,0930011,New Haven School District,Dwight Early Childhood Program,18,29,47,2009-10
0938111,0930011,New Haven School District,Early Learning Center,60,58,118,2009-10
0934611,0930011,New Haven School District,East Rock Community Magnet School,241,262,503,2009-10
0931711,0930011,New Haven School District,Engineering - Science University Magnet School,57,101,158,2009-10
0931611,0930011,New Haven School District,Fair Haven School,288,331,619,2009-10
0938011,0930011,New Haven School District,Headstart,219,222,441,2009-10
0938311,0930011,New Haven School District,Helene Grant HeadStart,134,140,274,2009-10
0936611,0930011,New Haven School District,High School In The Community,188,139,327,2009-10
0930711,0930011,New Haven School District,Hill Central Music Academy,179,186,365,2009-10
0936311,0930011,New Haven School District,Hill Regional Career High School,448,251,699,2009-10
0936211,0930011,New Haven School District,James Hillhouse High School,445,503,948,2009-10
0931311,0930011,New Haven School District,John C. Daniels,279,253,532,2009-10
0930811,0930011,New Haven School District,John S. Martinez Sea and Sky STEM School,310,278,588,2009-10
0930411,0930011,New Haven School District,Katherine Brennan School,88,88,176,2009-10
0933011,0930011,New Haven School District,King/Robinson Magnet School,233,242,475,2009-10
0932011,0930011,New Haven School District,Lincoln-Bassett School,155,162,317,2009-10
0931911,0930011,New Haven School District,Mauro-Sheridan Magnet School,252,344,596,2009-10
0936011,0930011,New Haven School District,Metropolitan Business Academy,86,98,184,2009-10
0937011,0930011,New Haven School District,New Haven Academy,130,109,239,2009-10
0939211,0930011,New Haven School District,Polly T. McCabe Center,26,0,26,2009-10
0939111,0930011,New Haven School District,Riverside Education Academy,91,99,190,2009-10
0934211,0930011,New Haven School District,Roberto Clemente Leadership Academy for Global Awareness,188,195,383,2009-10
0931011,0930011,New Haven School District,Ross/Woodward School,268,268,536,2009-10
0936711,0930011,New Haven School District,Sound School,154,174,328,2009-10
0932811,0930011,New Haven School District,Strong 21st Century Communications Magnet and SCSU Lab School,130,137,267,2009-10
0932911,0930011,New Haven School District,Truman School,279,270,549,2009-10
0939011,0930011,New Haven School District,Urban Youth Center Middle School,9,25,34,2009-10
0934911,0930011,New Haven School District,West Rock Authors Academy,106,124,230,2009-10
0933211,0930011,New Haven School District,Wexler/Grant Community School,248,213,461,2009-10
0936111,0930011,New Haven School District,Wilbur Cross High School,772,848,1620,2009-10
0933811,0930011,New Haven School District,Worthington Hooker School,217,216,433,2009-10
0950311,0950011,New London School District,Jennings School,287,257,544,2009-10
0955111,0950011,New London School District,Bennie Dover Jackson Middle School,265,345,610,2009-10
0950211,0950011,New London School District,Harbor School,130,158,288,2009-10
0950911,0950011,New London School District,Nathan Hale Arts Magnet School,127,146,273,2009-10
0959111,0950011,New London School District,New London Clinical Day Program,7,15,22,2009-10
0956111,0950011,New London School District,New London High School,417,518,935,2009-10
0950511,0950011,New London School District,Shoreline Academy,50,53,103,2009-10
0950811,0950011,New London School District,Winthrop STEM Elementary Magnet School,94,130,224,2009-10
0960511,0960011,New Milford School District,Hill And Plain School,199,250,449,2009-10
0960711,0960011,New Milford School District,John Pettibone School,204,244,448,2009-10
0969011,0960011,New Milford School District,Litchfield Hills Transition Center,*,*,7,2009-10
0966111,0960011,New Milford School District,New Milford High School,782,784,1566,2009-10
0960811,0960011,New Milford School District,Northville Elementary School,261,273,534,2009-10
0960911,0960011,New Milford School District,Sarah Noble Intermediate School,532,554,1086,2009-10
0965211,0960011,New Milford School District,Schaghticoke Middle School,401,373,774,2009-10
0940611,0940011,Newington School District,Anna Reynolds School,213,232,445,2009-10
0940211,0940011,Newington School District,Elizabeth Green School,149,159,308,2009-10
0940811,0940011,Newington School District,John Paterson School,211,279,490,2009-10
0945311,0940011,Newington School District,John Wallace Middle School,386,342,728,2009-10
0945111,0940011,Newington School District,Martin Kellogg Middle School,306,327,633,2009-10
0946111,0940011,Newington School District,Newington High School,706,762,1468,2009-10
0940711,0940011,Newington School District,Ruth Chaffee School,202,193,395,2009-10
0970111,0970011,Newtown School District,Hawley Elementary School,191,229,420,2009-10
0970411,0970011,Newtown School District,Head O'Meadow Elementary School,159,216,375,2009-10
0970311,0970011,Newtown School District,Middle Gate Elementary School,258,237,495,2009-10
0976111,0970011,Newtown School District,Newtown High School,868,863,1731,2009-10
0975111,0970011,Newtown School District,Newtown Middle School,447,449,896,2009-10
0978011,0970011,Newtown School District,Newtown Preschool,37,50,87,2009-10
0970511,0970011,Newtown School District,Reed Intermediate School,403,458,861,2009-10
0970211,0970011,Newtown School District,Sandy Hook Elementary School,291,334,625,2009-10
0980111,0980011,Norfolk School District,Botelle Elementary School,69,68,137,2009-10
0989211,0980011,Norfolk School District,Bridges II,*,*,*,2009-10
0989011,0980011,Norfolk School District,IEP Program,*,*,*,2009-10
0990411,0990011,North Branford School District,Jerome Harrison School,153,174,327,2009-10
0996111,0990011,North Branford School District,North Branford High School,351,335,686,2009-10
0995111,0990011,North Branford School District,North Branford Intermediate School,287,322,609,2009-10
0990511,0990011,North Branford School District,Stanley T. Williams School,135,116,251,2009-10
0990611,0990011,North Branford School District,Totoket Valley Elementary School,245,220,465,2009-10
1000111,1000011,North Canaan School District,North Canaan Elementary School,171,157,328,2009-10
1010811,1010011,North Haven School District,Clintonville Elementary School,175,221,396,2009-10
1010711,1010011,North Haven School District,Green Acres Elementary School,192,201,393,2009-10
1010211,1010011,North Haven School District,Montowese Elementary School,217,198,415,2009-10
1016111,1010011,North Haven School District,North Haven High School,602,579,1181,2009-10
1015211,1010011,North Haven School District,North Haven Middle School,426,446,872,2009-10
1010311,1010011,North Haven School District,Ridge Road Elementary School,208,220,428,2009-10
1020111,1020011,North Stonington School District,North Stonington Elementary School,165,218,383,2009-10
1026111,1020011,North Stonington School District,Wheeler High School,105,121,226,2009-10
1025111,1020011,North Stonington School District,Wheeler Middle School,89,93,182,2009-10
1036211,1030011,Norwalk School District,Brien McMahon High School,874,820,1694,2009-10
1030211,1030011,Norwalk School District,Brookside Elementary School,214,269,483,2009-10
1030311,1030011,Norwalk School District,Columbus Magnet School,188,160,348,2009-10
1030411,1030011,Norwalk School District,Cranbury Elementary School,221,260,481,2009-10
1032011,1030011,Norwalk School District,Fox Run Elementary School,206,254,460,2009-10
1030711,1030011,Norwalk School District,Jefferson Magnet School,255,284,539,2009-10
1030811,1030011,Norwalk School District,Kendall Elementary School,222,261,483,2009-10
1032211,1030011,Norwalk School District,Marvin Elementary School,222,235,457,2009-10
1032111,1030011,Norwalk School District,Naramake Elementary School,219,218,437,2009-10
1035211,1030011,Norwalk School District,Nathan Hale Middle School,290,298,588,2009-10
1036111,1030011,Norwalk School District,Norwalk High School,766,737,1503,2009-10
1036311,1030011,Norwalk School District,Norwalk Pathways Academy at Briggs,35,64,99,2009-10
1035311,1030011,Norwalk School District,Ponus Ridge Middle School,312,374,686,2009-10
1035511,1030011,Norwalk School District,Roton Middle School,207,193,400,2009-10
1031311,1030011,Norwalk School District,Rowayton School,229,239,468,2009-10
1032311,1030011,Norwalk School District,Silvermine Elementary School,171,166,337,2009-10
1031411,1030011,Norwalk School District,Tracey School,192,209,401,2009-10
1035411,1030011,Norwalk School District,West Rocks Middle School,324,339,663,2009-10
1032411,1030011,Norwalk School District,Wolfpit School,156,173,329,2009-10
9016122,9010022,Norwich Free Academy District,Norwich Free Academy,1269,1152,2421,2009-10
1040111,1040011,Norwich School District,Bishop School Early Learning Center,89,84,173,2009-10
1049111,1040011,Norwich School District,Deborah-Tennant Zinewicz  School,10,37,47,2009-10
1040611,1040011,Norwich School District,Greeneville School,157,171,328,2009-10
1049011,1040011,Norwich School District,Hickory Street School,*,*,19,2009-10
1041411,1040011,Norwich School District,John B. Stanton Network School,164,189,353,2009-10
1045111,1040011,Norwich School District,Kelly Middle School,315,316,631,2009-10
1042011,1040011,Norwich School District,Moriarty Magnet School,163,203,366,2009-10
1040811,1040011,Norwich School District,Samuel Huntington School,182,229,411,2009-10
1045211,1040011,Norwich School District,Teachers' Memorial Middle School,282,238,520,2009-10
1046111,1040011,Norwich School District,Thames River Academy,40,45,85,2009-10
1041711,1040011,Norwich School District,Thomas W. Mahan School,173,127,300,2009-10
1041911,1040011,Norwich School District,Uncas Network School,80,89,169,2009-10
1041811,1040011,Norwich School District,Veterans' Memorial School,118,115,233,2009-10
1041511,1040011,Norwich School District,Wequonnoc Magnet School,125,111,236,2009-10
2635113,2630013,Odyssey Community School District,Odyssey Community School,98,82,180,2009-10
1060211,1060011,Old Saybrook School District,Kathleen E. Goodwin School,232,233,465,2009-10
1065211,1060011,Old Saybrook School District,Old Saybrook Middle School,292,306,598,2009-10
1066111,1060011,Old Saybrook School District,Old Saybrook Senior High School,269,259,528,2009-10
1070211,1070011,Orange School District,Mary L. Tracy School,94,92,186,2009-10
1070511,1070011,Orange School District,Peck Place School,213,198,411,2009-10
1070311,1070011,Orange School District,Race Brook School,208,192,400,2009-10
1070411,1070011,Orange School District,Turkey Hill School,140,160,300,2009-10
1085111,1080011,Oxford School District,Great Oak School,253,252,505,2009-10
1080111,1080011,Oxford School District,Oxford Center School,262,274,536,2009-10
1086011,1080011,Oxford School District,Oxford High School,269,296,565,2009-10
1080311,1080011,Oxford School District,Quaker Farms School,273,277,550,2009-10
2835113,2830013,Park City Prep Charter School District,Park City Prep Charter School,116,126,242,2009-10
1090511,1090011,Plainfield School District,Early Childhood Center,127,147,274,2009-10
1090111,1090011,Plainfield School District,Moosup Elementary School,139,156,295,2009-10
1095111,1090011,Plainfield School District,Plainfield Central School,275,298,573,2009-10
1096111,1090011,Plainfield School District,Plainfield High School,433,419,852,2009-10
1090311,1090011,Plainfield School District,Plainfield Memorial School,208,211,419,2009-10
1090411,1090011,Plainfield School District,Shepard Hill Elementary School,157,152,309,2009-10
1100411,1100011,Plainville School District,Frank T. Wheeler School,135,148,283,2009-10
1100211,1100011,Plainville School District,Linden Street School,198,215,413,2009-10
1100511,1100011,Plainville School District,Louis Toffolon School,173,177,350,2009-10
1105211,1100011,Plainville School District,Middle School of Plainville,281,293,574,2009-10
1106111,1100011,Plainville School District,Plainville High School,440,422,862,2009-10
1108011,1100011,Plainville School District,Prekindergarten Program,22,32,54,2009-10
1115111,1110011,Plymouth School District,Eli Terry Jr. Middle School,208,247,455,2009-10
1110411,1110011,Plymouth School District,Harry S. Fisher Elementary School,200,193,393,2009-10
1110211,1110011,Plymouth School District,Plymouth Center School,176,236,412,2009-10
1116111,1110011,Plymouth School District,Terryville High School,256,265,521,2009-10
1120111,1120011,Pomfret School District,Pomfret Community School,274,258,532,2009-10
1130511,1130011,Portland School District,Brownstone Intermediate School,115,122,237,2009-10
1130411,1130011,Portland School District,Gildersleeve School,130,118,248,2009-10
1136111,1130011,Portland School District,Portland High School,173,189,362,2009-10
1135111,1130011,Portland School District,Portland Middle School,116,124,240,2009-10
1130211,1130011,Portland School District,Valley View School,181,168,349,2009-10
1145111,1140011,Preston School District,Preston Plains School,71,77,148,2009-10
1140411,1140011,Preston School District,Preston Veterans' Memorial School,150,134,284,2009-10
1169011,1160011,Putnam School District,Helping Hands,*,*,*,2009-10
1160311,1160011,Putnam School District,Putnam Elementary School,307,337,644,2009-10
1166111,1160011,Putnam School District,Putnam High School,150,177,327,2009-10
1165111,1160011,Putnam School District,Putnam Middle School,106,148,254,2009-10
1175111,1170011,Redding School District,John Read Middle School,314,281,595,2009-10
1170111,1170011,Redding School District,Redding Elementary School,320,350,670,2009-10
2016112,2010012,Regional School District 01,Housatonic Valley Regional High School,252,258,510,2009-10
2045112,2040012,Regional School District 04,John Winthrop Middle School,171,183,354,2009-10
2046112,2040012,Regional School District 04,Valley Regional High School,305,313,618,2009-10
2055112,2050012,Regional School District 05,Amity Middle School: Bethany,193,230,423,2009-10
2055212,2050012,Regional School District 05,Amity Middle School: Orange,211,219,430,2009-10
2056112,2050012,Regional School District 05,Amity Regional High School,784,846,1630,2009-10
2060112,2060012,Regional School District 06,Goshen Center School,113,105,218,2009-10
2060212,2060012,Regional School District 06,James Morris School,100,107,207,2009-10
2068012,2060012,Regional School District 06,Stepping Stones Preschool Program,6,8,14,2009-10
2066112,2060012,Regional School District 06,Wamogo Regional High School,298,238,536,2009-10
2060312,2060012,Regional School District 06,Warren Elementary School,44,52,96,2009-10
2079112,2070012,Regional School District 07,AIM,*,*,13,2009-10
2079012,2070012,Regional School District 07,FLEX,0,*,*,2009-10
2079412,2070012,Regional School District 07,Intensive Learning Program,0,6,6,2009-10
2079212,2070012,Regional School District 07,Links,11,12,23,2009-10
2076112,2070012,Regional School District 07,Northwestern Regional High School,402,355,757,2009-10
2075112,2070012,Regional School District 07,Northwestern Regional Middle School,174,168,342,2009-10
2079312,2070012,Regional School District 07,STEP,8,13,21,2009-10
2086112,2080012,Regional School District 08,RHAM High School,499,586,1085,2009-10
2085112,2080012,Regional School District 08,RHAM Middle School,294,350,644,2009-10
2096112,2090012,Regional School District 09,Joel Barlow High School,496,462,958,2009-10
2105112,2100012,Regional School District 10,Har-Bur Middle School,431,475,906,2009-10
2100312,2100012,Regional School District 10,Harwinton Consolidated School,239,238,477,2009-10
2100212,2100012,Regional School District 10,Lake Garda Elementary School,296,325,621,2009-10
2106112,2100012,Regional School District 10,Lewis S. Mills High School,381,432,813,2009-10
2116112,2110012,Regional School District 11,Parish Hill High School,145,146,291,2009-10
2120212,2120012,Regional School District 12,Booth Free School,58,54,112,2009-10
2128012,2120012,Regional School District 12,Early Childhood Education Center,17,12,29,2009-10
2126112,2120012,Regional School District 12,Shepaug Valley High School,141,182,323,2009-10
2125112,2120012,Regional School District 12,Shepaug Valley Middle School,117,131,248,2009-10
2120112,2120012,Regional School District 12,The Burnham School,37,50,87,2009-10
2120412,2120012,Regional School District 12,Washington Primary School,84,85,169,2009-10
2136112,2130012,Regional School District 13,Coginchaug Regional High School,298,279,577,2009-10
2130212,2130012,Regional School District 13,Francis E. Korn School,89,104,193,2009-10
2135112,2130012,Regional School District 13,Frank Ward Strong School,177,169,346,2009-10
2130112,2130012,Regional School District 13,Frederick Brewster School,110,174,284,2009-10
2130512,2130012,Regional School District 13,John Lyman School,163,160,323,2009-10
2130412,2130012,Regional School District 13,Middlefield Memorial School,173,187,360,2009-10
2140112,2140012,Regional School District 14,Bethlehem Elementary School,175,175,350,2009-10
2148012,2140012,Regional School District 14,Integrated Star Preschool Program,14,15,29,2009-10
2140212,2140012,Regional School District 14,Mitchell Elementary School,213,202,415,2009-10
2146112,2140012,Regional School District 14,Nonnewaug High School,458,384,842,2009-10
2145112,2140012,Regional School District 14,Woodbury Middle School,230,243,473,2009-10
2150412,2150012,Regional School District 15,Gainfield Elementary School,216,230,446,2009-10
2150712,2150012,Regional School District 15,Long Meadow Elementary School,286,322,608,2009-10
2155212,2150012,Regional School District 15,Memorial Middle School,272,260,532,2009-10
2150612,2150012,Regional School District 15,Middlebury Elementary School,202,251,453,2009-10
2156212,2150012,Regional School District 15,Pomperaug Regional High School,687,731,1418,2009-10
2150512,2150012,Regional School District 15,Pomperaug School,227,304,531,2009-10
2155112,2150012,Regional School District 15,Rochambeau Middle School,281,273,554,2009-10
2160312,2160012,Regional School District 16,Algonquin School,230,243,473,2009-10
2160212,2160012,Regional School District 16,Community School,133,93,226,2009-10
2160112,2160012,Regional School District 16,Laurel Ledge School,228,247,475,2009-10
2165112,2160012,Regional School District 16,Long River Middle School,316,306,622,2009-10
2166012,2160012,Regional School District 16,Woodland Regional High School,380,409,789,2009-10
2170212,2170012,Regional School District 17,Burr District Elementary School,150,154,304,2009-10
2170112,2170012,Regional School District 17,Haddam Elementary School,122,146,268,2009-10
2176112,2170012,Regional School District 17,Haddam-Killingworth High School,328,361,689,2009-10
2175112,2170012,Regional School District 17,Haddam-Killingworth Middle School,389,411,800,2009-10
2170312,2170012,Regional School District 17,Killingworth Elementary School,215,225,440,2009-10
2180312,2180012,Regional School District 18,Center School,149,115,264,2009-10
2180112,2180012,Regional School District 18,Lyme Consolidated School,70,75,145,2009-10
2186112,2180012,Regional School District 18,Lyme-Old Lyme High School,227,216,443,2009-10
2185112,2180012,Regional School District 18,Lyme-Old Lyme Middle School,147,178,325,2009-10
2180212,2180012,Regional School District 18,Mile Creek School,143,161,304,2009-10
2196112,2190012,Regional School District 19,E. O. Smith High School,610,583,1193,2009-10
1180811,1180011,Ridgefield School District,Barlow Mountain Elementary School,181,225,406,2009-10
1180611,1180011,Ridgefield School District,Branchville Elementary School,211,214,425,2009-10
1185111,1180011,Ridgefield School District,East Ridge Middle School,346,395,741,2009-10
1180411,1180011,Ridgefield School District,Farmingville Elementary School,180,188,368,2009-10
1180311,1180011,Ridgefield School District,Ridgebury Elementary School,220,202,422,2009-10
1186111,1180011,Ridgefield School District,Ridgefield High School,861,891,1752,2009-10
1180511,1180011,Ridgefield School District,Scotland Elementary School,175,217,392,2009-10
1185211,1180011,Ridgefield School District,Scotts Ridge Middle School,300,310,610,2009-10
1180211,1180011,Ridgefield School District,Veterans Park Elementary School,141,184,325,2009-10
1195111,1190011,Rocky Hill School District,Albert D. Griswold Middle School,338,311,649,2009-10
1190211,1190011,Rocky Hill School District,Dr. Oran A. Moser School,44,39,83,2009-10
1190411,1190011,Rocky Hill School District,Myrtle H. Stevens School,223,278,501,2009-10
1196111,1190011,Rocky Hill School District,Rocky Hill High School,384,397,781,2009-10
1190511,1190011,Rocky Hill School District,West Hill School,323,303,626,2009-10
1210111,1210011,Salem School District,Salem Elementary School,236,254,490,2009-10
1220111,1220011,Salisbury School District,Salisbury Central School,156,155,311,2009-10
1230111,1230011,Scotland School District,Scotland Elementary School,78,83,161,2009-10
1240311,1240011,Seymour School District,Anna L. Lopresti School,145,152,297,2009-10
1240111,1240011,Seymour School District,Bungay School,274,289,563,2009-10
1240411,1240011,Seymour School District,Paul E. Chatfield School,139,152,291,2009-10
1246111,1240011,Seymour School District,Seymour High School,363,341,704,2009-10
1245111,1240011,Seymour School District,Seymour Middle School,278,293,571,2009-10
1250111,1250011,Sharon School District,Sharon Center School,103,102,205,2009-10
1260911,1260011,Shelton School District,Mohegan School,332,313,645,2009-10
1261011,1260011,Shelton School District,Booth Hill School,228,253,481,2009-10
1260511,1260011,Shelton School District,Elizabeth Shelton School,282,308,590,2009-10
1265111,1260011,Shelton School District,Intermediate School,441,432,873,2009-10
1260411,1260011,Shelton School District,Lafayette School,152,168,320,2009-10
1260811,1260011,Shelton School District,Long Hill School,305,295,600,2009-10
1266111,1260011,Shelton School District,Shelton High School,801,830,1631,2009-10
1260611,1260011,Shelton School District,Sunnyside School,139,179,318,2009-10
1270111,1270011,Sherman School District,Sherman School,215,229,444,2009-10
2700113,2700013,Side By Side Charter School District,Side By Side Charter School,115,117,232,2009-10
1280111,1280011,Simsbury School District,Central School,182,209,391,2009-10
1285111,1280011,Simsbury School District,Henry James Memorial School,394,433,827,2009-10
1280611,1280011,Simsbury School District,Latimer Lane School,227,263,490,2009-10
1286111,1280011,Simsbury School District,Simsbury High School,746,835,1581,2009-10
1280711,1280011,Simsbury School District,Squadron Line School,375,406,781,2009-10
1280311,1280011,Simsbury School District,Tariffville School,129,154,283,2009-10
1280411,1280011,Simsbury School District,Tootin' Hills School,232,280,512,2009-10
1295111,1290011,Somers School District,Mabelle B. Avery Middle School,200,214,414,2009-10
1290411,1290011,Somers School District,Somers Elementary School,313,351,664,2009-10
1296111,1290011,Somers School District,Somers High School,281,291,572,2009-10
1320211,1320011,South Windsor School District,Pleasant Valley School,200,236,436,2009-10
1320711,1320011,South Windsor School District,Eli Terry School,204,231,435,2009-10
1320611,1320011,South Windsor School District,Orchard Hill School,225,241,466,2009-10
1320111,1320011,South Windsor School District,Philip R. Smith School,174,186,360,2009-10
1326211,1320011,South Windsor School District,South Windsor High School,734,841,1575,2009-10
1325111,1320011,South Windsor School District,Timothy Edwards School,535,538,1073,2009-10
1320411,1320011,South Windsor School District,Wapping Elementary School,145,164,309,2009-10
1315311,1310011,Southington School District,John F. Kennedy Middle School,382,419,801,2009-10
1311511,1310011,Southington School District,Derynoski Elementary School,369,322,691,2009-10
1311311,1310011,Southington School District,Flanders Elementary School,159,148,307,2009-10
1310211,1310011,Southington School District,Hatton Elementary School,197,242,439,2009-10
1315111,1310011,Southington School District,Joseph A. Depaolo Middle School,372,411,783,2009-10
1310611,1310011,Southington School District,Plantsville Elementary School,99,117,216,2009-10
1310711,1310011,Southington School District,South End Elementary School,103,119,222,2009-10
1316211,1310011,Southington School District,Southington High School,1017,1016,2033,2009-10
1310811,1310011,Southington School District,Strong Elementary School,237,240,477,2009-10
1310911,1310011,Southington School District,Thalberg Elementary School,203,219,422,2009-10
1311411,1310011,Southington School District,Urbin T. Kelley School,199,208,407,2009-10
1330111,1330011,Sprague School District,Sayles School,165,186,351,2009-10
1340611,1340011,Stafford School District,Stafford Elementary School,249,274,523,2009-10
1346111,1340011,Stafford School District,Stafford High School,275,262,537,2009-10
1345211,1340011,Stafford School District,Stafford Middle School,208,199,407,2009-10
1340311,1340011,Stafford School District,Staffordville School,85,96,181,2009-10
1340411,1340011,Stafford School District,West Stafford School,91,100,191,2009-10
2826013,2820013,Stamford Academy District,Stamford Academy,59,72,131,2009-10
1355611,1350011,Stamford School District,Cloonan School,266,315,581,2009-10
1352011,1350011,Stamford School District,Davenport Ridge School,280,253,533,2009-10
1355311,1350011,Stamford School District,Dolan School,297,318,615,2009-10
1352211,1350011,Stamford School District,Hart School,217,264,481,2009-10
1351211,1350011,Stamford School District,Julia A. Stark School,263,295,558,2009-10
1350511,1350011,Stamford School District,K. T. Murphy School,273,251,524,2009-10
1350611,1350011,Stamford School District,Newfield School,303,334,637,2009-10
1351811,1350011,Stamford School District,Northeast School,390,362,752,2009-10
1358011,1350011,Stamford School District,Preschool Team,11,30,41,2009-10
1355811,1350011,Stamford School District,Rippowam Middle School,330,360,690,2009-10
1350811,1350011,Stamford School District,Rogers International School,328,322,650,2009-10
1350911,1350011,Stamford School District,Roxbury School,318,379,697,2009-10
1355711,1350011,Stamford School District,Scofield Middle School,310,307,617,2009-10
1351111,1350011,Stamford School District,Springdale School,264,292,556,2009-10
1356111,1350011,Stamford School District,Stamford High School,846,887,1733,2009-10
1352111,1350011,Stamford School District,Stillmeadow School,302,310,612,2009-10
1356411,1350011,Stamford School District,The Academy of Information Technology,257,422,679,2009-10
1351911,1350011,Stamford School District,Toquam Magnet School,289,293,582,2009-10
1355511,1350011,Stamford School District,Turn of River School,259,280,539,2009-10
1356311,1350011,Stamford School District,Westhill High School,1132,1149,2281,2009-10
1351411,1350011,Stamford School District,Westover School,342,336,678,2009-10
1360311,1360011,Sterling School District,Sterling Community School,235,272,507,2009-10
1370511,1370011,Stonington School District,Deans Mill School,243,262,505,2009-10
1375211,1370011,Stonington School District,Mystic Middle School,210,202,412,2009-10
1375111,1370011,Stonington School District,Pawcatuck Middle School,184,189,373,2009-10
1378011,1370011,Stonington School District,Special Needs Preschool Program,11,11,22,2009-10
1376111,1370011,Stonington School District,Stonington High School,382,411,793,2009-10
1370411,1370011,Stonington School District,West Broad Street School,94,90,184,2009-10
1370611,1370011,Stonington School District,West Vine Street School,115,116,231,2009-10
1381311,1380011,Stratford School District,Eli Whitney School,263,262,525,2009-10
1386211,1380011,Stratford School District,Bunnell High School,629,617,1246,2009-10
1380311,1380011,Stratford School District,Chapel School,264,299,563,2009-10
1385211,1380011,Stratford School District,David Wooster Middle School,278,295,573,2009-10
1380411,1380011,Stratford School District,Franklin School,176,166,342,2009-10
1385311,1380011,Stratford School District,Harry B. Flood Middle School,301,303,604,2009-10
1381611,1380011,Stratford School District,Honeyspot School,115,124,239,2009-10
1380811,1380011,Stratford School District,Lordship School,108,109,217,2009-10
1380911,1380011,Stratford School District,Nichols School,210,227,437,2009-10
1381011,1380011,Stratford School District,Second Hill Lane School,354,369,723,2009-10
1381511,1380011,Stratford School District,Stratford Academy - Johnson House,229,224,453,2009-10
1386111,1380011,Stratford School District,Stratford High School,517,464,981,2009-10
1389011,1380011,Stratford School District,Strive-Stratford,6,11,17,2009-10
1381411,1380011,Stratford School District,Wilcoxson School,192,214,406,2009-10
1390411,1390011,Suffield School District,A. Ward Spaulding School,256,259,515,2009-10
1390311,1390011,Suffield School District,McAlister Intermediate School,281,279,560,2009-10
1396111,1390011,Suffield School District,Suffield High School,446,406,852,2009-10
1395111,1390011,Suffield School District,Suffield Middle School,300,331,631,2009-10
2696113,2690013,The Bridge Academy District,The Bridge Academy,148,115,263,2009-10
9026122,9020022,The Gilbert School District,The Gilbert School,210,171,381,2009-10
1400111,1400011,Thomaston School District,Black Rock School,179,169,348,2009-10
1400211,1400011,Thomaston School District,Thomaston Center School,122,140,262,2009-10
1406211,1400011,Thomaston School District,Thomaston High School,270,288,558,2009-10
1410111,1410011,Thompson School District,Mary R. Fisher Elementary School,247,260,507,2009-10
1415111,1410011,Thompson School District,Thompson Middle School,209,230,439,2009-10
1416111,1410011,Thompson School District,Tourtellotte Memorial High School,194,184,378,2009-10
1420111,1420011,Tolland School District,Birch Grove Primary School,350,358,708,2009-10
1426111,1420011,Tolland School District,Tolland High School,451,490,941,2009-10
1420211,1420011,Tolland School District,Tolland Intermediate School,362,369,731,2009-10
1425111,1420011,Tolland School District,Tolland Middle School,378,394,772,2009-10
1430111,1430011,Torrington School District,East School,230,249,479,2009-10
1430211,1430011,Torrington School District,Forbes School,174,209,383,2009-10
1430811,1430011,Torrington School District,Southwest School,157,174,331,2009-10
1430911,1430011,Torrington School District,Torringford School,304,356,660,2009-10
1436111,1430011,Torrington School District,Torrington High School,566,618,1184,2009-10
1435111,1430011,Torrington School District,Torrington Middle School,529,607,1136,2009-10
1431311,1430011,Torrington School District,Vogel-Wetmore School,221,237,458,2009-10
2785113,2780013,Trailblazers Academy District,Trailblazers Academy,63,102,165,2009-10
1440111,1440011,Trumbull School District,Booth Hill School,265,259,524,2009-10
1440811,1440011,Trumbull School District,Daniels Farm School,253,271,524,2009-10
1441011,1440011,Trumbull School District,Frenchtown Elementary School,302,355,657,2009-10
1445211,1440011,Trumbull School District,Hillcrest Middle School,344,376,720,2009-10
1440411,1440011,Trumbull School District,Jane Ryan School,201,212,413,2009-10
1445111,1440011,Trumbull School District,Madison Middle School,448,451,899,2009-10
1440311,1440011,Trumbull School District,Middlebrook School,225,256,481,2009-10
1440911,1440011,Trumbull School District,Tashua School,202,209,411,2009-10
1448011,1440011,Trumbull School District,Trumbull Early Childhood Education Center,98,138,236,2009-10
1446111,1440011,Trumbull School District,Trumbull High School,1146,1003,2149,2009-10
3361715,3360015,Unified School District #1,Bergin Correctional Institution,0,32,32,2009-10
3360115,3360015,Unified School District #1,Bridgeport Correctional Center,0,8,8,2009-10
3360215,3360015,Unified School District #1,Brooklyn Correctional Institution,0,7,7,2009-10
3360315,3360015,Unified School District #1,Cheshire Correctional Institution,0,27,27,2009-10
3362415,3360015,Unified School District #1,Corrigan/Radgowski Correctional Institution,0,56,56,2009-10
3360415,3360015,Unified School District #1,Enfield Correctional Institution,0,19,19,2009-10
3361915,3360015,Unified School District #1,Garner Correctional Institution,0,20,20,2009-10
3360515,3360015,Unified School District #1,Gates Correctional Institution,0,17,17,2009-10
3360615,3360015,Unified School District #1,Hartford Correctional Center,0,60,60,2009-10
3362215,3360015,Unified School District #1,MacDougall/Walker Correctional Institution,0,77,77,2009-10
3361115,3360015,Unified School District #1,Manson Youth Institution,*,*,498,2009-10
3360915,3360015,Unified School District #1,New Haven Correctional Center,0,16,16,2009-10
3362615,3360015,Unified School District #1,Northern Correctional Institution,0,13,13,2009-10
3361215,3360015,Unified School District #1,Osborn Correctional Institution,0,29,29,2009-10
3361315,3360015,Unified School District #1,Robinson Correctional Institution,0,32,32,2009-10
3361415,3360015,Unified School District #1,Webster Correctional Institution,0,6,6,2009-10
3361515,3360015,Unified School District #1,Willard/Cybulski Correctional Institution,0,12,12,2009-10
3362515,3360015,Unified School District #1,York Correctional Institution,61,0,61,2009-10
3470115,3470015,Unified School District #2,Children's Place School,19,16,35,2009-10
3476515,3470015,Unified School District #2,High Meadows,0,12,12,2009-10
3470315,3470015,Unified School District #2,Riverview School,32,31,63,2009-10
3476715,3470015,Unified School District #2,Walter G. Cady School,*,*,97,2009-10
1450111,1450011,Union School District,Union Elementary School,44,34,78,2009-10
1460311,1460011,Vernon School District,Northeast School,143,138,281,2009-10
1461411,1460011,Vernon School District,Center Road School,257,233,490,2009-10
1460111,1460011,Vernon School District,Lake Street School,145,167,312,2009-10
1460211,1460011,Vernon School District,Maple Street School,152,172,324,2009-10
1469011,1460011,Vernon School District,Next Step Program (AACBP),*,*,12,2009-10
1466111,1460011,Vernon School District,Rockville High School,587,521,1108,2009-10
1461011,1460011,Vernon School District,Skinner Road School,163,189,352,2009-10
1465111,1460011,Vernon School District,Vernon Center Middle School,383,419,802,2009-10
1470111,1470011,Voluntown School District,Voluntown Elementary School,156,144,300,2009-10
1480211,1480011,Wallingford School District,Highland School,156,152,308,2009-10
1489011,1480011,Wallingford School District,A.R.T.S. Academy,*,*,11,2009-10
1481011,1480011,Wallingford School District,Cook Hill School,185,211,396,2009-10
1485211,1480011,Wallingford School District,Dag Hammarskjold Middle School,354,346,700,2009-10
1480911,1480011,Wallingford School District,Evarts C. Stevens School,216,214,430,2009-10
1485311,1480011,Wallingford School District,James H. Moran Middle School,425,414,839,2009-10
1486111,1480011,Wallingford School District,Lyman Hall High School,635,521,1156,2009-10
1486211,1480011,Wallingford School District,Mark T. Sheehan High School,488,491,979,2009-10
1480111,1480011,Wallingford School District,Moses Y. Beach School,182,174,356,2009-10
1480311,1480011,Wallingford School District,Parker Farms School,184,171,355,2009-10
1481211,1480011,Wallingford School District,Pond Hill School,146,142,288,2009-10
1480411,1480011,Wallingford School District,Rock Hill School,160,168,328,2009-10
1480811,1480011,Wallingford School District,Yalesville School,256,255,511,2009-10
1511011,1510011,Waterbury School District,Brooklyn Elementary School,94,109,203,2009-10
1515211,1510011,Waterbury School District,West Side Middle School,549,644,1193,2009-10
1512311,1510011,Waterbury School District,Washington School,167,143,310,2009-10
1512111,1510011,Waterbury School District,B. W. Tinker School,247,304,551,2009-10
1510311,1510011,Waterbury School District,Barnard School,131,119,250,2009-10
1510511,1510011,Waterbury School District,Bucks Hill School,267,298,565,2009-10
1510611,1510011,Waterbury School District,Bunker Hill School,247,244,491,2009-10
1512711,1510011,Waterbury School District,Carrington School,234,260,494,2009-10
1516211,1510011,Waterbury School District,Crosby High School,632,698,1330,2009-10
1510911,1510011,Waterbury School District,Driggs School,248,299,547,2009-10
1519111,1510011,Waterbury School District,Enlightenment School,75,100,175,2009-10
1511411,1510011,Waterbury School District,F. J. Kingsbury School,235,236,471,2009-10
1512611,1510011,Waterbury School District,Gilmartin School,110,139,249,2009-10
1510711,1510011,Waterbury School District,H. S. Chase School,388,397,785,2009-10
1511311,1510011,Waterbury School District,Hopeville School,216,198,414,2009-10
1516411,1510011,Waterbury School District,John F. Kennedy High School,692,677,1369,2009-10
1513111,1510011,Waterbury School District,Maloney Interdistrict Magnet School,285,322,607,2009-10
1511111,1510011,Waterbury School District,Margaret M. Generali Elementary School,288,295,583,2009-10
1515111,1510011,Waterbury School District,Michael F. Wallace Middle School,655,685,1340,2009-10
1515311,1510011,Waterbury School District,North End Middle School,594,637,1231,2009-10
1512811,1510011,Waterbury School District,Regan School,147,144,291,2009-10
1513311,1510011,Waterbury School District,Rotella Interdistrict Magnet School,316,297,613,2009-10
1518011,1510011,Waterbury School District,Special Education Preschool,78,140,218,2009-10
1512011,1510011,Waterbury School District,Sprague School,240,217,457,2009-10
1519011,1510011,Waterbury School District,State Street School,19,67,86,2009-10
1512211,1510011,Waterbury School District,Walsh School,253,290,543,2009-10
1516011,1510011,Waterbury School District,Waterbury Arts Magnet School (High),288,197,485,2009-10
1515011,1510011,Waterbury School District,Waterbury Arts Magnet School (Middle),183,133,316,2009-10
1510811,1510011,Waterbury School District,Wendell L. Cross School,180,187,367,2009-10
1516311,1510011,Waterbury School District,Wilby High School,573,611,1184,2009-10
1513211,1510011,Waterbury School District,Woodrow Wilson School,216,211,427,2009-10
1525111,1520011,Waterford School District,Clark Lane Middle School,314,353,667,2009-10
1520611,1520011,Waterford School District,Oswegatchie Elementary School,207,230,437,2009-10
1520711,1520011,Waterford School District,Quaker Hill Elementary School,183,220,403,2009-10
1520511,1520011,Waterford School District,Southwest Elementary School,191,189,380,2009-10
1526111,1520011,Waterford School District,Waterford High School,479,501,980,2009-10
1530311,1530011,Watertown School District,Fletcher W. Judson School,183,162,345,2009-10
1530211,1530011,Watertown School District,John Trumbull Primary School,351,382,733,2009-10
1530411,1530011,Watertown School District,Polk School,195,195,390,2009-10
1535111,1530011,Watertown School District,Swift Middle School,380,404,784,2009-10
1536111,1530011,Watertown School District,Watertown High School,495,491,986,2009-10
1551711,1550011,West Hartford School District,Smith School,177,191,368,2009-10
1559111,1550011,West Hartford School District,Achieve,*,*,*,2009-10
1551611,1550011,West Hartford School District,Aiken School,218,241,459,2009-10
1550211,1550011,West Hartford School District,Braeburn School,221,217,438,2009-10
1555311,1550011,West Hartford School District,Bristow Middle School,211,209,420,2009-10
1550411,1550011,West Hartford School District,Bugbee School,212,199,411,2009-10
1550511,1550011,West Hartford School District,Charter Oak International Academy,170,170,340,2009-10
1556111,1550011,West Hartford School District,Conard High School,800,764,1564,2009-10
1550611,1550011,West Hartford School District,Duffy School,269,313,582,2009-10
1556211,1550011,West Hartford School District,Hall High School,777,803,1580,2009-10
1555111,1550011,West Hartford School District,King Philip Middle School,424,452,876,2009-10
1550911,1550011,West Hartford School District,Morley School,186,193,379,2009-10
1551011,1550011,West Hartford School District,Norfeldt School,203,224,427,2009-10
1555211,1550011,West Hartford School District,Sedgwick Middle School,443,436,879,2009-10
1559011,1550011,West Hartford School District,WAAVE (W Hartford Applied Academic/Voc'l Experience),*,*,12,2009-10
1551211,1550011,West Hartford School District,Webster Hill School,233,213,446,2009-10
1551311,1550011,West Hartford School District,Whiting Lane School,220,285,505,2009-10
1551511,1550011,West Hartford School District,Wolcott School,254,243,497,2009-10
1561211,1560011,West Haven School District,Washington School,200,231,431,2009-10
1560811,1560011,West Haven School District,Alma E. Pagels School,174,193,367,2009-10
1561311,1560011,West Haven School District,Anna V. Molloy School,154,132,286,2009-10
1565311,1560011,West Haven School District,Carrigan 5/6 Intermediate School,332,369,701,2009-10
1561011,1560011,West Haven School District,Clarence E. Thompson School,193,190,383,2009-10
1560611,1560011,West Haven School District,Edith E. Mackrille School,187,179,366,2009-10
1560311,1560011,West Haven School District,Forest School,212,249,461,2009-10
1565111,1560011,West Haven School District,Harry M. Bailey Middle School,381,348,729,2009-10
1561411,1560011,West Haven School District,Savin Rock Community School,202,236,438,2009-10
1560411,1560011,West Haven School District,Seth G. Haley School,246,257,503,2009-10
1566111,1560011,West Haven School District,West Haven High School,800,769,1569,2009-10
1540211,1540011,Westbrook School District,Daisy Ingraham School,178,190,368,2009-10
1546111,1540011,Westbrook School District,Westbrook High School,134,166,300,2009-10
1545111,1540011,Westbrook School District,Westbrook Middle School,144,160,304,2009-10
1570111,1570011,Weston School District,Hurlbutt Elementary School,255,273,528,2009-10
1576111,1570011,Weston School District,Weston High School,420,378,798,2009-10
1570211,1570011,Weston School District,Weston Intermediate School,285,341,626,2009-10
1575111,1570011,Weston School District,Weston Middle School,292,308,600,2009-10
1585111,1580011,Westport School District,Bedford Middle School,412,433,845,2009-10
1580311,1580011,Westport School District,Coleytown Elementary School,239,228,467,2009-10
1585311,1580011,Westport School District,Coleytown Middle School,273,219,492,2009-10
1580411,1580011,Westport School District,Green's Farms School,223,244,467,2009-10
1580511,1580011,Westport School District,King's Highway Elementary School,232,251,483,2009-10
1580711,1580011,Westport School District,Long Lots School,278,318,596,2009-10
1580811,1580011,Westport School District,Saugatuck Elementary School,239,286,525,2009-10
1586111,1580011,Westport School District,Staples High School,885,900,1785,2009-10
1588011,1580011,Westport School District,Stepping Stones Preschool,17,39,56,2009-10
1590811,1590011,Wethersfield School District,Alfred W. Hanmer School,182,212,394,2009-10
1591011,1590011,Wethersfield School District,Charles Wright School,166,145,311,2009-10
1590211,1590011,Wethersfield School District,Emerson-Williams School,222,250,472,2009-10
1591111,1590011,Wethersfield School District,Highcrest School,204,226,430,2009-10
1591211,1590011,Wethersfield School District,Samuel B. Webb Elementary School,208,236,444,2009-10
1595211,1590011,Wethersfield School District,Silas Deane Middle School,264,314,578,2009-10
1596111,1590011,Wethersfield School District,Wethersfield High School,587,594,1181,2009-10
1600111,1600011,Willington School District,Center School,104,123,227,2009-10
1605111,1600011,Willington School District,Hall Memorial School,158,157,315,2009-10
1615211,1610011,Wilton School District,Middlebrook School,479,555,1034,2009-10
1610711,1610011,Wilton School District,Cider Mill School,534,490,1024,2009-10
1610611,1610011,Wilton School District,Ina E. Driscoll School,236,264,500,2009-10
1610511,1610011,Wilton School District,Miller-Driscoll School,234,258,492,2009-10
1616111,1610011,Wilton School District,Wilton High School,630,661,1291,2009-10
1620411,1620011,Winchester School District,Batcheller Early Education Center,45,58,103,2009-10
1620211,1620011,Winchester School District,Mary P. Hinsdale School,181,227,408,2009-10
1620511,1620011,Winchester School District,Pearson Academy,95,132,227,2009-10
1625111,1620011,Winchester School District,Pearson Middle School,102,122,224,2009-10
1638011,1630011,Windham School District,Early Headstart,12,18,30,2009-10
1639011,1630011,Windham School District,Eastern Regional Academy/Windham,6,28,34,2009-10
1630111,1630011,Windham School District,Natchaug School,130,139,269,2009-10
1630311,1630011,Windham School District,North Windham School,212,228,440,2009-10
1630611,1630011,Windham School District,W. B. Sweeney School,158,200,358,2009-10
1630511,1630011,Windham School District,Windham Center School,164,151,315,2009-10
1638311,1630011,Windham School District,Windham Early Childhood Prospect Street,82,122,204,2009-10
1636111,1630011,Windham School District,Windham High School,396,469,865,2009-10
1635111,1630011,Windham School District,Windham Middle School,480,471,951,2009-10
1650111,1650011,Windsor Locks School District,North Street School,204,238,442,2009-10
1650411,1650011,Windsor Locks School District,South Elementary School,184,203,387,2009-10
1656111,1650011,Windsor Locks School District,Windsor Locks High School,271,280,551,2009-10
1655111,1650011,Windsor Locks School District,Windsor Locks Middle School,201,221,422,2009-10
1640111,1640011,Windsor School District,Clover Street School,157,129,286,2009-10
1640811,1640011,Windsor School District,John F. Kennedy School,157,176,333,2009-10
1640911,1640011,Windsor School District,Oliver Ellsworth School,198,212,410,2009-10
1640511,1640011,Windsor School District,Poquonock Elementary School,153,145,298,2009-10
1641011,1640011,Windsor School District,Roger Wolcott Early Child Center,102,121,223,2009-10
1645311,1640011,Windsor School District,Sage Park Middle School,401,439,840,2009-10
1646111,1640011,Windsor School District,Windsor High School,661,707,1368,2009-10
1660611,1660011,Wolcott School District,Alcott School,171,195,366,2009-10
1660211,1660011,Wolcott School District,Frisbie School,186,197,383,2009-10
1665111,1660011,Wolcott School District,Tyrrell Middle School,358,369,727,2009-10
1660511,1660011,Wolcott School District,Wakelee School,211,221,432,2009-10
1666111,1660011,Wolcott School District,Wolcott High School,416,427,843,2009-10
1670211,1670011,Woodbridge School District,Beecher Road Intermediate School,210,224,434,2009-10
1670111,1670011,Woodbridge School District,Beecher Road Primary School,151,148,299,2009-10
9036122,9030022,Woodstock Academy District,Woodstock Academy,609,544,1153,2009-10
1690211,1690011,Woodstock School District,Woodstock Elementary School,238,262,500,2009-10
1695111,1690011,Woodstock School District,Woodstock Middle School,193,224,417,2009-10
2880113,2880013,Achievement First Hartford Academy Inc. District,Achievement First Hartford Academy Inc.,271,339,610,2010-11
2795113,2790013,Amistad Academy District,Amistad Academy,404,408,812,2010-11
0010111,0010011,Andover School District,Andover Elementary School,143,191,334,2010-11
0026111,0020011,Ansonia School District,Ansonia High School,341,386,727,2010-11
0025111,0020011,Ansonia School District,Ansonia Middle School,202,256,458,2010-11
0020311,0020011,Ansonia School District,Mead School,313,329,642,2010-11
0020811,0020011,Ansonia School District,Prendergast School,387,400,787,2010-11
2449614,2440014,Area Cooperative Educational Services,Center for Autism Spectrum and Development Disorders,*,*,19,2010-11
2449414,2440014,Area Cooperative Educational Services,Mill Road School,24,146,170,2010-11
2445114,2440014,Area Cooperative Educational Services,Thomas Edison Magnet Middle School,337,383,720,2010-11
2449514,2440014,Area Cooperative Educational Services,Village School,41,112,153,2010-11
2449214,2440014,Area Cooperative Educational Services,Whitney High School East,28,100,128,2010-11
2449114,2440014,Area Cooperative Educational Services,Whitney High School North,19,83,102,2010-11
2449314,2440014,Area Cooperative Educational Services,Whitney High School West,13,40,53,2010-11
2440314,2440014,Area Cooperative Educational Services,Wintergreen Interdistrict  Magnet School,338,308,646,2010-11
0030111,0030011,Ashford School District,Ashford School,226,250,476,2010-11
0046111,0040011,Avon School District,Avon High School,556,532,1088,2010-11
0045111,0040011,Avon School District,Avon Middle School,289,295,584,2010-11
0040411,0040011,Avon School District,Pine Grove School,308,323,631,2010-11
0040311,0040011,Avon School District,Roaring Brook School,330,321,651,2010-11
0040511,0040011,Avon School District,Thompson Brook School,291,303,594,2010-11
0050111,0050011,Barkhamsted School District,Barkhamsted Elementary School,149,194,343,2010-11
0058011,0050011,Barkhamsted School District,Shared Services Integrated Preschool,12,18,30,2010-11
0076111,0070011,Berlin School District,Berlin High School,514,503,1017,2010-11
0075111,0070011,Berlin School District,Catherine M. McGee Middle School,345,374,719,2010-11
0070411,0070011,Berlin School District,Emma Hart Willard School,223,312,535,2010-11
0070511,0070011,Berlin School District,Mary E. Griswold School,279,306,585,2010-11
0070111,0070011,Berlin School District,Richard D. Hubbard School,115,146,261,2010-11
0080111,0080011,Bethany School District,Bethany Community School,240,272,512,2010-11
0090411,0090011,Bethel School District,Anna H. Rockwell School,176,208,384,2010-11
0096111,0090011,Bethel School District,Bethel High School,493,466,959,2010-11
0095111,0090011,Bethel School District,Bethel Middle School,334,349,683,2010-11
0090111,0090011,Bethel School District,Frank A. Berry School,214,246,460,2010-11
0090511,0090011,Bethel School District,Ralph M. T. Johnson School,214,238,452,2010-11
0116111,0110011,Bloomfield School District,Bloomfield High School,288,305,593,2010-11
0110711,0110011,Bloomfield School District,Carmen Arace Intermediate School,146,159,305,2010-11
0115211,0110011,Bloomfield School District,Carmen Arace Middle School,125,140,265,2010-11
0110311,0110011,Bloomfield School District,J. P. Vincent School,161,190,351,2010-11
0110611,0110011,Bloomfield School District,Laurel School,130,151,281,2010-11
0116211,0110011,Bloomfield School District,The Big Picture High School,56,33,89,2010-11
0110811,0110011,Bloomfield School District,Wintonbury Early Childhood Magnet School,143,169,312,2010-11
0120111,0120011,Bolton School District,Bolton Center School,282,286,568,2010-11
0126111,0120011,Bolton School District,Bolton High School,184,146,330,2010-11
0130111,0130011,Bozrah School District,Fields Memorial School,122,111,233,2010-11
0146111,0140011,Branford School District,Branford High School,567,531,1098,2010-11
0145111,0140011,Branford School District,Francis Walsh Intermediate School,505,535,1040,2010-11
0148011,0140011,Branford School District,Indian Neck School,20,33,53,2010-11
0141611,0140011,Branford School District,John B. Sliney School,188,180,368,2010-11
0141511,0140011,Branford School District,Mary R. Tisko School,218,208,426,2010-11
0141411,0140011,Branford School District,Mary T. Murphy School,203,228,431,2010-11
2850113,2850013,Bridgeport Achievement First District,Achievement First Bridgeport Academy,198,211,409,2010-11
0150111,0150011,Bridgeport School District,Barnum School,304,328,632,2010-11
0156111,0150011,Bridgeport School District,Bassick High School,528,643,1171,2010-11
0150211,0150011,Bridgeport School District,Beardsley School,175,195,370,2010-11
0150311,0150011,Bridgeport School District,Black Rock School,145,138,283,2010-11
0154011,0150011,Bridgeport School District,Blackham School,539,575,1114,2010-11
0159011,0150011,Bridgeport School District,Bridgeport Learning Center,7,43,50,2010-11
0150411,0150011,Bridgeport School District,Bryant School,206,233,439,2010-11
0156211,0150011,Bridgeport School District,Central High School,1173,1130,2303,2010-11
0151411,0150011,Bridgeport School District,Cesar Batalla School,521,542,1063,2010-11
0152111,0150011,Bridgeport School District,Classical Studies Academy,169,165,334,2010-11
0150511,0150011,Bridgeport School District,Columbus School,331,332,663,2010-11
0153911,0150011,Bridgeport School District,Cross School,202,206,408,2010-11
0154211,0150011,Bridgeport School District,Curiale School,273,323,596,2010-11
0154111,0150011,Bridgeport School District,Dunbar School,163,152,315,2010-11
0150711,0150011,Bridgeport School District,Edison School,130,125,255,2010-11
0153211,0150011,Bridgeport School District,Geraldine Johnson School,438,430,868,2010-11
0151111,0150011,Bridgeport School District,Hall School,136,170,306,2010-11
0151211,0150011,Bridgeport School District,Hallen School,141,175,316,2010-11
0156311,0150011,Bridgeport School District,Harding High School,681,713,1394,2010-11
0154511,0150011,Bridgeport School District,High Horizons Magnet School,239,192,431,2010-11
0151311,0150011,Bridgeport School District,Hooker School,202,261,463,2010-11
0153711,0150011,Bridgeport School District,Interdistrict Discovery Magnet School,59,71,130,2010-11
0152211,0150011,Bridgeport School District,Jettie S. Tisdale School,330,324,654,2010-11
0151911,0150011,Bridgeport School District,Longfellow School,205,221,426,2010-11
0151011,0150011,Bridgeport School District,Luis Munoz Marin School,425,429,854,2010-11
0152011,0150011,Bridgeport School District,Madison School,235,308,543,2010-11
0159511,0150011,Bridgeport School District,Make The Grade,9,18,27,2010-11
0154611,0150011,Bridgeport School District,Multicultural Magnet School,249,208,457,2010-11
0158011,0150011,Bridgeport School District,Parent-Children Program,*,0,*,2010-11
0159211,0150011,Bridgeport School District,Park City Academy,*,*,10,2010-11
0151711,0150011,Bridgeport School District,Park City Magnet School,255,256,511,2010-11
0152511,0150011,Bridgeport School District,Read School,390,432,822,2010-11
0152611,0150011,Bridgeport School District,Roosevelt School,223,239,462,2010-11
0154411,0150011,Bridgeport School District,Skane Center,102,144,246,2010-11
0153011,0150011,Bridgeport School District,Waltersville School,264,273,537,2010-11
0153611,0150011,Bridgeport School District,Winthrop School,353,366,719,2010-11
0179011,0170011,Bristol School District,Alternative Special Education Program (ASEP),*,*,27,2010-11
0176111,0170011,Bristol School District,Bristol Central High School,628,682,1310,2010-11
0176211,0170011,Bristol School District,Bristol Eastern High School,667,685,1352,2010-11
0175111,0170011,Bristol School District,Chippens Hill Middle School,431,450,881,2010-11
0170711,0170011,Bristol School District,Clara T. O'Connell School,154,189,343,2010-11
0179211,0170011,Bristol School District,Community/Vocational Program,7,9,16,2010-11
0170311,0170011,Bristol School District,Edgewood School,196,200,396,2010-11
0171411,0170011,Bristol School District,Ellen P. Hubbell School,241,279,520,2010-11
0170511,0170011,Bristol School District,Greene-Hills School,175,179,354,2010-11
0171911,0170011,Bristol School District,Ivy Drive School,199,221,420,2010-11
0170611,0170011,Bristol School District,John J. Jennings School,177,189,366,2010-11
0175311,0170011,Bristol School District,Memorial Boulevard Middle School,275,240,515,2010-11
0171711,0170011,Bristol School District,Mountain View School,177,203,380,2010-11
0175211,0170011,Bristol School District,Northeast Middle School,260,303,563,2010-11
0171111,0170011,Bristol School District,South Side School,282,328,610,2010-11
0171211,0170011,Bristol School District,Stafford School,265,279,544,2010-11
0186111,0180011,Brookfield School District,Brookfield High School,498,498,996,2010-11
0180311,0180011,Brookfield School District,Center Elementary School,183,217,400,2010-11
0180411,0180011,Brookfield School District,Huckleberry Hill Elementary School,281,302,583,2010-11
0185311,0180011,Brookfield School District,Whisconier Middle School,456,434,890,2010-11
0190111,0190011,Brooklyn School District,Brooklyn Elementary School,281,281,562,2010-11
0195111,0190011,Brooklyn School District,Brooklyn Middle School,175,210,385,2010-11
0210111,0210011,Canaan School District,Lee H. Kellogg School,45,41,86,2010-11
0220211,0220011,Canterbury School District,Canterbury Elementary School,148,170,318,2010-11
0225111,0220011,Canterbury School District,Dr. Helen Baldwin Middle School,92,114,206,2010-11
0236111,0230011,Canton School District,Canton High School,255,260,515,2010-11
0230311,0230011,Canton School District,Canton Intermediate School,209,196,405,2010-11
0235111,0230011,Canton School District,Canton Middle School,123,143,266,2010-11
0230211,0230011,Canton School District,Cherry Brook Primary School,294,297,591,2010-11
2415114,2410014,Capitol Region Education Council,Academy of Aerospace and Engineering,90,124,214,2010-11
2416514,2410014,Capitol Region Education Council,Academy of Science and Innovation,128,51,179,2010-11
2418014,2410014,Capitol Region Education Council,CREC Early Learning Center at Asylum Hill,8,12,20,2010-11
2419214,2410014,Capitol Region Education Council,Farmington Valley Regional Diagnostic Center,7,14,21,2010-11
2410114,2410014,Capitol Region Education Council,Glastonbury/East Hartford Magnet School,121,141,262,2010-11
2416314,2410014,Capitol Region Education Council,Great Path Academy at MCC,166,118,284,2010-11
2416414,2410014,Capitol Region Education Council,Greater Hartford Academy of  the Arts High School - Full Time,254,118,372,2010-11
2419414,2410014,Capitol Region Education Council,Integrated Program Models,*,*,*,2010-11
2410414,2410014,Capitol Region Education Council,International Magnet School for Global Citizenship,126,118,244,2010-11
2419014,2410014,Capitol Region Education Council,John J. Allison Polaris Center,11,35,46,2010-11
2419614,2410014,Capitol Region Education Council,Lincoln Academy Regional Interdistrict Collaborative,*,*,9,2010-11
2416114,2410014,Capitol Region Education Council,Metropolitan Learning Center for Global and International Studies,365,346,711,2010-11
2413114,2410014,Capitol Region Education Council,Montessori Magnet School,172,165,337,2010-11
2415214,2410014,Capitol Region Education Council,Public Safety Academy,99,194,293,2010-11
2410314,2410014,Capitol Region Education Council,Reggio Magnet School of the Arts,122,133,255,2010-11
2419514,2410014,Capitol Region Education Council,River Street Early Learning Center (Site 2),13,39,52,2010-11
2419314,2410014,Capitol Region Education Council,River Street School,24,127,151,2010-11
2419114,2410014,Capitol Region Education Council,Soundbridge,58,45,103,2010-11
2415014,2410014,Capitol Region Education Council,Two Rivers Magnet Middle School,308,350,658,2010-11
2410214,2410014,Capitol Region Education Council,University of Hartford Magnet School,206,224,430,2010-11
0240211,0240011,Chaplin School District,Chaplin Elementary School,94,93,187,2010-11
2870113,2870013,Charter School for Young Children on Asylum Hill District,Charter School for Young Children on Asylum Hill  Inc.,118,107,225,2010-11
0250111,0250011,Cheshire School District,Chapman School,155,145,300,2010-11
0256111,0250011,Cheshire School District,Cheshire High School,729,787,1516,2010-11
0250211,0250011,Cheshire School District,Darcey School,174,169,343,2010-11
0255111,0250011,Cheshire School District,Dodd Middle School,384,402,786,2010-11
0250611,0250011,Cheshire School District,Doolittle School,250,267,517,2010-11
0250411,0250011,Cheshire School District,Highland School,399,428,827,2010-11
0259011,0250011,Cheshire School District,Humiston School,6,16,22,2010-11
0250511,0250011,Cheshire School District,Norton School,261,226,487,2010-11
0260111,0260011,Chester School District,Chester Elementary School,147,128,275,2010-11
0270111,0270011,Clinton School District,Abraham Pierson School,150,154,304,2010-11
0275111,0270011,Clinton School District,Jared Eliot School,248,244,492,2010-11
0270311,0270011,Clinton School District,Lewin G. Joel Jr. School,326,357,683,2010-11
0276111,0270011,Clinton School District,The Morgan School,278,279,557,2010-11
0286111,0280011,Colchester School District,Bacon Academy,533,454,987,2010-11
0280411,0280011,Colchester School District,Colchester Elementary School,312,386,698,2010-11
0280211,0280011,Colchester School District,Jack Jackter Intermediate School,332,356,688,2010-11
0285111,0280011,Colchester School District,William J. Johnston Middle School,355,350,705,2010-11
0290111,0290011,Colebrook School District,Colebrook Consolidated School,58,54,112,2010-11
0300111,0300011,Columbia School District,Horace W. Porter School,268,271,539,2010-11
2686113,2680013,Common Ground High School District,Common Ground High School,80,83,163,2010-11
9001516,9000016,Connecticut Technical High School System,A. I. Prince Technical High School,401,325,726,2010-11
9001116,9000016,Connecticut Technical High School System,Bullard-Havens Technical High School,443,429,872,2010-11
9001916,9000016,Connecticut Technical High School System,E. C. Goodwin Technical High School,222,374,596,2010-11
9001416,9000016,Connecticut Technical High School System,Eli Whitney Technical High School,253,286,539,2010-11
9002716,9000016,Connecticut Technical High School System,Ella T. Grasso Southeastern Technical High School,247,336,583,2010-11
9002516,9000016,Connecticut Technical High School System,Emmett O'Brien Technical High School,150,385,535,2010-11
9001716,9000016,Connecticut Technical High School System,H. C. Wilcox Technical High School,291,503,794,2010-11
9001316,9000016,Connecticut Technical High School System,H. H. Ellis Technical High School,141,417,558,2010-11
9001216,9000016,Connecticut Technical High School System,Henry Abbott Technical High School,198,442,640,2010-11
9001616,9000016,Connecticut Technical High School System,Howell Cheney Technical High School,148,510,658,2010-11
9002016,9000016,Connecticut Technical High School System,Norwich Technical High School,237,409,646,2010-11
9002216,9000016,Connecticut Technical High School System,Oliver Wolcott Technical High School,238,471,709,2010-11
9002616,9000016,Connecticut Technical High School System,Platt Technical High School,289,580,869,2010-11
9001816,9000016,Connecticut Technical High School System,Vinal Technical High School,178,421,599,2010-11
9002316,9000016,Connecticut Technical High School System,W. F. Kaynor Technical High School,300,445,745,2010-11
9002416,9000016,Connecticut Technical High School System,Windham Technical High School,204,370,574,2010-11
2439214,2430014,Cooperative Educational Services,Developmental Learning Center (DLC),25,57,82,2010-11
2439114,2430014,Cooperative Educational Services,Preschool-Primary Learning Center (PLC),13,40,53,2010-11
2439314,2430014,Cooperative Educational Services,RISE Transitional Program,*,*,12,2010-11
2438014,2430014,Cooperative Educational Services,School Readiness,29,24,53,2010-11
2430114,2430014,Cooperative Educational Services,Six-Six Magnet School,222,230,452,2010-11
2439414,2430014,Cooperative Educational Services,Therapeutic Day Program,14,121,135,2010-11
0310111,0310011,Cornwall School District,Cornwall Consolidated School,56,59,115,2010-11
0325111,0320011,Coventry School District,Capt. Nathan Hale School,233,229,462,2010-11
0328011,0320011,Coventry School District,Coventry Early Intervention Services,6,7,13,2010-11
0320211,0320011,Coventry School District,Coventry Grammar School,202,189,391,2010-11
0326111,0320011,Coventry School District,Coventry High School,280,278,558,2010-11
0320411,0320011,Coventry School District,George Hersey Robertson School,194,217,411,2010-11
0336111,0330011,Cromwell School District,Cromwell High School,309,279,588,2010-11
0335111,0330011,Cromwell School District,Cromwell Middle School,221,254,475,2010-11
0330211,0330011,Cromwell School District,Edna C. Stevens School,220,269,489,2010-11
0330311,0330011,Cromwell School District,Woodside Intermediate School,222,243,465,2010-11
0346211,0340011,Danbury School District,Alternative Center For Excellence,39,41,80,2010-11
0345111,0340011,Danbury School District,Broadview Middle School,547,567,1114,2010-11
0346111,0340011,Danbury School District,Danbury High School,1413,1485,2898,2010-11
0341411,0340011,Danbury School District,Ellsworth Avenue School,187,209,396,2010-11
0341111,0340011,Danbury School District,Great Plain School,144,155,299,2010-11
0340211,0340011,Danbury School District,Hayestown Avenue School,199,189,388,2010-11
0341711,0340011,Danbury School District,King Street Intermediate School,186,188,374,2010-11
0341311,0340011,Danbury School District,King Street Primary School,201,214,415,2010-11
0341811,0340011,Danbury School District,Mill Ridge Educational Center,54,80,134,2010-11
0340511,0340011,Danbury School District,Mill Ridge Primary School,199,203,402,2010-11
0340611,0340011,Danbury School District,Morris Street School,177,165,342,2010-11
0340811,0340011,Danbury School District,Park Avenue School,215,210,425,2010-11
0341511,0340011,Danbury School District,Pembroke School,164,179,343,2010-11
0345211,0340011,Danbury School District,Rogers Park Middle School,522,572,1094,2010-11
0341211,0340011,Danbury School District,Shelter Rock School,198,211,409,2010-11
0341011,0340011,Danbury School District,South Street School,195,193,388,2010-11
0341611,0340011,Danbury School District,Stadley Rough School,222,230,452,2010-11
0341911,0340011,Danbury School District,Western CT Academy of International Studies Elementary Magnet School,183,203,386,2010-11
0356111,0350011,Darien School District,Darien High School,663,652,1315,2010-11
0350211,0350011,Darien School District,Hindley Elementary School,287,307,594,2010-11
0350711,0350011,Darien School District,Holmes Elementary School,207,232,439,2010-11
0355111,0350011,Darien School District,Middlesex Middle School,557,602,1159,2010-11
0351311,0350011,Darien School District,Ox Ridge Elementary School,221,251,472,2010-11
0350511,0350011,Darien School District,Royle Elementary School,188,231,419,2010-11
0350611,0350011,Darien School District,Tokeneke Elementary School,201,243,444,2010-11
0360111,0360011,Deep River School District,Deep River Elementary School,180,171,351,2010-11
3370215,3370015,Department of Mental Health and Addiction Services,Connecticut Valley Hospital,*,*,*,2010-11
0370611,0370011,Derby School District,Bradley School,186,181,367,2010-11
0376111,0370011,Derby School District,Derby High School,176,209,385,2010-11
0375011,0370011,Derby School District,Derby Middle School,146,173,319,2010-11
0370411,0370011,Derby School District,Irving School,198,198,396,2010-11
0400111,0400011,East Granby School District,Allgrove School,120,135,255,2010-11
0406111,0400011,East Granby School District,East Granby High School,130,145,275,2010-11
0405111,0400011,East Granby School District,East Granby Middle School,100,111,211,2010-11
0400211,0400011,East Granby School District,R. Dudley Seymour School,78,72,150,2010-11
0410111,0410011,East Haddam School District,East Haddam Elementary School,191,221,412,2010-11
0416111,0410011,East Haddam School District,Nathan Hale-Ray High School,209,178,387,2010-11
0415111,0410011,East Haddam School District,Nathan Hale-Ray Middle School,269,271,540,2010-11
0420311,0420011,East Hampton School District,Center School,134,154,288,2010-11
0426111,0420011,East Hampton School District,East Hampton High School,276,276,552,2010-11
0425111,0420011,East Hampton School District,East Hampton Middle School,270,238,508,2010-11
0420111,0420011,East Hampton School District,Memorial School,290,325,615,2010-11
0429011,0420011,East Hampton School District,The Learning Center at East Hampton,*,*,7,2010-11
0430911,0430011,East Hartford School District,Anna E. Norris School,136,155,291,2010-11
0436311,0430011,East Hartford School District,Connecticut IB Academy,117,63,180,2010-11
0430611,0430011,East Hartford School District,Dr. Franklin H. Mayberry School,188,220,408,2010-11
0432211,0430011,East Hartford School District,Dr. John A. Langford School,162,207,369,2010-11
0431011,0430011,East Hartford School District,Dr. Thomas S. O'Connell School,152,186,338,2010-11
0436211,0430011,East Hartford School District,East Hartford High School,859,875,1734,2010-11
0435111,0430011,East Hartford School District,East Hartford Middle School,506,515,1021,2010-11
0432011,0430011,East Hartford School District,Governor William Pitkin School,175,207,382,2010-11
0430511,0430011,East Hartford School District,Hockanum School,156,161,317,2010-11
0430411,0430011,East Hartford School District,Joseph O. Goodwin School,184,206,390,2010-11
0431811,0430011,East Hartford School District,Robert J. O'Brien School,193,195,388,2010-11
0431211,0430011,East Hartford School District,Silver Lane School,160,148,308,2010-11
0436411,0430011,East Hartford School District,Stevens Alternate High School,57,95,152,2010-11
0432411,0430011,East Hartford School District,Sunset Ridge Middle School,203,143,346,2010-11
0438011,0430011,East Hartford School District,Willowbrook Early Childhood,147,140,287,2010-11
0439011,0430011,East Hartford School District,Woodland School,25,163,188,2010-11
0441711,0440011,East Haven School District,Carbone School/East Haven Academy,166,124,290,2010-11
0441411,0440011,East Haven School District,D. C. Moore School,132,141,273,2010-11
0440111,0440011,East Haven School District,Deer Run School,168,180,348,2010-11
0441311,0440011,East Haven School District,Dominick H. Ferrara School,111,135,246,2010-11
0446111,0440011,East Haven School District,East Haven High School,467,476,943,2010-11
0441011,0440011,East Haven School District,Grove J. Tuttle School,92,112,204,2010-11
0445111,0440011,East Haven School District,Joseph Melillo Middle School,331,349,680,2010-11
0440711,0440011,East Haven School District,Momauguin School,81,100,181,2010-11
0441811,0440011,East Haven School District,Overbrook Elementary School,114,112,226,2010-11
0449011,0440011,East Haven School District,Pathways,6,28,34,2010-11
0456111,0450011,East Lyme School District,East Lyme High School,621,587,1208,2010-11
0455111,0450011,East Lyme School District,East Lyme Middle School,423,427,850,2010-11
0450111,0450011,East Lyme School District,Flanders School,180,185,365,2010-11
0458011,0450011,East Lyme School District,Integrated Preschool,15,29,44,2010-11
0450411,0450011,East Lyme School District,Lillie B. Haynes School,172,193,365,2010-11
0450211,0450011,East Lyme School District,Niantic Center School,118,111,229,2010-11
0470111,0470011,East Windsor School District,Broad Brook Elementary School,270,288,558,2010-11
0476111,0470011,East Windsor School District,East Windsor High School,184,194,378,2010-11
0475411,0470011,East Windsor School District,East Windsor Middle School,186,207,393,2010-11
2536014,2530014,Eastern Connecticut Regional Educational Service Center (EASTCONN),Arts at the Capitol Theater Magnet School (ACT),79,33,112,2010-11
2539014,2530014,Eastern Connecticut Regional Educational Service Center (EASTCONN),EastConn Special Education,8,59,67,2010-11
2536114,2530014,Eastern Connecticut Regional Educational Service Center (EASTCONN),Quinebaug Middle College,50,55,105,2010-11
0390111,0390011,Eastford School District,Eastford Elementary School,84,96,180,2010-11
0465111,0460011,Easton School District,Helen Keller Middle School,185,211,396,2010-11
0460111,0460011,Easton School District,Samuel Staples Elementary School,318,387,705,2010-11
2428014,2420014,EdAdvance,EdAdvance Headstart,94,89,183,2010-11
2429014,2420014,EdAdvance,The ACCESS School at The Danuta M. Thibodeau Education Center,16,18,34,2010-11
0480111,0480011,Ellington School District,Center School,211,221,432,2010-11
0480211,0480011,Ellington School District,Crystal Lake School,100,117,217,2010-11
0486111,0480011,Ellington School District,Ellington High School,409,382,791,2010-11
0485111,0480011,Ellington School District,Ellington Middle School,221,189,410,2010-11
0480711,0480011,Ellington School District,Windermere Intermediate School,205,231,436,2010-11
0480611,0480011,Ellington School District,Windermere School,209,230,439,2010-11
2890113,2890013,Elm City College Preparatory School District,Elm City College Preparatory School,310,275,585,2010-11
0491311,0490011,Enfield School District,Edgar H. Parkman School,162,163,325,2010-11
0491611,0490011,Enfield School District,Eli Whitney School,191,227,418,2010-11
0496111,0490011,Enfield School District,Enfield High School,370,439,809,2010-11
0490211,0490011,Enfield School District,Enfield Street School,175,172,347,2010-11
0499011,0490011,Enfield School District,Enfield Transitional Learning Academy,*,*,10,2010-11
0496211,0490011,Enfield School District,Enrico Fermi High School,539,563,1102,2010-11
0491211,0490011,Enfield School District,Harriet Beecher Stowe School,117,117,234,2010-11
0490411,0490011,Enfield School District,Hazardville Memorial School,158,208,366,2010-11
0498011,0490011,Enfield School District,Head Start Program,49,55,104,2010-11
0491811,0490011,Enfield School District,Henry Barnard School,171,226,397,2010-11
0495211,0490011,Enfield School District,John F. Kennedy Middle School,421,427,848,2010-11
0491111,0490011,Enfield School District,Nathan Hale School,116,131,247,2010-11
0491511,0490011,Enfield School District,Prudence Crandall School,202,177,379,2010-11
0491711,0490011,Enfield School District,Thomas G. Alcorn School,148,153,301,2010-11
0500111,0500011,Essex School District,Essex Elementary School,301,292,593,2010-11
2726113,2720013,Explorations District,Explorations,47,33,80,2010-11
0510211,0510011,Fairfield School District,Burr Elementary School,198,222,420,2010-11
0510111,0510011,Fairfield School District,Dwight Elementary School,169,145,314,2010-11
0518011,0510011,Fairfield School District,Early Childhood Center,47,71,118,2010-11
0516011,0510011,Fairfield School District,Fairfield Ludlowe High School,801,702,1503,2010-11
0516211,0510011,Fairfield School District,Fairfield Warde High School,676,652,1328,2010-11
0515211,0510011,Fairfield School District,Fairfield Woods Middle School,318,350,668,2010-11
0510411,0510011,Fairfield School District,Holland Hill School,167,166,333,2010-11
0511711,0510011,Fairfield School District,Jennings School,160,187,347,2010-11
0510611,0510011,Fairfield School District,McKinley School,236,254,490,2010-11
0510711,0510011,Fairfield School District,Mill Hill School,223,251,474,2010-11
0511611,0510011,Fairfield School District,North Stratfield School,233,250,483,2010-11
0511811,0510011,Fairfield School District,Osborn Hill School,250,288,538,2010-11
0511211,0510011,Fairfield School District,Riverfield School,218,233,451,2010-11
0515311,0510011,Fairfield School District,Roger Ludlowe Middle School,485,500,985,2010-11
0511311,0510011,Fairfield School District,Sherman School,218,224,442,2010-11
0511411,0510011,Fairfield School District,Stratfield School,252,252,504,2010-11
0515111,0510011,Fairfield School District,Tomlinson Middle School,395,389,784,2010-11
0520411,0520011,Farmington School District,East Farms School,217,252,469,2010-11
0528011,0520011,Farmington School District,Farmington Collaborative PK,36,40,76,2010-11
0526111,0520011,Farmington School District,Farmington High School,634,675,1309,2010-11
0525111,0520011,Farmington School District,Irving A. Robbins Middle School,334,354,688,2010-11
0520211,0520011,Farmington School District,Noah Wallace School,161,185,346,2010-11
0520111,0520011,Farmington School District,Union School,149,151,300,2010-11
0520311,0520011,Farmington School District,West District School,163,175,338,2010-11
0520511,0520011,Farmington School District,West Woods Upper Elementary School,273,330,603,2010-11
0530111,0530011,Franklin School District,Franklin Elementary School,104,118,222,2010-11
0540211,0540011,Glastonbury School District,Buttonball Lane School,260,258,518,2010-11
0540311,0540011,Glastonbury School District,Eastbury School,131,172,303,2010-11
0540811,0540011,Glastonbury School District,Gideon Welles School,259,247,506,2010-11
0546111,0540011,Glastonbury School District,Glastonbury High School,1121,1080,2201,2010-11
0540411,0540011,Glastonbury School District,Hebron Avenue School,255,250,505,2010-11
0540611,0540011,Glastonbury School District,Hopewell School,249,253,502,2010-11
0540711,0540011,Glastonbury School District,Naubuc School,252,245,497,2010-11
0540911,0540011,Glastonbury School District,Nayaug Elementary School,345,318,663,2010-11
0545211,0540011,Glastonbury School District,Smith Middle School,556,557,1113,2010-11
0560111,0560011,Granby School District,Frank M. Kearns Primary School,202,221,423,2010-11
0566111,0560011,Granby School District,Granby Memorial High School,393,392,785,2010-11
0565111,0560011,Granby School District,Granby Memorial Middle School,168,187,355,2010-11
0560411,0560011,Granby School District,Kelly Lane Primary School,148,182,330,2010-11
0560311,0560011,Granby School District,Wells Road Intermediate School,179,168,347,2010-11
0575111,0570011,Greenwich School District,Central Middle School,295,326,621,2010-11
0570211,0570011,Greenwich School District,Cos Cob School,200,218,418,2010-11
0575211,0570011,Greenwich School District,Eastern Middle School,401,392,793,2010-11
0570411,0570011,Greenwich School District,Glenville School,165,182,347,2010-11
0576111,0570011,Greenwich School District,Greenwich High School,1268,1405,2673,2010-11
0570511,0570011,Greenwich School District,Hamilton Avenue School,213,203,416,2010-11
0571311,0570011,Greenwich School District,International School At Dundee,192,180,372,2010-11
0570311,0570011,Greenwich School District,Julian Curtiss School,175,178,353,2010-11
0570611,0570011,Greenwich School District,New Lebanon School,111,132,243,2010-11
0570711,0570011,Greenwich School District,North Mianus School,232,220,452,2010-11
0570811,0570011,Greenwich School District,North Street School,220,231,451,2010-11
0570911,0570011,Greenwich School District,Old Greenwich School,210,200,410,2010-11
0571111,0570011,Greenwich School District,Parkway School,130,162,292,2010-11
0571011,0570011,Greenwich School District,Riverside School,230,284,514,2010-11
0575311,0570011,Greenwich School District,Western Middle School,230,263,493,2010-11
0580311,0580011,Griswold School District,Griswold Elementary School,350,376,726,2010-11
0586211,0580011,Griswold School District,Griswold High School,353,356,709,2010-11
0585111,0580011,Griswold School District,Griswold Middle School,270,300,570,2010-11
0595311,0590011,Groton School District,Carl C. Cutler Middle School,184,175,359,2010-11
0592011,0590011,Groton School District,Catherine Kolnaski Magnet School,225,253,478,2010-11
0591811,0590011,Groton School District,Charles Barnum School,200,184,384,2010-11
0590311,0590011,Groton School District,Claude Chester School,189,199,388,2010-11
0595111,0590011,Groton School District,Fitch Middle School,186,225,411,2010-11
0591711,0590011,Groton School District,Mary Morrisson School,178,175,353,2010-11
0591911,0590011,Groton School District,Northeast Academy Elementary School,198,230,428,2010-11
0591211,0590011,Groton School District,Pleasant Valley School,133,169,302,2010-11
0596111,0590011,Groton School District,Robert E. Fitch High School,647,624,1271,2010-11
0590111,0590011,Groton School District,S. B. Butler School,160,187,347,2010-11
0595211,0590011,Groton School District,West Side Middle School,116,132,248,2010-11
0600711,0600011,Guilford School District,A. Baldwin Middle School,297,290,587,2010-11
0600611,0600011,Guilford School District,A. W. Cox School,161,155,316,2010-11
0600411,0600011,Guilford School District,Calvin Leete School,167,168,335,2010-11
0605111,0600011,Guilford School District,E. C. Adams Middle School,262,310,572,2010-11
0606111,0600011,Guilford School District,Guilford High School,568,545,1113,2010-11
0600211,0600011,Guilford School District,Guilford Lakes School,189,220,409,2010-11
0600311,0600011,Guilford School District,Melissa Jones School,165,181,346,2010-11
0628011,0620011,Hamden School District,Alice Peck Learning Center,31,56,87,2010-11
0621211,0620011,Hamden School District,Bear Path School,230,236,466,2010-11
0620211,0620011,Hamden School District,Church Street School,191,216,407,2010-11
0620311,0620011,Hamden School District,Dunbar Hill School,156,153,309,2010-11
0626111,0620011,Hamden School District,Hamden High School,946,988,1934,2010-11
0625211,0620011,Hamden School District,Hamden Middle School,448,452,900,2010-11
0620411,0620011,Hamden School District,Helen Street School,107,175,282,2010-11
0621111,0620011,Hamden School District,Ridge Hill School,153,188,341,2010-11
0620111,0620011,Hamden School District,Shepherd Glen School,169,173,342,2010-11
0621011,0620011,Hamden School District,Spring Glen School,189,188,377,2010-11
0621411,0620011,Hamden School District,West Woods School,266,269,535,2010-11
0630111,0630011,Hampton School District,Hampton Elementary School,50,90,140,2010-11
0640711,0640011,Hartford School District,Asian Studies Academy at Bellizzi School,161,179,340,2010-11
0640411,0640011,Hartford School District,Batchelder School,273,317,590,2010-11
0642811,0640011,Hartford School District,Betances Early Reading Lab Magnet School,164,147,311,2010-11
0643511,0640011,Hartford School District,Breakthrough II Magnet School,70,72,142,2010-11
0643311,0640011,Hartford School District,Breakthrough Magnet School,178,173,351,2010-11
0647111,0640011,Hartford School District,Bulkeley High School,233,256,489,2010-11
0646111,0640011,Hartford School District,Bulkeley High School Lower School,276,394,670,2010-11
0640611,0640011,Hartford School District,Burns Latino Studies Academy,332,332,664,2010-11
0642311,0640011,Hartford School District,Burr School,341,365,706,2010-11
0646911,0640011,Hartford School District,Capital Preparatory Magnet School,184,152,336,2010-11
0642411,0640011,Hartford School District,Clark School,181,200,381,2010-11
0646411,0640011,Hartford School District,Classical Magnet School,413,297,710,2010-11
0646011,0640011,Hartford School District,Culinary Arts Academy at Weaver High School,120,125,245,2010-11
0645311,0640011,Hartford School District,Dr. Joseph Bellizzi Middle School,140,153,293,2010-11
0640911,0640011,Hartford School District,Environmental Sciences Magnet at Hooker School,130,145,275,2010-11
0643211,0640011,Hartford School District,Expeditionary Learning Academy at Moylan School,337,340,677,2010-11
0643611,0640011,Hartford School District,Global Communications Academy,187,185,372,2010-11
0647211,0640011,Hartford School District,HPHS Engineering and Green Technology Academy,109,285,394,2010-11
0647311,0640011,Hartford School District,HPHS Freshmen Academy,145,173,318,2010-11
0647411,0640011,Hartford School District,HPHS Law and Government Academy,212,166,378,2010-11
0647511,0640011,Hartford School District,HPHS Nursing and Health Sciences Academy,277,106,383,2010-11
0645411,0640011,Hartford School District,Hartford Magnet Trinity College Academy,322,289,611,2010-11
0649011,0640011,Hartford School District,Hartford Transitional Learning Academy (Elementary),6,26,32,2010-11
0647611,0640011,Hartford School District,"High School, Inc.",134,122,256,2010-11
0647711,0640011,Hartford School District,Journalism and Media Academy Magnet School,113,116,229,2010-11
0641011,0640011,Hartford School District,Kennelly School,396,385,781,2010-11
0641111,0640011,Hartford School District,Kinsella Magnet School of Performing Arts,379,283,662,2010-11
0640811,0640011,Hartford School District,M. D. Fox School,408,438,846,2010-11
0641611,0640011,Hartford School District,"M. L. King, Jr. School",222,246,468,2010-11
0641211,0640011,Hartford School District,McDonough Middle School,200,219,419,2010-11
0641911,0640011,Hartford School District,Milner School,200,212,412,2010-11
0643711,0640011,Hartford School District,Montessori Magnet at Fisher School,93,105,198,2010-11
0641411,0640011,Hartford School District,Naylor/CCSU Leadership Academy,350,349,699,2010-11
0647811,0640011,Hartford School District,OPPortunity High School,69,54,123,2010-11
0641511,0640011,Hartford School District,Parkville Community School,239,276,515,2010-11
0646611,0640011,Hartford School District,Pathways Academy of Technology and Design,140,215,355,2010-11
0641711,0640011,Hartford School District,Rawson School,204,259,463,2010-11
0644011,0640011,Hartford School District,Renzulli Gifted and Talented Academy,37,20,57,2010-11
0640111,0640011,Hartford School District,SAND School,239,224,463,2010-11
0642511,0640011,Hartford School District,STEM Magnet at Fisher School,124,204,328,2010-11
0643011,0640011,Hartford School District,Sanchez School,240,252,492,2010-11
0645611,0640011,Hartford School District,Sarah J Rawson Middle Grades Academy,79,109,188,2010-11
0642611,0640011,Hartford School District,Simpson-Waverly School,163,198,361,2010-11
0646511,0640011,Hartford School District,Sports and Medical Sciences Academy,340,332,672,2010-11
0646711,0640011,Hartford School District,University High School of Science and Engineering,141,266,407,2010-11
0646311,0640011,Hartford School District,Weaver High School,69,85,154,2010-11
0642011,0640011,Hartford School District,Webster Micro Society Magnet School,271,321,592,2010-11
0642111,0640011,Hartford School District,West Middle School,339,349,688,2010-11
0642211,0640011,Hartford School District,Wish Museum School,225,218,443,2010-11
0650111,0650011,Hartland School District,Hartland School,101,121,222,2010-11
0670211,0670011,Hebron School District,Gilead Hill School,233,237,470,2010-11
0670111,0670011,Hebron School District,Hebron Elementary School,310,356,666,2010-11
2860113,2860013,Highville Charter School District,Highville Charter School,162,138,300,2010-11
2640113,2640013,Integrated Day Charter School District,Integrated Day Charter School,167,164,331,2010-11
2655113,2650013,Interdistrict School for Arts and Comm District,Interdistrict School For Arts And Communication,97,85,182,2010-11
2610113,2610013,Jumoke Academy District,Jumoke Academy,237,195,432,2010-11
0680111,0680011,Kent School District,Kent Center School,129,158,287,2010-11
0698011,0690011,Killingly School District,Goodyear Early Childhood Center,46,61,107,2010-11
0690111,0690011,Killingly School District,Killingly Central School,243,255,498,2010-11
0696111,0690011,Killingly School District,Killingly High School,418,370,788,2010-11
0695211,0690011,Killingly School District,Killingly Intermediate School,380,443,823,2010-11
0690311,0690011,Killingly School District,Killingly Memorial School,229,240,469,2010-11
2456014,2450014,Learn,Connecticut River Academy,77,69,146,2010-11
2455014,2450014,Learn,Dual Language & Arts Magnet Middle School,45,37,82,2010-11
2459014,2450014,Learn,Learn Special Education,*,*,30,2010-11
2450114,2450014,Learn,Regional Multicultural Magnet School,282,263,545,2010-11
2450214,2450014,Learn,The Friendship School,234,258,492,2010-11
0710111,0710011,Lebanon School District,Lebanon Elementary School,232,252,484,2010-11
0715111,0710011,Lebanon School District,Lebanon Middle School,194,204,398,2010-11
0716211,0710011,Lebanon School District,Lyman Memorial High School,288,233,521,2010-11
0720211,0720011,Ledyard School District,Gales Ferry School,102,105,207,2010-11
0720411,0720011,Ledyard School District,Gallup Hill School,169,176,345,2010-11
0720311,0720011,Ledyard School District,Juliet W. Long School,134,151,285,2010-11
0720111,0720011,Ledyard School District,Ledyard Center School,200,216,416,2010-11
0726111,0720011,Ledyard School District,Ledyard High School,476,452,928,2010-11
0725111,0720011,Ledyard School District,Ledyard Middle School,220,216,436,2010-11
0736011,0730011,Lisbon School District,Community Connection - The Big Picture High School,15,17,32,2010-11
0730111,0730011,Lisbon School District,Lisbon Central School,238,264,502,2010-11
0740211,0740011,Litchfield School District,Center School,166,175,341,2010-11
0746111,0740011,Litchfield School District,Litchfield High School,283,277,560,2010-11
0740311,0740011,Litchfield School District,Litchfield Intermediate School,130,138,268,2010-11
0766111,0760011,Madison School District,Daniel Hand High School,659,631,1290,2010-11
0760611,0760011,Madison School District,Dr. Robert H. Brown Middle School,271,317,588,2010-11
0760211,0760011,Madison School District,Island Avenue Elementary School,146,156,302,2010-11
0760111,0760011,Madison School District,J. Milton Jeffrey Elementary School,230,262,492,2010-11
0760311,0760011,Madison School District,Kathleen H. Ryerson Elementary School,131,144,275,2010-11
0769011,0760011,Madison School District,Town Campus Learning Center,14,29,43,2010-11
0765211,0760011,Madison School District,Walter C. Polson Upper Middle School,316,300,616,2010-11
0770911,0770011,Manchester School District,Nathan Hale School,121,113,234,2010-11
0770111,0770011,Manchester School District,Bowers School,185,224,409,2010-11
0770311,0770011,Manchester School District,Buckley School,180,208,388,2010-11
0771711,0770011,Manchester School District,Elisabeth M. Bennet Academy,236,218,454,2010-11
0770411,0770011,Manchester School District,Highland Park School,114,159,273,2010-11
0775311,0770011,Manchester School District,Illing Middle School,427,474,901,2010-11
0770611,0770011,Manchester School District,Keeney School,197,190,387,2010-11
0776111,0770011,Manchester School District,Manchester High School,933,947,1880,2010-11
0778011,0770011,Manchester School District,Manchester Preschool Center,86,99,185,2010-11
0779011,0770011,Manchester School District,Manchester Regional Academy,32,67,99,2010-11
0779111,0770011,Manchester School District,Manchester Transition Center,0,*,*,2010-11
0771611,0770011,Manchester School District,Martin School,105,116,221,2010-11
0771011,0770011,Manchester School District,Robertson School,167,210,377,2010-11
0771211,0770011,Manchester School District,Verplanck School,152,188,340,2010-11
0771311,0770011,Manchester School District,Waddell School,166,182,348,2010-11
0771411,0770011,Manchester School District,Washington School,154,153,307,2010-11
0780411,0780011,Mansfield School District,Annie E. Vinton School,125,149,274,2010-11
0780211,0780011,Mansfield School District,Dorothy C. Goodwin School,89,113,202,2010-11
0785111,0780011,Mansfield School District,Mansfield Middle School,291,294,585,2010-11
0780511,0780011,Mansfield School District,Southeast Elementary School,121,145,266,2010-11
0790111,0790011,Marlborough School District,Elmer Thienes-Mary Hall Elementary School,340,335,675,2010-11
0800711,0800011,Meriden School District,Nathan Hale School,312,309,621,2010-11
0800111,0800011,Meriden School District,Benjamin Franklin School,198,268,466,2010-11
0801111,0800011,Meriden School District,Casimir Pulaski School,354,352,706,2010-11
0806111,0800011,Meriden School District,Francis T. Maloney High School,625,610,1235,2010-11
0800311,0800011,Meriden School District,Hanover School,244,286,530,2010-11
0800411,0800011,Meriden School District,Israel Putnam School,241,320,561,2010-11
0800511,0800011,Meriden School District,John Barry School,256,253,509,2010-11
0805211,0800011,Meriden School District,Lincoln Middle School,333,378,711,2010-11
0806211,0800011,Meriden School District,Orville H. Platt High School,558,544,1102,2010-11
0800811,0800011,Meriden School District,Roger Sherman School,250,274,524,2010-11
0801011,0800011,Meriden School District,Thomas Hooker School,231,215,446,2010-11
0805411,0800011,Meriden School District,Washington Middle School,423,465,888,2010-11
0830211,0830011,Middletown School District,Bielefield School,164,202,366,2010-11
0830511,0830011,Middletown School District,Farm Hill School,173,198,371,2010-11
0831511,0830011,Middletown School District,Keigwin Middle School,180,192,372,2010-11
0831311,0830011,Middletown School District,Lawrence School,184,193,377,2010-11
0830911,0830011,Middletown School District,MacDonough School,115,133,248,2010-11
0836211,0830011,Middletown School District,Middletown High School,664,693,1357,2010-11
0831211,0830011,Middletown School District,Moody School,172,189,361,2010-11
0831111,0830011,Middletown School District,Snow School,177,179,356,2010-11
0830111,0830011,Middletown School District,Spencer School,169,172,341,2010-11
0831411,0830011,Middletown School District,Wesley School,157,154,311,2010-11
0835411,0830011,Middletown School District,Woodrow Wilson Middle School,357,376,733,2010-11
0840111,0840011,Milford School District,Calf Pen Meadow School,171,159,330,2010-11
0845111,0840011,Milford School District,East Shore Middle School,231,301,532,2010-11
0845211,0840011,Milford School District,Harborside Middle School,289,322,611,2010-11
0841911,0840011,Milford School District,J. F. Kennedy School,210,211,421,2010-11
0846211,0840011,Milford School District,Jonathan Law High School,488,509,997,2010-11
0846311,0840011,Milford School District,Joseph A. Foran High School,524,485,1009,2010-11
0841611,0840011,Milford School District,Live Oaks School,170,167,337,2010-11
0841711,0840011,Milford School District,Mathewson School,209,246,455,2010-11
0840711,0840011,Milford School District,Meadowside School,215,250,465,2010-11
0840811,0840011,Milford School District,Orange Avenue School,209,227,436,2010-11
0841811,0840011,Milford School District,Orchard Hills School,173,205,378,2010-11
0841011,0840011,Milford School District,Pumpkin Delight School,195,223,418,2010-11
0845311,0840011,Milford School District,West Shore Middle School,287,286,573,2010-11
0850611,0850011,Monroe School District,Chalk Hill School,132,145,277,2010-11
0850511,0850011,Monroe School District,Fawn Hollow Elementary School,279,336,615,2010-11
0855211,0850011,Monroe School District,Jockey Hollow School,301,333,634,2010-11
0856111,0850011,Monroe School District,Masuk High School,667,642,1309,2010-11
0850111,0850011,Monroe School District,Monroe Elementary School,192,217,409,2010-11
0850311,0850011,Monroe School District,Stepney Elementary School,252,259,511,2010-11
0860711,0860011,Montville School District,Dr. Charles E. Murphy School,190,193,383,2010-11
0865111,0860011,Montville School District,Leonard J. Tyl Middle School,310,332,642,2010-11
0860111,0860011,Montville School District,Mohegan School,223,196,419,2010-11
0866111,0860011,Montville School District,Montville High School,356,411,767,2010-11
0860511,0860011,Montville School District,Oakdale School,207,226,433,2010-11
0869011,0860011,Montville School District,Palmer Academy,7,12,19,2010-11
0880811,0880011,Naugatuck School District,Andrew Avenue School,92,110,202,2010-11
0888211,0880011,Naugatuck School District,Central Avenue Preschool,10,21,31,2010-11
0880111,0880011,Naugatuck School District,Central Avenue School,122,130,252,2010-11
0885111,0880011,Naugatuck School District,City Hill Middle School,368,403,771,2010-11
0880211,0880011,Naugatuck School District,Cross Street Intermediate School,156,174,330,2010-11
0888111,0880011,Naugatuck School District,Head Start,56,48,104,2010-11
0880411,0880011,Naugatuck School District,Hillside Intermediate School,193,197,390,2010-11
0880511,0880011,Naugatuck School District,Hop Brook Elementary School,165,170,335,2010-11
0880311,0880011,Naugatuck School District,Maple Hill School,183,193,376,2010-11
0886111,0880011,Naugatuck School District,Naugatuck High School,664,697,1361,2010-11
0880611,0880011,Naugatuck School District,Salem School,105,126,231,2010-11
0880711,0880011,Naugatuck School District,Western School,124,153,277,2010-11
2800113,2800013,New Beginnings Inc Family Academy District,New Beginnings Inc Family Academy,204,156,360,2010-11
0899211,0890011,New Britain School District,Academic Extension Center,*,*,12,2010-11
0890311,0890011,New Britain School District,Chamberlain  Elementary School,191,264,455,2010-11
0891111,0890011,New Britain School District,Frank J. DiLoreto School,509,388,897,2010-11
0890511,0890011,New Britain School District,Gaffney School,211,307,518,2010-11
0890611,0890011,New Britain School District,Holmes School,186,236,422,2010-11
0895411,0890011,New Britain School District,House of Arts Letters and Science (HALS)  Academy,88,68,156,2010-11
0890711,0890011,New Britain School District,Jefferson School,180,235,415,2010-11
0890811,0890011,New Britain School District,Lincoln School,337,362,699,2010-11
0896111,0890011,New Britain School District,New Britain High School,1245,1374,2619,2010-11
0899011,0890011,New Britain School District,New Britain Transition Center,12,20,32,2010-11
0890911,0890011,New Britain School District,Northend School,132,175,307,2010-11
0895311,0890011,New Britain School District,Pulaski Middle School,263,329,592,2010-11
0895111,0890011,New Britain School District,Roosevelt Middle School,200,229,429,2010-11
0895211,0890011,New Britain School District,Slade Middle School,347,369,716,2010-11
0891211,0890011,New Britain School District,Smalley Academy,360,313,673,2010-11
0891311,0890011,New Britain School District,Smith School,300,331,631,2010-11
0891511,0890011,New Britain School District,Vance School,264,280,544,2010-11
0900411,0900011,New Canaan School District,East School,256,260,516,2010-11
0906111,0900011,New Canaan School District,New Canaan High School,694,649,1343,2010-11
0905111,0900011,New Canaan School District,Saxe Middle School,591,627,1218,2010-11
0900211,0900011,New Canaan School District,South School,282,279,561,2010-11
0900311,0900011,New Canaan School District,West School,233,260,493,2010-11
0910111,0910011,New Fairfield School District,Consolidated School,271,331,602,2010-11
0910211,0910011,New Fairfield School District,Meeting House Hill School,290,320,610,2010-11
0916111,0910011,New Fairfield School District,New Fairfield High School,499,475,974,2010-11
0915211,0910011,New Fairfield School District,New Fairfield Middle School,335,397,732,2010-11
0920311,0920011,New Hartford School District,Ann Antolini School,178,181,359,2010-11
0920111,0920011,New Hartford School District,Bakerville Consolidated School,62,58,120,2010-11
0920211,0920011,New Hartford School District,New Hartford Elementary School,71,58,129,2010-11
0931211,0930011,New Haven School District,Edgewood School,220,235,455,2010-11
0931411,0930011,New Haven School District,Nathan Hale School,270,285,555,2010-11
0931511,0930011,New Haven School District,Augusta Lewis Troup School,243,272,515,2010-11
0930211,0930011,New Haven School District,Barnard Environmental Magnet School,276,273,549,2010-11
0930311,0930011,New Haven School District,Beecher School,219,249,468,2010-11
0931811,0930011,New Haven School District,Benjamin Jepson Magnet School,236,291,527,2010-11
0935511,0930011,New Haven School District,Betsy Ross Arts Magnet School,289,155,444,2010-11
0934311,0930011,New Haven School District,Bishop Woods Architecture and Design Magnet School,245,244,489,2010-11
0932111,0930011,New Haven School District,Brennan Rogers School,181,180,361,2010-11
0934811,0930011,New Haven School District,"Celentano BioTech, Health and Medical Magnet School",220,247,467,2010-11
0930611,0930011,New Haven School District,Clinton Avenue School,256,292,548,2010-11
0934111,0930011,New Haven School District,Columbus Family Academy,254,219,473,2010-11
0933111,0930011,New Haven School District,Conte/West Hills Magnet School,298,310,608,2010-11
0936411,0930011,New Haven School District,Cooperative High School,443,180,623,2010-11
0936811,0930011,New Haven School District,Cortlandt V.R. Creed Health and Sport Sciences High School,45,167,212,2010-11
0930911,0930011,New Haven School District,Davis 21st Century Magnet Elementary School,226,234,460,2010-11
0935611,0930011,New Haven School District,Domus Academy,10,34,44,2010-11
0938211,0930011,New Haven School District,Dwight Early Childhood Program,15,24,39,2010-11
0938111,0930011,New Haven School District,Early Learning Center,59,56,115,2010-11
0934611,0930011,New Haven School District,East Rock Community Magnet School,199,236,435,2010-11
0931711,0930011,New Haven School District,Engineering - Science University Magnet School,66,160,226,2010-11
0931611,0930011,New Haven School District,Fair Haven School,302,337,639,2010-11
0938011,0930011,New Haven School District,Headstart,187,215,402,2010-11
0938311,0930011,New Haven School District,Helene Grant HeadStart,141,131,272,2010-11
0936611,0930011,New Haven School District,High School In The Community,169,138,307,2010-11
0930711,0930011,New Haven School District,Hill Central Music Academy,217,185,402,2010-11
0936311,0930011,New Haven School District,Hill Regional Career High School,425,244,669,2010-11
0936211,0930011,New Haven School District,James Hillhouse High School,479,490,969,2010-11
0931311,0930011,New Haven School District,John C. Daniels,269,258,527,2010-11
0930811,0930011,New Haven School District,John S. Martinez Sea and Sky STEM School,277,259,536,2010-11
0933011,0930011,New Haven School District,King/Robinson Magnet School,255,302,557,2010-11
0932011,0930011,New Haven School District,Lincoln-Bassett School,144,169,313,2010-11
0931911,0930011,New Haven School District,Mauro-Sheridan Magnet School,241,325,566,2010-11
0936011,0930011,New Haven School District,Metropolitan Business Academy,155,141,296,2010-11
0937011,0930011,New Haven School District,New Haven Academy,144,123,267,2010-11
0939211,0930011,New Haven School District,Polly T. McCabe Center,*,*,22,2010-11
0939111,0930011,New Haven School District,Riverside Education Academy,77,85,162,2010-11
0934211,0930011,New Haven School District,Roberto Clemente Leadership Academy for Global Awareness,267,269,536,2010-11
0931011,0930011,New Haven School District,Ross/Woodward School,259,262,521,2010-11
0936711,0930011,New Haven School District,Sound School,151,169,320,2010-11
0932811,0930011,New Haven School District,Strong 21st Century Communications Magnet and SCSU Lab School,158,159,317,2010-11
0932911,0930011,New Haven School District,Truman School,273,259,532,2010-11
0934911,0930011,New Haven School District,West Rock Authors Academy,111,135,246,2010-11
0933211,0930011,New Haven School District,Wexler/Grant Community School,189,186,375,2010-11
0936111,0930011,New Haven School District,Wilbur Cross High School,600,687,1287,2010-11
0933811,0930011,New Haven School District,Worthington Hooker School,219,225,444,2010-11
0950311,0950011,New London School District,Jennings School,280,274,554,2010-11
0955111,0950011,New London School District,Bennie Dover Jackson Middle School,263,327,590,2010-11
0950211,0950011,New London School District,Harbor School,138,163,301,2010-11
0950911,0950011,New London School District,Nathan Hale Arts Magnet School,123,161,284,2010-11
0959111,0950011,New London School District,New London Clinical Day Program,11,17,28,2010-11
0956111,0950011,New London School District,New London High School,442,541,983,2010-11
0950511,0950011,New London School District,Shoreline Academy,51,57,108,2010-11
0950811,0950011,New London School District,Winthrop STEM Elementary Magnet School,100,124,224,2010-11
0960511,0960011,New Milford School District,Hill And Plain School,192,264,456,2010-11
0960711,0960011,New Milford School District,John Pettibone School,224,234,458,2010-11
0969011,0960011,New Milford School District,Litchfield Hills Transition Center,*,*,9,2010-11
0966111,0960011,New Milford School District,New Milford High School,746,764,1510,2010-11
0960811,0960011,New Milford School District,Northville Elementary School,257,291,548,2010-11
0960911,0960011,New Milford School District,Sarah Noble Intermediate School,497,527,1024,2010-11
0965211,0960011,New Milford School District,Schaghticoke Middle School,371,377,748,2010-11
0940611,0940011,Newington School District,Anna Reynolds School,208,233,441,2010-11
0940211,0940011,Newington School District,Elizabeth Green School,144,159,303,2010-11
0940811,0940011,Newington School District,John Paterson School,202,274,476,2010-11
0945311,0940011,Newington School District,John Wallace Middle School,370,336,706,2010-11
0945111,0940011,Newington School District,Martin Kellogg Middle School,294,328,622,2010-11
0946111,0940011,Newington School District,Newington High School,732,753,1485,2010-11
0940711,0940011,Newington School District,Ruth Chaffee School,194,198,392,2010-11
0970111,0970011,Newtown School District,Hawley Elementary School,192,224,416,2010-11
0970411,0970011,Newtown School District,Head O'Meadow Elementary School,169,200,369,2010-11
0970311,0970011,Newtown School District,Middle Gate Elementary School,250,230,480,2010-11
0976111,0970011,Newtown School District,Newtown High School,865,866,1731,2010-11
0975111,0970011,Newtown School District,Newtown Middle School,437,460,897,2010-11
0978011,0970011,Newtown School District,Newtown Preschool,38,50,88,2010-11
0970511,0970011,Newtown School District,Reed Intermediate School,411,484,895,2010-11
0970211,0970011,Newtown School District,Sandy Hook Elementary School,276,299,575,2010-11
0980111,0980011,Norfolk School District,Botelle Elementary School,68,65,133,2010-11
0989211,0980011,Norfolk School District,Bridges II,*,*,*,2010-11
0989011,0980011,Norfolk School District,IEP Program,*,*,*,2010-11
0990411,0990011,North Branford School District,Jerome Harrison School,242,233,475,2010-11
0996111,0990011,North Branford School District,North Branford High School,349,339,688,2010-11
0995111,0990011,North Branford School District,North Branford Intermediate School,298,311,609,2010-11
0990611,0990011,North Branford School District,Totoket Valley Elementary School,269,249,518,2010-11
1000111,1000011,North Canaan School District,North Canaan Elementary School,164,154,318,2010-11
1010811,1010011,North Haven School District,Clintonville Elementary School,170,230,400,2010-11
1010711,1010011,North Haven School District,Green Acres Elementary School,175,196,371,2010-11
1010211,1010011,North Haven School District,Montowese Elementary School,194,192,386,2010-11
1016111,1010011,North Haven School District,North Haven High School,612,561,1173,2010-11
1015211,1010011,North Haven School District,North Haven Middle School,416,416,832,2010-11
1010311,1010011,North Haven School District,Ridge Road Elementary School,197,227,424,2010-11
1020111,1020011,North Stonington School District,North Stonington Elementary School,167,204,371,2010-11
1026111,1020011,North Stonington School District,Wheeler High School,102,122,224,2010-11
1025111,1020011,North Stonington School District,Wheeler Middle School,99,102,201,2010-11
1036211,1030011,Norwalk School District,Brien McMahon High School,869,826,1695,2010-11
1030211,1030011,Norwalk School District,Brookside Elementary School,227,281,508,2010-11
1030311,1030011,Norwalk School District,Columbus Magnet School,177,149,326,2010-11
1030411,1030011,Norwalk School District,Cranbury Elementary School,228,258,486,2010-11
1032011,1030011,Norwalk School District,Fox Run Elementary School,220,246,466,2010-11
1030711,1030011,Norwalk School District,Jefferson Magnet School,279,282,561,2010-11
1030811,1030011,Norwalk School District,Kendall Elementary School,236,272,508,2010-11
1032211,1030011,Norwalk School District,Marvin Elementary School,223,262,485,2010-11
1032111,1030011,Norwalk School District,Naramake Elementary School,228,235,463,2010-11
1035211,1030011,Norwalk School District,Nathan Hale Middle School,300,332,632,2010-11
1036111,1030011,Norwalk School District,Norwalk High School,745,751,1496,2010-11
1036311,1030011,Norwalk School District,Norwalk Pathways Academy at Briggs,55,63,118,2010-11
1035311,1030011,Norwalk School District,Ponus Ridge Middle School,314,353,667,2010-11
1035511,1030011,Norwalk School District,Roton Middle School,201,208,409,2010-11
1031311,1030011,Norwalk School District,Rowayton School,228,245,473,2010-11
1032311,1030011,Norwalk School District,Silvermine Elementary School,180,175,355,2010-11
1031411,1030011,Norwalk School District,Tracey School,197,197,394,2010-11
1035411,1030011,Norwalk School District,West Rocks Middle School,329,341,670,2010-11
1032411,1030011,Norwalk School District,Wolfpit School,163,183,346,2010-11
9016122,9010022,Norwich Free Academy District,Norwich Free Academy,1259,1122,2381,2010-11
1040111,1040011,Norwich School District,Bishop School Early Learning Center,7,9,16,2010-11
1049111,1040011,Norwich School District,Deborah-Tennant Zinewicz  School,6,31,37,2010-11
1049011,1040011,Norwich School District,Hickory Street School,*,*,14,2010-11
1041411,1040011,Norwich School District,John B. Stanton Network School,191,208,399,2010-11
1045111,1040011,Norwich School District,Kelly Middle School,290,329,619,2010-11
1042011,1040011,Norwich School District,Moriarty Magnet School,236,271,507,2010-11
1040811,1040011,Norwich School District,Samuel Huntington School,178,206,384,2010-11
1045211,1040011,Norwich School District,Teachers' Memorial Middle School,278,261,539,2010-11
1046111,1040011,Norwich School District,Thames River Academy,34,53,87,2010-11
1041711,1040011,Norwich School District,Thomas W. Mahan School,172,145,317,2010-11
1041911,1040011,Norwich School District,Uncas Network School,148,151,299,2010-11
1041811,1040011,Norwich School District,Veterans' Memorial School,166,162,328,2010-11
1041511,1040011,Norwich School District,Wequonnoc Magnet School,113,147,260,2010-11
2635113,2630013,Odyssey Community School District,Odyssey Community School,90,91,181,2010-11
1060211,1060011,Old Saybrook School District,Kathleen E. Goodwin School,223,228,451,2010-11
1065211,1060011,Old Saybrook School District,Old Saybrook Middle School,300,282,582,2010-11
1066111,1060011,Old Saybrook School District,Old Saybrook Senior High School,269,266,535,2010-11
1070211,1070011,Orange School District,Mary L. Tracy School,85,93,178,2010-11
1070511,1070011,Orange School District,Peck Place School,207,188,395,2010-11
1070311,1070011,Orange School District,Race Brook School,209,202,411,2010-11
1070411,1070011,Orange School District,Turkey Hill School,143,154,297,2010-11
1085111,1080011,Oxford School District,Great Oak School,251,249,500,2010-11
1080111,1080011,Oxford School District,Oxford Center School,272,253,525,2010-11
1086011,1080011,Oxford School District,Oxford High School,309,320,629,2010-11
1080311,1080011,Oxford School District,Quaker Farms School,271,272,543,2010-11
2835113,2830013,Park City Prep Charter School District,Park City Prep Charter School,128,122,250,2010-11
1098011,1090011,Plainfield School District,Early Childhood Center,*,*,16,2010-11
1090111,1090011,Plainfield School District,Moosup Elementary School,188,215,403,2010-11
1095111,1090011,Plainfield School District,Plainfield Central School,277,308,585,2010-11
1096111,1090011,Plainfield School District,Plainfield High School,408,384,792,2010-11
1090311,1090011,Plainfield School District,Plainfield Memorial School,199,209,408,2010-11
1090411,1090011,Plainfield School District,Shepard Hill Elementary School,208,214,422,2010-11
1100411,1100011,Plainville School District,Frank T. Wheeler School,115,152,267,2010-11
1100211,1100011,Plainville School District,Linden Street School,201,211,412,2010-11
1100511,1100011,Plainville School District,Louis Toffolon School,185,180,365,2010-11
1105211,1100011,Plainville School District,Middle School of Plainville,266,309,575,2010-11
1106111,1100011,Plainville School District,Plainville High School,412,384,796,2010-11
1108011,1100011,Plainville School District,Prekindergarten Program,17,31,48,2010-11
1115111,1110011,Plymouth School District,Eli Terry Jr. Middle School,193,248,441,2010-11
1110411,1110011,Plymouth School District,Harry S. Fisher Elementary School,196,166,362,2010-11
1110211,1110011,Plymouth School District,Plymouth Center School,183,217,400,2010-11
1116111,1110011,Plymouth School District,Terryville High School,241,286,527,2010-11
1120111,1120011,Pomfret School District,Pomfret Community School,259,254,513,2010-11
1130511,1130011,Portland School District,Brownstone Intermediate School,118,115,233,2010-11
1130411,1130011,Portland School District,Gildersleeve School,133,109,242,2010-11
1136111,1130011,Portland School District,Portland High School,166,201,367,2010-11
1135111,1130011,Portland School District,Portland Middle School,107,119,226,2010-11
1130211,1130011,Portland School District,Valley View School,173,163,336,2010-11
1145111,1140011,Preston School District,Preston Plains School,58,77,135,2010-11
1140411,1140011,Preston School District,Preston Veterans' Memorial School,143,152,295,2010-11
1169011,1160011,Putnam School District,Helping Hands,*,*,*,2010-11
1160311,1160011,Putnam School District,Putnam Elementary School,334,365,699,2010-11
1166111,1160011,Putnam School District,Putnam High School,138,176,314,2010-11
1165111,1160011,Putnam School District,Putnam Middle School,120,155,275,2010-11
1175111,1170011,Redding School District,John Read Middle School,296,286,582,2010-11
1170111,1170011,Redding School District,Redding Elementary School,324,337,661,2010-11
2016112,2010012,Regional School District 01,Housatonic Valley Regional High School,249,253,502,2010-11
2045112,2040012,Regional School District 04,John Winthrop Middle School,175,189,364,2010-11
2046112,2040012,Regional School District 04,Valley Regional High School,316,293,609,2010-11
2055112,2050012,Regional School District 05,Amity Middle School: Bethany,188,226,414,2010-11
2055212,2050012,Regional School District 05,Amity Middle School: Orange,205,207,412,2010-11
2056112,2050012,Regional School District 05,Amity Regional High School,778,871,1649,2010-11
2060112,2060012,Regional School District 06,Goshen Center School,108,105,213,2010-11
2060212,2060012,Regional School District 06,James Morris School,97,99,196,2010-11
2066112,2060012,Regional School District 06,Wamogo Regional High School,299,246,545,2010-11
2060312,2060012,Regional School District 06,Warren Elementary School,43,50,93,2010-11
2079112,2070012,Regional School District 07,AIM,7,9,16,2010-11
2079012,2070012,Regional School District 07,FLEX,*,*,6,2010-11
2079412,2070012,Regional School District 07,Intensive Learning Program,*,*,11,2010-11
2079212,2070012,Regional School District 07,Links,6,9,15,2010-11
2076112,2070012,Regional School District 07,Northwestern Regional High School,417,345,762,2010-11
2075112,2070012,Regional School District 07,Northwestern Regional Middle School,145,185,330,2010-11
2079312,2070012,Regional School District 07,STEP,11,17,28,2010-11
2086112,2080012,Regional School District 08,RHAM High School,536,620,1156,2010-11
2085112,2080012,Regional School District 08,RHAM Middle School,293,316,609,2010-11
2096112,2090012,Regional School District 09,Joel Barlow High School,510,458,968,2010-11
2105112,2100012,Regional School District 10,Har-Bur Middle School,414,475,889,2010-11
2100312,2100012,Regional School District 10,Harwinton Consolidated School,239,237,476,2010-11
2100212,2100012,Regional School District 10,Lake Garda Elementary School,268,306,574,2010-11
2106112,2100012,Regional School District 10,Lewis S. Mills High School,405,417,822,2010-11
2116112,2110012,Regional School District 11,Parish Hill High School,133,141,274,2010-11
2120212,2120012,Regional School District 12,Booth Free School,58,55,113,2010-11
2128012,2120012,Regional School District 12,Early Childhood Education Center,10,9,19,2010-11
2126112,2120012,Regional School District 12,Shepaug Valley High School,143,183,326,2010-11
2125112,2120012,Regional School District 12,Shepaug Valley Middle School,105,121,226,2010-11
2120112,2120012,Regional School District 12,The Burnham School,35,49,84,2010-11
2120412,2120012,Regional School District 12,Washington Primary School,82,80,162,2010-11
2136112,2130012,Regional School District 13,Coginchaug Regional High School,296,273,569,2010-11
2130212,2130012,Regional School District 13,Francis E. Korn School,94,106,200,2010-11
2135112,2130012,Regional School District 13,Frank Ward Strong School,178,172,350,2010-11
2130112,2130012,Regional School District 13,Frederick Brewster School,114,155,269,2010-11
2130512,2130012,Regional School District 13,John Lyman School,156,163,319,2010-11
2130412,2130012,Regional School District 13,Middlefield Memorial School,157,177,334,2010-11
2140112,2140012,Regional School District 14,Bethlehem Elementary School,176,173,349,2010-11
2148012,2140012,Regional School District 14,Integrated Star Preschool Program,22,21,43,2010-11
2140212,2140012,Regional School District 14,Mitchell Elementary School,190,197,387,2010-11
2146112,2140012,Regional School District 14,Nonnewaug High School,467,387,854,2010-11
2145112,2140012,Regional School District 14,Woodbury Middle School,224,223,447,2010-11
2150412,2150012,Regional School District 15,Gainfield Elementary School,211,213,424,2010-11
2150712,2150012,Regional School District 15,Long Meadow Elementary School,278,325,603,2010-11
2155212,2150012,Regional School District 15,Memorial Middle School,268,240,508,2010-11
2150612,2150012,Regional School District 15,Middlebury Elementary School,208,253,461,2010-11
2156212,2150012,Regional School District 15,Pomperaug Regional High School,659,722,1381,2010-11
2150512,2150012,Regional School District 15,Pomperaug School,223,275,498,2010-11
2155112,2150012,Regional School District 15,Rochambeau Middle School,272,278,550,2010-11
2160312,2160012,Regional School District 16,Algonquin School,244,236,480,2010-11
2160212,2160012,Regional School District 16,Community School,119,92,211,2010-11
2160112,2160012,Regional School District 16,Laurel Ledge School,216,255,471,2010-11
2165112,2160012,Regional School District 16,Long River Middle School,310,285,595,2010-11
2166012,2160012,Regional School District 16,Woodland Regional High School,385,394,779,2010-11
2170212,2170012,Regional School District 17,Burr District Elementary School,143,158,301,2010-11
2170112,2170012,Regional School District 17,Haddam Elementary School,116,136,252,2010-11
2176112,2170012,Regional School District 17,Haddam-Killingworth High School,322,358,680,2010-11
2175112,2170012,Regional School District 17,Haddam-Killingworth Middle School,415,383,798,2010-11
2170312,2170012,Regional School District 17,Killingworth Elementary School,220,226,446,2010-11
2180312,2180012,Regional School District 18,Center School,148,121,269,2010-11
2180112,2180012,Regional School District 18,Lyme Consolidated School,61,73,134,2010-11
2186112,2180012,Regional School District 18,Lyme-Old Lyme High School,234,213,447,2010-11
2185112,2180012,Regional School District 18,Lyme-Old Lyme Middle School,146,185,331,2010-11
2180212,2180012,Regional School District 18,Mile Creek School,155,157,312,2010-11
2196112,2190012,Regional School District 19,E. O. Smith High School,604,581,1185,2010-11
1180811,1180011,Ridgefield School District,Barlow Mountain Elementary School,180,232,412,2010-11
1180611,1180011,Ridgefield School District,Branchville Elementary School,219,224,443,2010-11
1185111,1180011,Ridgefield School District,East Ridge Middle School,354,388,742,2010-11
1180411,1180011,Ridgefield School District,Farmingville Elementary School,168,178,346,2010-11
1180311,1180011,Ridgefield School District,Ridgebury Elementary School,208,201,409,2010-11
1189011,1180011,Ridgefield School District,Ridgefield 18-21 Transition Program,*,*,*,2010-11
1186111,1180011,Ridgefield School District,Ridgefield High School,865,889,1754,2010-11
1180511,1180011,Ridgefield School District,Scotland Elementary School,183,202,385,2010-11
1185211,1180011,Ridgefield School District,Scotts Ridge Middle School,284,298,582,2010-11
1180211,1180011,Ridgefield School District,Veterans Park Elementary School,153,191,344,2010-11
1195111,1190011,Rocky Hill School District,Albert D. Griswold Middle School,317,327,644,2010-11
1190211,1190011,Rocky Hill School District,Dr. Oran A. Moser School,42,43,85,2010-11
1190411,1190011,Rocky Hill School District,Myrtle H. Stevens School,217,252,469,2010-11
1196111,1190011,Rocky Hill School District,Rocky Hill High School,374,378,752,2010-11
1190511,1190011,Rocky Hill School District,West Hill School,322,308,630,2010-11
1210111,1210011,Salem School District,Salem Elementary School,223,238,461,2010-11
1220111,1220011,Salisbury School District,Salisbury Central School,152,158,310,2010-11
1230111,1230011,Scotland School District,Scotland Elementary School,81,62,143,2010-11
1240311,1240011,Seymour School District,Anna L. Lopresti School,151,163,314,2010-11
1240111,1240011,Seymour School District,Bungay School,286,292,578,2010-11
1240411,1240011,Seymour School District,Paul E. Chatfield School,138,153,291,2010-11
1246111,1240011,Seymour School District,Seymour High School,321,321,642,2010-11
1245111,1240011,Seymour School District,Seymour Middle School,274,313,587,2010-11
1250111,1250011,Sharon School District,Sharon Center School,102,95,197,2010-11
1260911,1260011,Shelton School District,Mohegan School,215,206,421,2010-11
1261011,1260011,Shelton School District,Booth Hill School,154,205,359,2010-11
1260511,1260011,Shelton School District,Elizabeth Shelton School,227,252,479,2010-11
1265111,1260011,Shelton School District,Intermediate School,468,457,925,2010-11
1260811,1260011,Shelton School District,Long Hill School,218,223,441,2010-11
1261111,1260011,Shelton School District,Perry Hill Elementary School,417,440,857,2010-11
1266111,1260011,Shelton School District,Shelton High School,777,769,1546,2010-11
1260611,1260011,Shelton School District,Sunnyside School,109,154,263,2010-11
1270111,1270011,Sherman School District,Sherman School,198,210,408,2010-11
2700113,2700013,Side By Side Charter School District,Side By Side Charter School,110,123,233,2010-11
1280111,1280011,Simsbury School District,Central School,192,216,408,2010-11
1285111,1280011,Simsbury School District,Henry James Memorial School,393,411,804,2010-11
1280611,1280011,Simsbury School District,Latimer Lane School,249,257,506,2010-11
1286111,1280011,Simsbury School District,Simsbury High School,737,845,1582,2010-11
1280711,1280011,Simsbury School District,Squadron Line School,370,397,767,2010-11
1280311,1280011,Simsbury School District,Tariffville School,117,150,267,2010-11
1280411,1280011,Simsbury School District,Tootin' Hills School,198,228,426,2010-11
1295111,1290011,Somers School District,Mabelle B. Avery Middle School,175,212,387,2010-11
1290411,1290011,Somers School District,Somers Elementary School,321,360,681,2010-11
1296111,1290011,Somers School District,Somers High School,289,273,562,2010-11
1320211,1320011,South Windsor School District,Pleasant Valley School,195,237,432,2010-11
1320711,1320011,South Windsor School District,Eli Terry School,204,231,435,2010-11
1320611,1320011,South Windsor School District,Orchard Hill School,204,224,428,2010-11
1320111,1320011,South Windsor School District,Philip R. Smith School,156,186,342,2010-11
1326211,1320011,South Windsor School District,South Windsor High School,712,827,1539,2010-11
1325111,1320011,South Windsor School District,Timothy Edwards School,565,523,1088,2010-11
1320411,1320011,South Windsor School District,Wapping Elementary School,130,163,293,2010-11
1315311,1310011,Southington School District,John F. Kennedy Middle School,404,432,836,2010-11
1311511,1310011,Southington School District,Derynoski Elementary School,359,324,683,2010-11
1311311,1310011,Southington School District,Flanders Elementary School,139,151,290,2010-11
1310211,1310011,Southington School District,Hatton Elementary School,191,236,427,2010-11
1315111,1310011,Southington School District,Joseph A. Depaolo Middle School,342,392,734,2010-11
1310611,1310011,Southington School District,Plantsville Elementary School,139,141,280,2010-11
1310711,1310011,Southington School District,South End Elementary School,121,124,245,2010-11
1316211,1310011,Southington School District,Southington High School,1030,1021,2051,2010-11
1310811,1310011,Southington School District,Strong Elementary School,190,206,396,2010-11
1310911,1310011,Southington School District,Thalberg Elementary School,222,227,449,2010-11
1311411,1310011,Southington School District,Urbin T. Kelley School,197,210,407,2010-11
1330111,1330011,Sprague School District,Sayles School,177,194,371,2010-11
1340611,1340011,Stafford School District,Stafford Elementary School,250,252,502,2010-11
1346111,1340011,Stafford School District,Stafford High School,294,264,558,2010-11
1345211,1340011,Stafford School District,Stafford Middle School,211,205,416,2010-11
1340311,1340011,Stafford School District,Staffordville School,85,105,190,2010-11
1340411,1340011,Stafford School District,West Stafford School,97,91,188,2010-11
2826013,2820013,Stamford Academy District,Stamford Academy,54,83,137,2010-11
1355611,1350011,Stamford School District,Cloonan School,293,305,598,2010-11
1352011,1350011,Stamford School District,Davenport Ridge School,278,276,554,2010-11
1355311,1350011,Stamford School District,Dolan School,255,298,553,2010-11
1352211,1350011,Stamford School District,Hart School,242,262,504,2010-11
1351211,1350011,Stamford School District,Julia A. Stark School,249,283,532,2010-11
1350511,1350011,Stamford School District,K. T. Murphy School,301,239,540,2010-11
1350611,1350011,Stamford School District,Newfield School,329,315,644,2010-11
1351811,1350011,Stamford School District,Northeast School,373,356,729,2010-11
1358011,1350011,Stamford School District,Preschool Team,6,19,25,2010-11
1355811,1350011,Stamford School District,Rippowam Middle School,310,334,644,2010-11
1350811,1350011,Stamford School District,Rogers International School,373,374,747,2010-11
1350911,1350011,Stamford School District,Roxbury School,303,353,656,2010-11
1355711,1350011,Stamford School District,Scofield Middle School,320,311,631,2010-11
1351111,1350011,Stamford School District,Springdale School,277,308,585,2010-11
1356111,1350011,Stamford School District,Stamford High School,890,921,1811,2010-11
1352111,1350011,Stamford School District,Stillmeadow School,309,339,648,2010-11
1356411,1350011,Stamford School District,The Academy of Information Technology,274,406,680,2010-11
1351911,1350011,Stamford School District,Toquam Magnet School,324,299,623,2010-11
1355511,1350011,Stamford School District,Turn of River School,277,295,572,2010-11
1356311,1350011,Stamford School District,Westhill High School,1150,1160,2310,2010-11
1351411,1350011,Stamford School District,Westover School,340,378,718,2010-11
1360311,1360011,Sterling School District,Sterling Community School,226,256,482,2010-11
1370511,1370011,Stonington School District,Deans Mill School,237,278,515,2010-11
1375211,1370011,Stonington School District,Mystic Middle School,228,213,441,2010-11
1375111,1370011,Stonington School District,Pawcatuck Middle School,171,178,349,2010-11
1378011,1370011,Stonington School District,Special Needs Preschool Program,9,15,24,2010-11
1376111,1370011,Stonington School District,Stonington High School,379,402,781,2010-11
1370411,1370011,Stonington School District,West Broad Street School,79,84,163,2010-11
1370611,1370011,Stonington School District,West Vine Street School,105,114,219,2010-11
1381311,1380011,Stratford School District,Eli Whitney School,272,260,532,2010-11
1386211,1380011,Stratford School District,Bunnell High School,613,620,1233,2010-11
1380311,1380011,Stratford School District,Chapel School,261,286,547,2010-11
1385211,1380011,Stratford School District,David Wooster Middle School,274,290,564,2010-11
1380411,1380011,Stratford School District,Franklin School,164,144,308,2010-11
1385311,1380011,Stratford School District,Harry B. Flood Middle School,314,283,597,2010-11
1381611,1380011,Stratford School District,Honeyspot School,126,121,247,2010-11
1380811,1380011,Stratford School District,Lordship School,110,103,213,2010-11
1380911,1380011,Stratford School District,Nichols School,195,227,422,2010-11
1381011,1380011,Stratford School District,Second Hill Lane School,343,355,698,2010-11
1389111,1380011,Stratford School District,Secondary STEPS Program,*,*,14,2010-11
1381511,1380011,Stratford School District,Stratford Academy - Johnson House,239,221,460,2010-11
1386111,1380011,Stratford School District,Stratford High School,529,515,1044,2010-11
1389011,1380011,Stratford School District,Strive-Stratford,6,8,14,2010-11
1381411,1380011,Stratford School District,Wilcoxson School,178,213,391,2010-11
1390411,1390011,Suffield School District,A. Ward Spaulding School,238,256,494,2010-11
1390311,1390011,Suffield School District,McAlister Intermediate School,289,265,554,2010-11
1396111,1390011,Suffield School District,Suffield High School,459,399,858,2010-11
1395111,1390011,Suffield School District,Suffield Middle School,282,318,600,2010-11
2696113,2690013,The Bridge Academy District,The Bridge Academy,138,133,271,2010-11
9026122,9020022,The Gilbert School District,The Gilbert School,178,147,325,2010-11
1400111,1400011,Thomaston School District,Black Rock School,174,166,340,2010-11
1400211,1400011,Thomaston School District,Thomaston Center School,119,137,256,2010-11
1406211,1400011,Thomaston School District,Thomaston High School,252,270,522,2010-11
1410111,1410011,Thompson School District,Mary R. Fisher Elementary School,231,250,481,2010-11
1415111,1410011,Thompson School District,Thompson Middle School,204,216,420,2010-11
1416111,1410011,Thompson School District,Tourtellotte Memorial High School,187,175,362,2010-11
1420111,1420011,Tolland School District,Birch Grove Primary School,306,351,657,2010-11
1426111,1420011,Tolland School District,Tolland High School,451,488,939,2010-11
1420211,1420011,Tolland School District,Tolland Intermediate School,350,357,707,2010-11
1425111,1420011,Tolland School District,Tolland Middle School,373,376,749,2010-11
1430111,1430011,Torrington School District,East School,224,222,446,2010-11
1430211,1430011,Torrington School District,Forbes School,189,209,398,2010-11
1430811,1430011,Torrington School District,Southwest School,140,183,323,2010-11
1430911,1430011,Torrington School District,Torringford School,305,364,669,2010-11
1436111,1430011,Torrington School District,Torrington High School,523,565,1088,2010-11
1435111,1430011,Torrington School District,Torrington Middle School,534,600,1134,2010-11
1431311,1430011,Torrington School District,Vogel-Wetmore School,203,248,451,2010-11
2785113,2780013,Trailblazers Academy District,Trailblazers Academy,69,93,162,2010-11
1440111,1440011,Trumbull School District,Booth Hill School,268,267,535,2010-11
1440811,1440011,Trumbull School District,Daniels Farm School,233,265,498,2010-11
1441011,1440011,Trumbull School District,Frenchtown Elementary School,308,336,644,2010-11
1445211,1440011,Trumbull School District,Hillcrest Middle School,360,387,747,2010-11
1440411,1440011,Trumbull School District,Jane Ryan School,191,211,402,2010-11
1445111,1440011,Trumbull School District,Madison Middle School,433,440,873,2010-11
1440311,1440011,Trumbull School District,Middlebrook School,227,259,486,2010-11
1440911,1440011,Trumbull School District,Tashua School,203,206,409,2010-11
1448011,1440011,Trumbull School District,Trumbull Early Childhood Education Center,106,125,231,2010-11
1446111,1440011,Trumbull School District,Trumbull High School,1134,1016,2150,2010-11
3361715,3360015,Unified School District #1,Bergin Correctional Institution,0,19,19,2010-11
3360115,3360015,Unified School District #1,Bridgeport Correctional Center,0,11,11,2010-11
3360215,3360015,Unified School District #1,Brooklyn Correctional Institution,0,*,*,2010-11
3360315,3360015,Unified School District #1,Cheshire Correctional Institution,0,38,38,2010-11
3362415,3360015,Unified School District #1,Corrigan/Radgowski Correctional Institution,0,43,43,2010-11
3360415,3360015,Unified School District #1,Enfield Correctional Institution,0,15,15,2010-11
3361915,3360015,Unified School District #1,Garner Correctional Institution,0,18,18,2010-11
3360515,3360015,Unified School District #1,Gates Correctional Institution,0,11,11,2010-11
3360615,3360015,Unified School District #1,Hartford Correctional Center,0,41,41,2010-11
3362215,3360015,Unified School District #1,MacDougall/Walker Correctional Institution,0,53,53,2010-11
3361115,3360015,Unified School District #1,Manson Youth Institution,*,*,445,2010-11
3360915,3360015,Unified School District #1,New Haven Correctional Center,0,17,17,2010-11
3362615,3360015,Unified School District #1,Northern Correctional Institution,0,16,16,2010-11
3361215,3360015,Unified School District #1,Osborn Correctional Institution,0,14,14,2010-11
3361315,3360015,Unified School District #1,Robinson Correctional Institution,0,24,24,2010-11
3361515,3360015,Unified School District #1,Willard/Cybulski Correctional Institution,0,13,13,2010-11
3362515,3360015,Unified School District #1,York Correctional Institution,36,0,36,2010-11
3470115,3470015,Unified School District #2,Children's Place School,10,13,23,2010-11
3470315,3470015,Unified School District #2,Riverview School,22,42,64,2010-11
3476715,3470015,Unified School District #2,Walter G. Cady School,0,117,117,2010-11
1450111,1450011,Union School District,Union Elementary School,47,34,81,2010-11
1460311,1460011,Vernon School District,Northeast School,139,160,299,2010-11
1461411,1460011,Vernon School District,Center Road School,257,247,504,2010-11
1460111,1460011,Vernon School District,Lake Street School,129,158,287,2010-11
1460211,1460011,Vernon School District,Maple Street School,151,158,309,2010-11
1469011,1460011,Vernon School District,Next Step Program (AACBP),9,6,15,2010-11
1466111,1460011,Vernon School District,Rockville High School,532,528,1060,2010-11
1461011,1460011,Vernon School District,Skinner Road School,163,187,350,2010-11
1465111,1460011,Vernon School District,Vernon Center Middle School,386,386,772,2010-11
1470111,1470011,Voluntown School District,Voluntown Elementary School,165,147,312,2010-11
1480211,1480011,Wallingford School District,Highland School,171,181,352,2010-11
1489011,1480011,Wallingford School District,A.R.T.S. Academy,*,*,7,2010-11
1481011,1480011,Wallingford School District,Cook Hill School,196,195,391,2010-11
1485211,1480011,Wallingford School District,Dag Hammarskjold Middle School,367,346,713,2010-11
1480911,1480011,Wallingford School District,Evarts C. Stevens School,186,195,381,2010-11
1489211,1480011,Wallingford School District,Harvest Park,0,*,*,2010-11
1485311,1480011,Wallingford School District,James H. Moran Middle School,415,399,814,2010-11
1486111,1480011,Wallingford School District,Lyman Hall High School,637,503,1140,2010-11
1486211,1480011,Wallingford School District,Mark T. Sheehan High School,473,476,949,2010-11
1480111,1480011,Wallingford School District,Moses Y. Beach School,185,191,376,2010-11
1489111,1480011,Wallingford School District,Multi-Vocational Life Skills Program,*,*,7,2010-11
1480311,1480011,Wallingford School District,Parker Farms School,166,176,342,2010-11
1481211,1480011,Wallingford School District,Pond Hill School,166,171,337,2010-11
1480411,1480011,Wallingford School District,Rock Hill School,182,175,357,2010-11
1480811,1480011,Wallingford School District,Yalesville School,201,182,383,2010-11
1511011,1510011,Waterbury School District,Brooklyn Elementary School,85,104,189,2010-11
1515211,1510011,Waterbury School District,West Side Middle School,536,611,1147,2010-11
1512311,1510011,Waterbury School District,Washington School,160,158,318,2010-11
1512111,1510011,Waterbury School District,B. W. Tinker School,227,282,509,2010-11
1510311,1510011,Waterbury School District,Barnard School,134,130,264,2010-11
1510511,1510011,Waterbury School District,Bucks Hill School,261,299,560,2010-11
1510611,1510011,Waterbury School District,Bunker Hill School,239,247,486,2010-11
1512711,1510011,Waterbury School District,Carrington School,234,254,488,2010-11
1516211,1510011,Waterbury School District,Crosby High School,642,746,1388,2010-11
1510911,1510011,Waterbury School District,Driggs School,261,269,530,2010-11
1519111,1510011,Waterbury School District,Enlightenment School,68,82,150,2010-11
1511411,1510011,Waterbury School District,F. J. Kingsbury School,239,234,473,2010-11
1512611,1510011,Waterbury School District,Gilmartin School,159,171,330,2010-11
1510711,1510011,Waterbury School District,H. S. Chase School,356,360,716,2010-11
1511311,1510011,Waterbury School District,Hopeville School,212,207,419,2010-11
1516411,1510011,Waterbury School District,John F. Kennedy High School,673,695,1368,2010-11
1513111,1510011,Waterbury School District,Maloney Interdistrict Magnet School,289,318,607,2010-11
1511111,1510011,Waterbury School District,Margaret M. Generali Elementary School,272,285,557,2010-11
1515111,1510011,Waterbury School District,Michael F. Wallace Middle School,673,675,1348,2010-11
1515311,1510011,Waterbury School District,North End Middle School,559,647,1206,2010-11
1512811,1510011,Waterbury School District,Regan School,138,142,280,2010-11
1513311,1510011,Waterbury School District,Rotella Interdistrict Magnet School,326,290,616,2010-11
1518011,1510011,Waterbury School District,Special Education Preschool,79,129,208,2010-11
1512011,1510011,Waterbury School District,Sprague School,184,192,376,2010-11
1519011,1510011,Waterbury School District,State Street School,16,61,77,2010-11
1512211,1510011,Waterbury School District,Walsh School,283,284,567,2010-11
1516011,1510011,Waterbury School District,Waterbury Arts Magnet School (High),303,178,481,2010-11
1515011,1510011,Waterbury School District,Waterbury Arts Magnet School (Middle),190,129,319,2010-11
1510811,1510011,Waterbury School District,Wendell L. Cross School,186,188,374,2010-11
1516311,1510011,Waterbury School District,Wilby High School,624,682,1306,2010-11
1513211,1510011,Waterbury School District,Woodrow Wilson School,209,209,418,2010-11
1525111,1520011,Waterford School District,Clark Lane Middle School,323,366,689,2010-11
1520211,1520011,Waterford School District,Great Neck Elementary School,192,192,384,2010-11
1520611,1520011,Waterford School District,Oswegatchie Elementary School,193,211,404,2010-11
1520711,1520011,Waterford School District,Quaker Hill Elementary School,172,194,366,2010-11
1526111,1520011,Waterford School District,Waterford High School,463,496,959,2010-11
1530311,1530011,Watertown School District,Fletcher W. Judson School,189,160,349,2010-11
1530211,1530011,Watertown School District,John Trumbull Primary School,322,375,697,2010-11
1530411,1530011,Watertown School District,Polk School,171,197,368,2010-11
1535111,1530011,Watertown School District,Swift Middle School,366,394,760,2010-11
1536111,1530011,Watertown School District,Watertown High School,524,477,1001,2010-11
1551711,1550011,West Hartford School District,Smith School,168,195,363,2010-11
1559111,1550011,West Hartford School District,Achieve,*,*,*,2010-11
1551611,1550011,West Hartford School District,Aiken School,210,234,444,2010-11
1550211,1550011,West Hartford School District,Braeburn School,218,214,432,2010-11
1555311,1550011,West Hartford School District,Bristow Middle School,207,216,423,2010-11
1550411,1550011,West Hartford School District,Bugbee School,220,199,419,2010-11
1550511,1550011,West Hartford School District,Charter Oak International Academy,155,159,314,2010-11
1556111,1550011,West Hartford School District,Conard High School,760,792,1552,2010-11
1550611,1550011,West Hartford School District,Duffy School,269,290,559,2010-11
1556211,1550011,West Hartford School District,Hall High School,777,795,1572,2010-11
1555111,1550011,West Hartford School District,King Philip Middle School,427,452,879,2010-11
1550911,1550011,West Hartford School District,Morley School,193,184,377,2010-11
1551011,1550011,West Hartford School District,Norfeldt School,197,216,413,2010-11
1555211,1550011,West Hartford School District,Sedgwick Middle School,472,452,924,2010-11
1559011,1550011,West Hartford School District,WAAVE (W Hartford Applied Academic/Voc'l Experience),*,*,12,2010-11
1551211,1550011,West Hartford School District,Webster Hill School,244,226,470,2010-11
1551311,1550011,West Hartford School District,Whiting Lane School,255,296,551,2010-11
1551511,1550011,West Hartford School District,Wolcott School,252,261,513,2010-11
1561211,1560011,West Haven School District,Washington School,198,261,459,2010-11
1560811,1560011,West Haven School District,Alma E. Pagels School,202,198,400,2010-11
1565311,1560011,West Haven School District,Carrigan 5/6 Intermediate School,488,461,949,2010-11
1560611,1560011,West Haven School District,Edith E. Mackrille School,210,189,399,2010-11
1560311,1560011,West Haven School District,Forest School,211,253,464,2010-11
1565111,1560011,West Haven School District,Harry M. Bailey Middle School,496,495,991,2010-11
1561411,1560011,West Haven School District,Savin Rock Community School,233,284,517,2010-11
1560411,1560011,West Haven School District,Seth G. Haley School,227,244,471,2010-11
1566111,1560011,West Haven School District,West Haven High School,750,795,1545,2010-11
1540211,1540011,Westbrook School District,Daisy Ingraham School,156,180,336,2010-11
1546111,1540011,Westbrook School District,Westbrook High School,146,155,301,2010-11
1545111,1540011,Westbrook School District,Westbrook Middle School,146,163,309,2010-11
1570111,1570011,Weston School District,Hurlbutt Elementary School,261,281,542,2010-11
1576111,1570011,Weston School District,Weston High School,406,374,780,2010-11
1570211,1570011,Weston School District,Weston Intermediate School,289,305,594,2010-11
1575111,1570011,Weston School District,Weston Middle School,281,326,607,2010-11
1585111,1580011,Westport School District,Bedford Middle School,416,417,833,2010-11
1580311,1580011,Westport School District,Coleytown Elementary School,240,237,477,2010-11
1585311,1580011,Westport School District,Coleytown Middle School,263,228,491,2010-11
1580411,1580011,Westport School District,Green's Farms School,224,241,465,2010-11
1580511,1580011,Westport School District,King's Highway Elementary School,239,247,486,2010-11
1580711,1580011,Westport School District,Long Lots School,278,328,606,2010-11
1580811,1580011,Westport School District,Saugatuck Elementary School,238,292,530,2010-11
1586111,1580011,Westport School District,Staples High School,898,934,1832,2010-11
1588011,1580011,Westport School District,Stepping Stones Preschool,17,38,55,2010-11
1590811,1590011,Wethersfield School District,Alfred W. Hanmer School,184,211,395,2010-11
1591011,1590011,Wethersfield School District,Charles Wright School,179,145,324,2010-11
1590211,1590011,Wethersfield School District,Emerson-Williams School,217,232,449,2010-11
1591111,1590011,Wethersfield School District,Highcrest School,204,215,419,2010-11
1591211,1590011,Wethersfield School District,Samuel B. Webb Elementary School,198,212,410,2010-11
1595211,1590011,Wethersfield School District,Silas Deane Middle School,300,319,619,2010-11
1596111,1590011,Wethersfield School District,Wethersfield High School,584,596,1180,2010-11
1600111,1600011,Willington School District,Center School,101,110,211,2010-11
1605111,1600011,Willington School District,Hall Memorial School,144,156,300,2010-11
1615211,1610011,Wilton School District,Middlebrook School,496,537,1033,2010-11
1610711,1610011,Wilton School District,Cider Mill School,518,504,1022,2010-11
1610511,1610011,Wilton School District,Miller-Driscoll School,473,515,988,2010-11
1616111,1610011,Wilton School District,Wilton High School,620,656,1276,2010-11
1629211,1620011,Winchester School District,Batcheller - Bridges 1,*,*,*,2010-11
1620411,1620011,Winchester School District,Batcheller Early Education Center,59,59,118,2010-11
1620211,1620011,Winchester School District,Mary P. Hinsdale School,183,220,403,2010-11
1625111,1620011,Winchester School District,Pearson Middle School,175,247,422,2010-11
1638011,1630011,Windham School District,Early Headstart,16,16,32,2010-11
1630111,1630011,Windham School District,Natchaug School,121,132,253,2010-11
1630311,1630011,Windham School District,North Windham School,210,213,423,2010-11
1638411,1630011,Windham School District,Partial Day Program,*,*,10,2010-11
1630611,1630011,Windham School District,W. B. Sweeney School,154,187,341,2010-11
1630511,1630011,Windham School District,Windham Center School,154,156,310,2010-11
1638311,1630011,Windham School District,Windham Early Childhood Prospect Street,94,115,209,2010-11
1636111,1630011,Windham School District,Windham High School,359,452,811,2010-11
1635111,1630011,Windham School District,Windham Middle School,487,499,986,2010-11
1650111,1650011,Windsor Locks School District,North Street School,217,232,449,2010-11
1650411,1650011,Windsor Locks School District,South Elementary School,180,198,378,2010-11
1656111,1650011,Windsor Locks School District,Windsor Locks High School,275,269,544,2010-11
1655111,1650011,Windsor Locks School District,Windsor Locks Middle School,190,224,414,2010-11
1640111,1640011,Windsor School District,Clover Street School,152,127,279,2010-11
1640811,1640011,Windsor School District,John F. Kennedy School,154,170,324,2010-11
1640911,1640011,Windsor School District,Oliver Ellsworth School,182,193,375,2010-11
1640511,1640011,Windsor School District,Poquonock Elementary School,147,140,287,2010-11
1641011,1640011,Windsor School District,Roger Wolcott Early Child Center,109,135,244,2010-11
1645311,1640011,Windsor School District,Sage Park Middle School,393,421,814,2010-11
1646111,1640011,Windsor School District,Windsor High School,617,684,1301,2010-11
1660611,1660011,Wolcott School District,Alcott School,151,190,341,2010-11
1660211,1660011,Wolcott School District,Frisbie School,197,190,387,2010-11
1665111,1660011,Wolcott School District,Tyrrell Middle School,328,355,683,2010-11
1660511,1660011,Wolcott School District,Wakelee School,212,218,430,2010-11
1666111,1660011,Wolcott School District,Wolcott High School,446,454,900,2010-11
1670211,1670011,Woodbridge School District,Beecher Road Intermediate School,195,217,412,2010-11
1670111,1670011,Woodbridge School District,Beecher Road Primary School,153,158,311,2010-11
9036122,9030022,Woodstock Academy District,Woodstock Academy,575,521,1096,2010-11
1690211,1690011,Woodstock School District,Woodstock Elementary School,246,272,518,2010-11
1695111,1690011,Woodstock School District,Woodstock Middle School,196,211,407,2010-11
2880113,2880013,Achievement First Hartford Academy Inc. District,Achievement First Hartford Academy Inc.,350,412,762,2011-12
2795113,2790013,Amistad Academy District,Amistad Academy,425,432,857,2011-12
0010111,0010011,Andover School District,Andover Elementary School,131,183,314,2011-12
0026111,0020011,Ansonia School District,Ansonia High School,339,356,695,2011-12
0025111,0020011,Ansonia School District,Ansonia Middle School,214,258,472,2011-12
0020311,0020011,Ansonia School District,Mead School,304,306,610,2011-12
0020811,0020011,Ansonia School District,Prendergast School,357,381,738,2011-12
2449614,2440014,Area Cooperative Educational Services,Center for Autism Spectrum and Development Disorders,7,24,31,2011-12
2449414,2440014,Area Cooperative Educational Services,Mill Road School,17,143,160,2011-12
2445114,2440014,Area Cooperative Educational Services,Thomas Edison Magnet Middle School,338,383,721,2011-12
2449514,2440014,Area Cooperative Educational Services,Village School,42,106,148,2011-12
2449214,2440014,Area Cooperative Educational Services,Whitney High School East,29,85,114,2011-12
2449114,2440014,Area Cooperative Educational Services,Whitney High School North,24,70,94,2011-12
2449314,2440014,Area Cooperative Educational Services,Whitney High School West,13,34,47,2011-12
2440314,2440014,Area Cooperative Educational Services,Wintergreen Interdistrict  Magnet School,327,313,640,2011-12
0030111,0030011,Ashford School District,Ashford School,239,242,481,2011-12
0046111,0040011,Avon School District,Avon High School,577,535,1112,2011-12
0045111,0040011,Avon School District,Avon Middle School,272,300,572,2011-12
0040411,0040011,Avon School District,Pine Grove School,300,331,631,2011-12
0040311,0040011,Avon School District,Roaring Brook School,285,305,590,2011-12
0040511,0040011,Avon School District,Thompson Brook School,293,301,594,2011-12
0050111,0050011,Barkhamsted School District,Barkhamsted Elementary School,148,190,338,2011-12
0058011,0050011,Barkhamsted School District,Shared Services Integrated Preschool,9,10,19,2011-12
0076111,0070011,Berlin School District,Berlin High School,492,484,976,2011-12
0075111,0070011,Berlin School District,Catherine M. McGee Middle School,351,379,730,2011-12
0070411,0070011,Berlin School District,Emma Hart Willard School,204,288,492,2011-12
0070511,0070011,Berlin School District,Mary E. Griswold School,273,304,577,2011-12
0070111,0070011,Berlin School District,Richard D. Hubbard School,112,129,241,2011-12
0080111,0080011,Bethany School District,Bethany Community School,240,251,491,2011-12
0090411,0090011,Bethel School District,Anna H. Rockwell School,180,209,389,2011-12
0096111,0090011,Bethel School District,Bethel High School,477,472,949,2011-12
0095111,0090011,Bethel School District,Bethel Middle School,325,368,693,2011-12
0090111,0090011,Bethel School District,Frank A. Berry School,232,261,493,2011-12
0090511,0090011,Bethel School District,Ralph M. T. Johnson School,216,231,447,2011-12
0116111,0110011,Bloomfield School District,Bloomfield High School,292,311,603,2011-12
0110711,0110011,Bloomfield School District,Carmen Arace Intermediate School,123,140,263,2011-12
0115211,0110011,Bloomfield School District,Carmen Arace Middle School,135,151,286,2011-12
0110311,0110011,Bloomfield School District,J. P. Vincent School,135,187,322,2011-12
0110511,0110011,Bloomfield School District,Metacomet School,130,121,251,2011-12
0116211,0110011,Bloomfield School District,The Big Picture High School,65,40,105,2011-12
0110811,0110011,Bloomfield School District,Wintonbury Early Childhood Magnet School,162,159,321,2011-12
0120111,0120011,Bolton School District,Bolton Center School,286,263,549,2011-12
0126111,0120011,Bolton School District,Bolton High School,167,176,343,2011-12
0130111,0130011,Bozrah School District,Fields Memorial School,121,113,234,2011-12
0146111,0140011,Branford School District,Branford High School,562,502,1064,2011-12
0145111,0140011,Branford School District,Francis Walsh Intermediate School,476,544,1020,2011-12
0148011,0140011,Branford School District,Indian Neck School,20,26,46,2011-12
0141611,0140011,Branford School District,John B. Sliney School,188,177,365,2011-12
0141511,0140011,Branford School District,Mary R. Tisko School,202,182,384,2011-12
0141411,0140011,Branford School District,Mary T. Murphy School,203,236,439,2011-12
2850113,2850013,Bridgeport Achievement First District,Achievement First Bridgeport Academy,256,287,543,2011-12
0150111,0150011,Bridgeport School District,Barnum School,316,343,659,2011-12
0156111,0150011,Bridgeport School District,Bassick High School,509,564,1073,2011-12
0150211,0150011,Bridgeport School District,Beardsley School,187,201,388,2011-12
0150311,0150011,Bridgeport School District,Black Rock School,146,159,305,2011-12
0154011,0150011,Bridgeport School District,Blackham School,524,542,1066,2011-12
0159011,0150011,Bridgeport School District,Bridgeport Learning Center,8,43,51,2011-12
0150411,0150011,Bridgeport School District,Bryant School,185,228,413,2011-12
0156211,0150011,Bridgeport School District,Central High School,1114,1067,2181,2011-12
0151411,0150011,Bridgeport School District,Cesar Batalla School,558,588,1146,2011-12
0152111,0150011,Bridgeport School District,Classical Studies Academy,144,146,290,2011-12
0150511,0150011,Bridgeport School District,Columbus School,262,261,523,2011-12
0153911,0150011,Bridgeport School District,Cross School,212,219,431,2011-12
0154211,0150011,Bridgeport School District,Curiale School,269,346,615,2011-12
0154111,0150011,Bridgeport School District,Dunbar School,176,168,344,2011-12
0150711,0150011,Bridgeport School District,Edison School,125,126,251,2011-12
0153211,0150011,Bridgeport School District,Geraldine Johnson School,427,430,857,2011-12
0151111,0150011,Bridgeport School District,Hall School,152,158,310,2011-12
0151211,0150011,Bridgeport School District,Hallen School,148,187,335,2011-12
0156311,0150011,Bridgeport School District,Harding High School,649,660,1309,2011-12
0154511,0150011,Bridgeport School District,High Horizons Magnet School,232,197,429,2011-12
0151311,0150011,Bridgeport School District,Hooker School,191,225,416,2011-12
0153711,0150011,Bridgeport School District,Interdistrict Discovery Magnet School,149,163,312,2011-12
0152211,0150011,Bridgeport School District,Jettie S. Tisdale School,326,344,670,2011-12
0151911,0150011,Bridgeport School District,Longfellow School,216,238,454,2011-12
0151011,0150011,Bridgeport School District,Luis Munoz Marin School,436,461,897,2011-12
0152011,0150011,Bridgeport School District,Madison School,225,285,510,2011-12
0159511,0150011,Bridgeport School District,Make The Grade,13,26,39,2011-12
0154611,0150011,Bridgeport School District,Multicultural Magnet School,273,211,484,2011-12
0159211,0150011,Bridgeport School District,Park City Academy,0,*,*,2011-12
0151711,0150011,Bridgeport School District,Park City Magnet School,281,242,523,2011-12
0152511,0150011,Bridgeport School District,Read School,404,446,850,2011-12
0152611,0150011,Bridgeport School District,Roosevelt School,263,271,534,2011-12
0154411,0150011,Bridgeport School District,Skane Center,81,148,229,2011-12
0153011,0150011,Bridgeport School District,Waltersville School,227,256,483,2011-12
0153611,0150011,Bridgeport School District,Winthrop School,372,357,729,2011-12
0179011,0170011,Bristol School District,Alternative Special Education Program (ASEP),*,*,17,2011-12
0176111,0170011,Bristol School District,Bristol Central High School,633,684,1317,2011-12
0176211,0170011,Bristol School District,Bristol Eastern High School,625,683,1308,2011-12
0175111,0170011,Bristol School District,Chippens Hill Middle School,413,404,817,2011-12
0170711,0170011,Bristol School District,Clara T. O'Connell School,153,195,348,2011-12
0179211,0170011,Bristol School District,Community/Vocational Program,6,9,15,2011-12
0170311,0170011,Bristol School District,Edgewood School,197,195,392,2011-12
0171411,0170011,Bristol School District,Ellen P. Hubbell School,268,292,560,2011-12
0170511,0170011,Bristol School District,Greene-Hills School,174,163,337,2011-12
0171911,0170011,Bristol School District,Ivy Drive School,199,224,423,2011-12
0170611,0170011,Bristol School District,John J. Jennings School,182,205,387,2011-12
0175311,0170011,Bristol School District,Memorial Boulevard Middle School,261,251,512,2011-12
0171711,0170011,Bristol School District,Mountain View School,188,182,370,2011-12
0175211,0170011,Bristol School District,Northeast Middle School,261,299,560,2011-12
0171111,0170011,Bristol School District,South Side School,267,326,593,2011-12
0171211,0170011,Bristol School District,Stafford School,238,255,493,2011-12
0186111,0180011,Brookfield School District,Brookfield High School,509,457,966,2011-12
0180311,0180011,Brookfield School District,Center Elementary School,204,205,409,2011-12
0180411,0180011,Brookfield School District,Huckleberry Hill Elementary School,272,319,591,2011-12
0185311,0180011,Brookfield School District,Whisconier Middle School,443,428,871,2011-12
0190111,0190011,Brooklyn School District,Brooklyn Elementary School,264,270,534,2011-12
0195111,0190011,Brooklyn School District,Brooklyn Middle School,177,219,396,2011-12
0210111,0210011,Canaan School District,Lee H. Kellogg School,47,39,86,2011-12
0220211,0220011,Canterbury School District,Canterbury Elementary School,128,170,298,2011-12
0225111,0220011,Canterbury School District,Dr. Helen Baldwin Middle School,95,122,217,2011-12
0236111,0230011,Canton School District,Canton High School,253,269,522,2011-12
0230311,0230011,Canton School District,Canton Intermediate School,222,186,408,2011-12
0235111,0230011,Canton School District,Canton Middle School,125,133,258,2011-12
0230211,0230011,Canton School District,Cherry Brook Primary School,273,277,550,2011-12
2415114,2410014,Capitol Region Education Council,Academy of Aerospace and Engineering,124,266,390,2011-12
2416514,2410014,Capitol Region Education Council,Academy of Science and Innovation,211,67,278,2011-12
2418114,2410014,Capitol Region Education Council,Discovery Academy,61,89,150,2011-12
2419214,2410014,Capitol Region Education Council,Farmington Valley Regional Diagnostic Center,8,16,24,2011-12
2410114,2410014,Capitol Region Education Council,Glastonbury/East Hartford Magnet School,118,141,259,2011-12
2416314,2410014,Capitol Region Education Council,Great Path Academy at MCC,152,94,246,2011-12
2416414,2410014,Capitol Region Education Council,Greater Hartford Academy of  the Arts High School - Full Time,278,122,400,2011-12
2419414,2410014,Capitol Region Education Council,Integrated Program Models,*,*,*,2011-12
2410414,2410014,Capitol Region Education Council,International Magnet School for Global Citizenship,154,157,311,2011-12
2419014,2410014,Capitol Region Education Council,John J. Allison Polaris Center,10,37,47,2011-12
2419614,2410014,Capitol Region Education Council,Lincoln Academy Regional Interdistrict Collaborative,*,*,8,2011-12
2416114,2410014,Capitol Region Education Council,Metropolitan Learning Center for Global and International Studies,368,351,719,2011-12
2413114,2410014,Capitol Region Education Council,Montessori Magnet School,182,168,350,2011-12
2410514,2410014,Capitol Region Education Council,Museum Academy,150,121,271,2011-12
2415214,2410014,Capitol Region Education Council,Public Safety Academy,134,255,389,2011-12
2410314,2410014,Capitol Region Education Council,Reggio Magnet School of the Arts,136,148,284,2011-12
2419514,2410014,Capitol Region Education Council,River Street Early Learning Center (Site 2),15,43,58,2011-12
2419314,2410014,Capitol Region Education Council,River Street School,22,125,147,2011-12
2419114,2410014,Capitol Region Education Council,Soundbridge,50,47,97,2011-12
2415014,2410014,Capitol Region Education Council,Two Rivers Magnet Middle School,320,364,684,2011-12
2410214,2410014,Capitol Region Education Council,University of Hartford Magnet School,220,221,441,2011-12
0240211,0240011,Chaplin School District,Chaplin Elementary School,90,92,182,2011-12
0250111,0250011,Cheshire School District,Chapman School,154,140,294,2011-12
0256111,0250011,Cheshire School District,Cheshire High School,772,777,1549,2011-12
0250211,0250011,Cheshire School District,Darcey School,164,172,336,2011-12
0255111,0250011,Cheshire School District,Dodd Middle School,356,418,774,2011-12
0250611,0250011,Cheshire School District,Doolittle School,271,266,537,2011-12
0250411,0250011,Cheshire School District,Highland School,387,408,795,2011-12
0259011,0250011,Cheshire School District,Humiston School,8,17,25,2011-12
0250511,0250011,Cheshire School District,Norton School,254,226,480,2011-12
0260111,0260011,Chester School District,Chester Elementary School,141,119,260,2011-12
0270111,0270011,Clinton School District,Abraham Pierson School,157,157,314,2011-12
0275111,0270011,Clinton School District,Jared Eliot School,243,223,466,2011-12
0270311,0270011,Clinton School District,Lewin G. Joel Jr. School,302,356,658,2011-12
0276111,0270011,Clinton School District,The Morgan School,270,295,565,2011-12
0286111,0280011,Colchester School District,Bacon Academy,525,458,983,2011-12
0280411,0280011,Colchester School District,Colchester Elementary School,311,369,680,2011-12
0280211,0280011,Colchester School District,Jack Jackter Intermediate School,307,347,654,2011-12
0285111,0280011,Colchester School District,William J. Johnston Middle School,357,343,700,2011-12
0290111,0290011,Colebrook School District,Colebrook Consolidated School,51,48,99,2011-12
0300111,0300011,Columbia School District,Horace W. Porter School,270,254,524,2011-12
2686113,2680013,Common Ground High School District,Common Ground High School,72,93,165,2011-12
9001516,9000016,Connecticut Technical High School System,A. I. Prince Technical High School,417,338,755,2011-12
9001116,9000016,Connecticut Technical High School System,Bullard-Havens Technical High School,456,418,874,2011-12
9001916,9000016,Connecticut Technical High School System,E. C. Goodwin Technical High School,241,377,618,2011-12
9001416,9000016,Connecticut Technical High School System,Eli Whitney Technical High School,246,275,521,2011-12
9002716,9000016,Connecticut Technical High School System,Ella T. Grasso Southeastern Technical High School,226,343,569,2011-12
9002516,9000016,Connecticut Technical High School System,Emmett O'Brien Technical High School,148,398,546,2011-12
9001716,9000016,Connecticut Technical High School System,H. C. Wilcox Technical High School,301,471,772,2011-12
9001316,9000016,Connecticut Technical High School System,H. H. Ellis Technical High School,114,426,540,2011-12
9001216,9000016,Connecticut Technical High School System,Henry Abbott Technical High School,215,423,638,2011-12
9001616,9000016,Connecticut Technical High School System,Howell Cheney Technical High School,167,506,673,2011-12
9002016,9000016,Connecticut Technical High School System,Norwich Technical High School,240,416,656,2011-12
9002216,9000016,Connecticut Technical High School System,Oliver Wolcott Technical High School,229,440,669,2011-12
9002616,9000016,Connecticut Technical High School System,Platt Technical High School,315,570,885,2011-12
9001816,9000016,Connecticut Technical High School System,Vinal Technical High School,175,432,607,2011-12
9002316,9000016,Connecticut Technical High School System,W. F. Kaynor Technical High School,338,423,761,2011-12
9002416,9000016,Connecticut Technical High School System,Windham Technical High School,204,368,572,2011-12
2439214,2430014,Cooperative Educational Services,Developmental Learning Center (DLC),22,68,90,2011-12
2439114,2430014,Cooperative Educational Services,Preschool-Primary Learning Center (PLC),14,37,51,2011-12
2439314,2430014,Cooperative Educational Services,RISE Transitional Program,*,*,11,2011-12
2438014,2430014,Cooperative Educational Services,School Readiness,31,20,51,2011-12
2430114,2430014,Cooperative Educational Services,Six-Six Magnet School,226,237,463,2011-12
2439414,2430014,Cooperative Educational Services,Therapeutic Day Program,23,124,147,2011-12
0310111,0310011,Cornwall School District,Cornwall Consolidated School,50,56,106,2011-12
0325111,0320011,Coventry School District,Capt. Nathan Hale School,212,240,452,2011-12
0328011,0320011,Coventry School District,Coventry Early Intervention Services,6,17,23,2011-12
0320211,0320011,Coventry School District,Coventry Grammar School,203,177,380,2011-12
0326111,0320011,Coventry School District,Coventry High School,265,259,524,2011-12
0320411,0320011,Coventry School District,George Hersey Robertson School,211,190,401,2011-12
0336111,0330011,Cromwell School District,Cromwell High School,275,271,546,2011-12
0335111,0330011,Cromwell School District,Cromwell Middle School,236,264,500,2011-12
0330211,0330011,Cromwell School District,Edna C. Stevens School,224,256,480,2011-12
0330311,0330011,Cromwell School District,Woodside Intermediate School,208,248,456,2011-12
0346211,0340011,Danbury School District,Alternative Center For Excellence,41,50,91,2011-12
0345111,0340011,Danbury School District,Broadview Middle School,528,594,1122,2011-12
0346111,0340011,Danbury School District,Danbury High School,1423,1466,2889,2011-12
0341411,0340011,Danbury School District,Ellsworth Avenue School,174,204,378,2011-12
0341111,0340011,Danbury School District,Great Plain School,161,153,314,2011-12
0340211,0340011,Danbury School District,Hayestown Avenue School,204,192,396,2011-12
0341711,0340011,Danbury School District,King Street Intermediate School,190,182,372,2011-12
0341311,0340011,Danbury School District,King Street Primary School,206,209,415,2011-12
0341811,0340011,Danbury School District,Mill Ridge Educational Center,46,102,148,2011-12
0340511,0340011,Danbury School District,Mill Ridge Primary School,211,215,426,2011-12
0340611,0340011,Danbury School District,Morris Street School,198,208,406,2011-12
0340811,0340011,Danbury School District,Park Avenue School,202,224,426,2011-12
0341511,0340011,Danbury School District,Pembroke School,182,184,366,2011-12
0345211,0340011,Danbury School District,Rogers Park Middle School,546,564,1110,2011-12
0341211,0340011,Danbury School District,Shelter Rock School,201,218,419,2011-12
0341011,0340011,Danbury School District,South Street School,164,179,343,2011-12
0341611,0340011,Danbury School District,Stadley Rough School,245,222,467,2011-12
0341911,0340011,Danbury School District,Western CT Academy of International Studies Elementary Magnet School,188,201,389,2011-12
0356111,0350011,Darien School District,Darien High School,682,633,1315,2011-12
0350211,0350011,Darien School District,Hindley Elementary School,268,302,570,2011-12
0350711,0350011,Darien School District,Holmes Elementary School,211,208,419,2011-12
0355111,0350011,Darien School District,Middlesex Middle School,534,620,1154,2011-12
0351311,0350011,Darien School District,Ox Ridge Elementary School,214,251,465,2011-12
0350511,0350011,Darien School District,Royle Elementary School,191,218,409,2011-12
0350611,0350011,Darien School District,Tokeneke Elementary School,235,248,483,2011-12
0360111,0360011,Deep River School District,Deep River Elementary School,183,174,357,2011-12
3370215,3370015,Department of Mental Health and Addiction Services,Connecticut Valley Hospital,*,*,*,2011-12
0370611,0370011,Derby School District,Bradley School,172,179,351,2011-12
0376111,0370011,Derby School District,Derby High School,164,195,359,2011-12
0375011,0370011,Derby School District,Derby Middle School,156,178,334,2011-12
0370411,0370011,Derby School District,Irving School,196,206,402,2011-12
0400111,0400011,East Granby School District,Allgrove School,98,140,238,2011-12
0406111,0400011,East Granby School District,East Granby High School,122,141,263,2011-12
0405111,0400011,East Granby School District,East Granby Middle School,112,104,216,2011-12
0400211,0400011,East Granby School District,R. Dudley Seymour School,69,60,129,2011-12
0410111,0410011,East Haddam School District,East Haddam Elementary School,181,190,371,2011-12
0416111,0410011,East Haddam School District,Nathan Hale-Ray High School,208,198,406,2011-12
0415111,0410011,East Haddam School District,Nathan Hale-Ray Middle School,246,251,497,2011-12
0420311,0420011,East Hampton School District,Center School,138,165,303,2011-12
0426111,0420011,East Hampton School District,East Hampton High School,282,268,550,2011-12
0425111,0420011,East Hampton School District,East Hampton Middle School,247,222,469,2011-12
0420111,0420011,East Hampton School District,Memorial School,300,321,621,2011-12
0429011,0420011,East Hampton School District,The Learning Center at East Hampton,*,*,*,2011-12
0430911,0430011,East Hartford School District,Anna E. Norris School,141,133,274,2011-12
0436311,0430011,East Hartford School District,Connecticut IB Academy,126,62,188,2011-12
0430611,0430011,East Hartford School District,Dr. Franklin H. Mayberry School,194,207,401,2011-12
0432211,0430011,East Hartford School District,Dr. John A. Langford School,169,212,381,2011-12
0431011,0430011,East Hartford School District,Dr. Thomas S. O'Connell School,134,179,313,2011-12
0436211,0430011,East Hartford School District,East Hartford High School,842,890,1732,2011-12
0435111,0430011,East Hartford School District,East Hartford Middle School,524,527,1051,2011-12
0432011,0430011,East Hartford School District,Governor William Pitkin School,166,195,361,2011-12
0430511,0430011,East Hartford School District,Hockanum School,152,145,297,2011-12
0430411,0430011,East Hartford School District,Joseph O. Goodwin School,174,174,348,2011-12
0431811,0430011,East Hartford School District,Robert J. O'Brien School,240,307,547,2011-12
0431211,0430011,East Hartford School District,Silver Lane School,149,138,287,2011-12
0436411,0430011,East Hartford School District,Stevens Alternate High School,47,104,151,2011-12
0432411,0430011,East Hartford School District,Sunset Ridge Middle School,232,172,404,2011-12
0438011,0430011,East Hartford School District,Willowbrook Early Childhood,104,129,233,2011-12
0439011,0430011,East Hartford School District,Woodland School,32,154,186,2011-12
0441711,0440011,East Haven School District,Carbone School/East Haven Academy,170,115,285,2011-12
0441411,0440011,East Haven School District,D. C. Moore School,131,135,266,2011-12
0440111,0440011,East Haven School District,Deer Run School,143,162,305,2011-12
0441311,0440011,East Haven School District,Dominick H. Ferrara School,117,134,251,2011-12
0446111,0440011,East Haven School District,East Haven High School,437,448,885,2011-12
0441011,0440011,East Haven School District,Grove J. Tuttle School,81,115,196,2011-12
0445111,0440011,East Haven School District,Joseph Melillo Middle School,306,341,647,2011-12
0440711,0440011,East Haven School District,Momauguin School,73,93,166,2011-12
0441811,0440011,East Haven School District,Overbrook Elementary School,125,111,236,2011-12
0449011,0440011,East Haven School District,Pathways,*,*,36,2011-12
0456111,0450011,East Lyme School District,East Lyme High School,591,571,1162,2011-12
0455111,0450011,East Lyme School District,East Lyme Middle School,433,421,854,2011-12
0450111,0450011,East Lyme School District,Flanders School,174,188,362,2011-12
0458011,0450011,East Lyme School District,Integrated Preschool,16,35,51,2011-12
0450411,0450011,East Lyme School District,Lillie B. Haynes School,169,169,338,2011-12
0450211,0450011,East Lyme School District,Niantic Center School,107,104,211,2011-12
0470111,0470011,East Windsor School District,Broad Brook Elementary School,258,274,532,2011-12
0476111,0470011,East Windsor School District,East Windsor High School,188,186,374,2011-12
0475411,0470011,East Windsor School District,East Windsor Middle School,184,194,378,2011-12
2536014,2530014,Eastern Connecticut Regional Educational Service Center (EASTCONN),Arts at the Capitol Theater Magnet School (ACT),84,42,126,2011-12
2539014,2530014,Eastern Connecticut Regional Educational Service Center (EASTCONN),EastConn Special Education,9,50,59,2011-12
2536114,2530014,Eastern Connecticut Regional Educational Service Center (EASTCONN),Quinebaug Middle College,55,55,110,2011-12
0390111,0390011,Eastford School District,Eastford Elementary School,79,97,176,2011-12
0465111,0460011,Easton School District,Helen Keller Middle School,179,212,391,2011-12
0460111,0460011,Easton School District,Samuel Staples Elementary School,301,365,666,2011-12
2428014,2420014,EdAdvance,EdAdvance Headstart,94,103,197,2011-12
2429014,2420014,EdAdvance,The ACCESS School at The Danuta M. Thibodeau Education Center,7,17,24,2011-12
0480111,0480011,Ellington School District,Center School,215,233,448,2011-12
0480211,0480011,Ellington School District,Crystal Lake School,102,115,217,2011-12
0486111,0480011,Ellington School District,Ellington High School,401,399,800,2011-12
0485111,0480011,Ellington School District,Ellington Middle School,222,199,421,2011-12
0480711,0480011,Ellington School District,Windermere Intermediate School,205,214,419,2011-12
0480611,0480011,Ellington School District,Windermere School,217,225,442,2011-12
2890113,2890013,Elm City College Preparatory School District,Elm City College Preparatory School,315,285,600,2011-12
0491311,0490011,Enfield School District,Edgar H. Parkman School,187,214,401,2011-12
0491611,0490011,Enfield School District,Eli Whitney School,187,229,416,2011-12
0496111,0490011,Enfield School District,Enfield High School,353,391,744,2011-12
0490211,0490011,Enfield School District,Enfield Street School,165,135,300,2011-12
0499011,0490011,Enfield School District,Enfield Transitional Learning Academy,*,*,10,2011-12
0496211,0490011,Enfield School District,Enrico Fermi High School,527,531,1058,2011-12
0490411,0490011,Enfield School District,Hazardville Memorial School,163,203,366,2011-12
0498011,0490011,Enfield School District,Head Start Program,53,51,104,2011-12
0491811,0490011,Enfield School District,Henry Barnard School,175,187,362,2011-12
0495211,0490011,Enfield School District,John F. Kennedy Middle School,588,613,1201,2011-12
0491111,0490011,Enfield School District,Nathan Hale School,128,130,258,2011-12
0491511,0490011,Enfield School District,Prudence Crandall School,203,230,433,2011-12
0500111,0500011,Essex School District,Essex Elementary School,271,287,558,2011-12
2726113,2720013,Explorations District,Explorations,39,35,74,2011-12
0510211,0510011,Fairfield School District,Burr Elementary School,212,231,443,2011-12
0510111,0510011,Fairfield School District,Dwight Elementary School,151,140,291,2011-12
0518011,0510011,Fairfield School District,Early Childhood Center,44,86,130,2011-12
0516011,0510011,Fairfield School District,Fairfield Ludlowe High School,838,699,1537,2011-12
0516211,0510011,Fairfield School District,Fairfield Warde High School,673,680,1353,2011-12
0515211,0510011,Fairfield School District,Fairfield Woods Middle School,375,394,769,2011-12
0510411,0510011,Fairfield School District,Holland Hill School,178,174,352,2011-12
0511711,0510011,Fairfield School District,Jennings School,154,207,361,2011-12
0510611,0510011,Fairfield School District,McKinley School,223,230,453,2011-12
0510711,0510011,Fairfield School District,Mill Hill School,219,240,459,2011-12
0511611,0510011,Fairfield School District,North Stratfield School,242,243,485,2011-12
0511811,0510011,Fairfield School District,Osborn Hill School,250,292,542,2011-12
0511211,0510011,Fairfield School District,Riverfield School,200,219,419,2011-12
0515311,0510011,Fairfield School District,Roger Ludlowe Middle School,496,501,997,2011-12
0511311,0510011,Fairfield School District,Sherman School,229,227,456,2011-12
0511411,0510011,Fairfield School District,Stratfield School,241,270,511,2011-12
0515111,0510011,Fairfield School District,Tomlinson Middle School,359,397,756,2011-12
0520411,0520011,Farmington School District,East Farms School,227,237,464,2011-12
0528011,0520011,Farmington School District,Farmington Collaborative PK,31,38,69,2011-12
0526111,0520011,Farmington School District,Farmington High School,624,669,1293,2011-12
0525111,0520011,Farmington School District,Irving A. Robbins Middle School,304,348,652,2011-12
0520211,0520011,Farmington School District,Noah Wallace School,163,178,341,2011-12
0520111,0520011,Farmington School District,Union School,160,147,307,2011-12
0520311,0520011,Farmington School District,West District School,167,180,347,2011-12
0520511,0520011,Farmington School District,West Woods Upper Elementary School,263,312,575,2011-12
0530111,0530011,Franklin School District,Franklin Elementary School,95,109,204,2011-12
0540211,0540011,Glastonbury School District,Buttonball Lane School,277,268,545,2011-12
0540311,0540011,Glastonbury School District,Eastbury School,136,184,320,2011-12
0540811,0540011,Glastonbury School District,Gideon Welles School,254,252,506,2011-12
0546111,0540011,Glastonbury School District,Glastonbury High School,1105,1099,2204,2011-12
0540411,0540011,Glastonbury School District,Hebron Avenue School,236,230,466,2011-12
0540611,0540011,Glastonbury School District,Hopewell School,227,254,481,2011-12
0540711,0540011,Glastonbury School District,Naubuc School,243,208,451,2011-12
0540911,0540011,Glastonbury School District,Nayaug Elementary School,339,307,646,2011-12
0545211,0540011,Glastonbury School District,Smith Middle School,545,531,1076,2011-12
0560111,0560011,Granby School District,Frank M. Kearns Primary School,193,199,392,2011-12
0566111,0560011,Granby School District,Granby Memorial High School,386,370,756,2011-12
0565111,0560011,Granby School District,Granby Memorial Middle School,160,196,356,2011-12
0560411,0560011,Granby School District,Kelly Lane Primary School,154,173,327,2011-12
0560311,0560011,Granby School District,Wells Road Intermediate School,163,164,327,2011-12
0575111,0570011,Greenwich School District,Central Middle School,292,312,604,2011-12
0570211,0570011,Greenwich School District,Cos Cob School,207,195,402,2011-12
0575211,0570011,Greenwich School District,Eastern Middle School,379,395,774,2011-12
0570411,0570011,Greenwich School District,Glenville School,188,197,385,2011-12
0576111,0570011,Greenwich School District,Greenwich High School,1299,1357,2656,2011-12
0570511,0570011,Greenwich School District,Hamilton Avenue School,205,208,413,2011-12
0571311,0570011,Greenwich School District,International School At Dundee,191,175,366,2011-12
0570311,0570011,Greenwich School District,Julian Curtiss School,162,181,343,2011-12
0570611,0570011,Greenwich School District,New Lebanon School,115,146,261,2011-12
0570711,0570011,Greenwich School District,North Mianus School,233,228,461,2011-12
0570811,0570011,Greenwich School District,North Street School,204,234,438,2011-12
0570911,0570011,Greenwich School District,Old Greenwich School,218,210,428,2011-12
0571111,0570011,Greenwich School District,Parkway School,115,153,268,2011-12
0571011,0570011,Greenwich School District,Riverside School,222,300,522,2011-12
0575311,0570011,Greenwich School District,Western Middle School,221,253,474,2011-12
0580311,0580011,Griswold School District,Griswold Elementary School,360,367,727,2011-12
0586211,0580011,Griswold School District,Griswold High School,331,321,652,2011-12
0585111,0580011,Griswold School District,Griswold Middle School,275,311,586,2011-12
0595311,0590011,Groton School District,Carl C. Cutler Middle School,180,175,355,2011-12
0592011,0590011,Groton School District,Catherine Kolnaski Magnet School,233,253,486,2011-12
0591811,0590011,Groton School District,Charles Barnum School,219,173,392,2011-12
0590311,0590011,Groton School District,Claude Chester School,163,171,334,2011-12
0595111,0590011,Groton School District,Fitch Middle School,180,227,407,2011-12
0591711,0590011,Groton School District,Mary Morrisson School,175,198,373,2011-12
0591911,0590011,Groton School District,Northeast Academy Elementary School,201,224,425,2011-12
0591211,0590011,Groton School District,Pleasant Valley School,168,188,356,2011-12
0596111,0590011,Groton School District,Robert E. Fitch High School,608,629,1237,2011-12
0590111,0590011,Groton School District,S. B. Butler School,158,163,321,2011-12
0595211,0590011,Groton School District,West Side Middle School,124,144,268,2011-12
0600711,0600011,Guilford School District,A. Baldwin Middle School,299,286,585,2011-12
0600611,0600011,Guilford School District,A. W. Cox School,153,160,313,2011-12
0600411,0600011,Guilford School District,Calvin Leete School,156,171,327,2011-12
0605111,0600011,Guilford School District,E. C. Adams Middle School,244,307,551,2011-12
0606111,0600011,Guilford School District,Guilford High School,579,552,1131,2011-12
0600211,0600011,Guilford School District,Guilford Lakes School,187,202,389,2011-12
0600311,0600011,Guilford School District,Melissa Jones School,172,188,360,2011-12
0628011,0620011,Hamden School District,Alice Peck Learning Center,31,58,89,2011-12
0621211,0620011,Hamden School District,Bear Path School,238,230,468,2011-12
0620211,0620011,Hamden School District,Church Street School,203,203,406,2011-12
0620311,0620011,Hamden School District,Dunbar Hill School,157,164,321,2011-12
0626111,0620011,Hamden School District,Hamden High School,901,952,1853,2011-12
0625211,0620011,Hamden School District,Hamden Middle School,447,460,907,2011-12
0620411,0620011,Hamden School District,Helen Street School,108,159,267,2011-12
0621111,0620011,Hamden School District,Ridge Hill School,141,180,321,2011-12
0620111,0620011,Hamden School District,Shepherd Glen School,154,183,337,2011-12
0621011,0620011,Hamden School District,Spring Glen School,191,203,394,2011-12
0621411,0620011,Hamden School District,West Woods School,239,237,476,2011-12
0630111,0630011,Hampton School District,Hampton Elementary School,47,79,126,2011-12
0640711,0640011,Hartford School District,Asian Studies Academy at Bellizzi School,207,242,449,2011-12
0640411,0640011,Hartford School District,Batchelder School,259,306,565,2011-12
0642811,0640011,Hartford School District,Betances Early Reading Lab Magnet School,150,165,315,2011-12
0643511,0640011,Hartford School District,Breakthrough II Magnet School,91,80,171,2011-12
0643311,0640011,Hartford School District,Breakthrough Magnet School,182,173,355,2011-12
0647111,0640011,Hartford School District,Bulkeley High School,185,214,399,2011-12
0646111,0640011,Hartford School District,Bulkeley High School Lower School,265,360,625,2011-12
0640611,0640011,Hartford School District,Burns Latino Studies Academy,304,292,596,2011-12
0642311,0640011,Hartford School District,Burr School,386,421,807,2011-12
0646911,0640011,Hartford School District,Capital Preparatory Magnet School,281,240,521,2011-12
0642411,0640011,Hartford School District,Clark School,189,208,397,2011-12
0646411,0640011,Hartford School District,Classical Magnet School,428,286,714,2011-12
0646011,0640011,Hartford School District,Culinary Arts Academy at Weaver High School,146,151,297,2011-12
0645311,0640011,Hartford School District,Dr. Joseph Bellizzi Middle School,68,78,146,2011-12
0640911,0640011,Hartford School District,Environmental Sciences Magnet at Hooker School,162,196,358,2011-12
0643211,0640011,Hartford School District,Expeditionary Learning Academy at Moylan School,361,388,749,2011-12
0643611,0640011,Hartford School District,Global Communications Academy,215,202,417,2011-12
0647211,0640011,Hartford School District,HPHS Engineering and Green Technology Academy,126,307,433,2011-12
0647311,0640011,Hartford School District,HPHS Freshmen Academy,110,111,221,2011-12
0647411,0640011,Hartford School District,HPHS Law and Government Academy,209,187,396,2011-12
0647511,0640011,Hartford School District,HPHS Nursing and Health Sciences Academy,254,124,378,2011-12
0645411,0640011,Hartford School District,Hartford Magnet Trinity College Academy,384,332,716,2011-12
0649011,0640011,Hartford School District,Hartford Transitional Learning Academy (Elementary),*,*,32,2011-12
0647611,0640011,Hartford School District,"High School, Inc.",148,173,321,2011-12
0647711,0640011,Hartford School District,Journalism and Media Academy Magnet School,145,172,317,2011-12
0641011,0640011,Hartford School District,Kennelly School,402,397,799,2011-12
0641111,0640011,Hartford School District,Kinsella Magnet School of Performing Arts,404,286,690,2011-12
0640811,0640011,Hartford School District,M. D. Fox School,225,254,479,2011-12
0641611,0640011,Hartford School District,"M. L. King, Jr. School",195,206,401,2011-12
0641211,0640011,Hartford School District,McDonough Middle School,198,253,451,2011-12
0641911,0640011,Hartford School District,Milner School,210,212,422,2011-12
0643711,0640011,Hartford School District,Montessori Magnet at Fisher School,119,121,240,2011-12
0641411,0640011,Hartford School District,Naylor/CCSU Leadership Academy,354,350,704,2011-12
0647811,0640011,Hartford School District,OPPortunity High School,57,59,116,2011-12
0641511,0640011,Hartford School District,Parkville Community School,267,264,531,2011-12
0646611,0640011,Hartford School District,Pathways Academy of Technology and Design,120,207,327,2011-12
0641711,0640011,Hartford School District,Rawson School,193,259,452,2011-12
0644011,0640011,Hartford School District,Renzulli Gifted and Talented Academy,62,43,105,2011-12
0640111,0640011,Hartford School District,SAND School,236,235,471,2011-12
0642511,0640011,Hartford School District,STEM Magnet at Fisher School,126,218,344,2011-12
0643011,0640011,Hartford School District,Sanchez School,228,241,469,2011-12
0645611,0640011,Hartford School District,Sarah J Rawson Middle Grades Academy,86,116,202,2011-12
0642611,0640011,Hartford School District,Simpson-Waverly School,175,172,347,2011-12
0646511,0640011,Hartford School District,Sports and Medical Sciences Academy,324,313,637,2011-12
0646711,0640011,Hartford School District,University High School of Science and Engineering,139,250,389,2011-12
0642011,0640011,Hartford School District,Webster Micro Society Magnet School,268,314,582,2011-12
0642111,0640011,Hartford School District,West Middle School,310,347,657,2011-12
0642211,0640011,Hartford School District,Wish Museum School,198,194,392,2011-12
0650111,0650011,Hartland School District,Hartland School,100,125,225,2011-12
0670211,0670011,Hebron School District,Gilead Hill School,189,211,400,2011-12
0670111,0670011,Hebron School District,Hebron Elementary School,310,338,648,2011-12
2860113,2860013,Highville Charter School District,Highville Charter School,179,158,337,2011-12
2640113,2640013,Integrated Day Charter School District,Integrated Day Charter School,162,168,330,2011-12
2655113,2650013,Interdistrict School for Arts and Comm District,Interdistrict School For Arts And Communication,107,84,191,2011-12
2610113,2610013,Jumoke Academy District,Jumoke Academy,279,209,488,2011-12
0680111,0680011,Kent School District,Kent Center School,130,148,278,2011-12
0698011,0690011,Killingly School District,Goodyear Early Childhood Center,39,61,100,2011-12
0690111,0690011,Killingly School District,Killingly Central School,240,253,493,2011-12
0696111,0690011,Killingly School District,Killingly High School,436,386,822,2011-12
0695211,0690011,Killingly School District,Killingly Intermediate School,386,426,812,2011-12
0690311,0690011,Killingly School District,Killingly Memorial School,222,227,449,2011-12
2456014,2450014,Learn,Connecticut River Academy,137,109,246,2011-12
2455014,2450014,Learn,Dual Language & Arts Magnet Middle School,46,36,82,2011-12
2459014,2450014,Learn,Learn Special Education,*,*,28,2011-12
2456114,2450014,Learn,Marine Science Magnet High School of Southeastern Connecticut,48,62,110,2011-12
2450114,2450014,Learn,Regional Multicultural Magnet School,275,264,539,2011-12
2450214,2450014,Learn,The Friendship School,254,255,509,2011-12
0710111,0710011,Lebanon School District,Lebanon Elementary School,224,228,452,2011-12
0715111,0710011,Lebanon School District,Lebanon Middle School,173,213,386,2011-12
0716211,0710011,Lebanon School District,Lyman Memorial High School,260,185,445,2011-12
0720211,0720011,Ledyard School District,Gales Ferry School,117,107,224,2011-12
0720411,0720011,Ledyard School District,Gallup Hill School,165,187,352,2011-12
0720311,0720011,Ledyard School District,Juliet W. Long School,120,150,270,2011-12
0720111,0720011,Ledyard School District,Ledyard Center School,186,227,413,2011-12
0726111,0720011,Ledyard School District,Ledyard High School,484,450,934,2011-12
0725111,0720011,Ledyard School District,Ledyard Middle School,206,184,390,2011-12
0736011,0730011,Lisbon School District,Community Connection - The Big Picture High School,8,16,24,2011-12
0730111,0730011,Lisbon School District,Lisbon Central School,212,241,453,2011-12
0740211,0740011,Litchfield School District,Center School,157,159,316,2011-12
0746111,0740011,Litchfield School District,Litchfield High School,273,270,543,2011-12
0740311,0740011,Litchfield School District,Litchfield Intermediate School,133,130,263,2011-12
0766111,0760011,Madison School District,Daniel Hand High School,642,615,1257,2011-12
0760611,0760011,Madison School District,Dr. Robert H. Brown Middle School,263,278,541,2011-12
0760211,0760011,Madison School District,Island Avenue Elementary School,133,152,285,2011-12
0760111,0760011,Madison School District,J. Milton Jeffrey Elementary School,211,262,473,2011-12
0760311,0760011,Madison School District,Kathleen H. Ryerson Elementary School,125,125,250,2011-12
0769011,0760011,Madison School District,Town Campus Learning Center,16,24,40,2011-12
0765211,0760011,Madison School District,Walter C. Polson Upper Middle School,292,313,605,2011-12
0770911,0770011,Manchester School District,Nathan Hale School,135,152,287,2011-12
0770111,0770011,Manchester School District,Bowers School,190,211,401,2011-12
0770311,0770011,Manchester School District,Buckley School,206,232,438,2011-12
0771711,0770011,Manchester School District,Elisabeth M. Bennet Academy,166,245,411,2011-12
0775311,0770011,Manchester School District,Illing Middle School,403,433,836,2011-12
0770611,0770011,Manchester School District,Keeney School,163,164,327,2011-12
0776111,0770011,Manchester School District,Manchester High School,871,908,1779,2011-12
0778011,0770011,Manchester School District,Manchester Preschool Center,98,96,194,2011-12
0779011,0770011,Manchester School District,Manchester Regional Academy,23,70,93,2011-12
0779111,0770011,Manchester School District,Manchester Transition Center,*,*,9,2011-12
0771611,0770011,Manchester School District,Martin School,123,129,252,2011-12
0771011,0770011,Manchester School District,Robertson School,174,201,375,2011-12
0771211,0770011,Manchester School District,Verplanck School,160,198,358,2011-12
0771311,0770011,Manchester School District,Waddell School,158,185,343,2011-12
0771411,0770011,Manchester School District,Washington School,153,149,302,2011-12
0780411,0780011,Mansfield School District,Annie E. Vinton School,127,142,269,2011-12
0780211,0780011,Mansfield School District,Dorothy C. Goodwin School,98,125,223,2011-12
0785111,0780011,Mansfield School District,Mansfield Middle School,295,280,575,2011-12
0780511,0780011,Mansfield School District,Southeast Elementary School,115,142,257,2011-12
0790111,0790011,Marlborough School District,Elmer Thienes-Mary Hall Elementary School,329,343,672,2011-12
0800711,0800011,Meriden School District,Nathan Hale School,300,308,608,2011-12
0800111,0800011,Meriden School District,Benjamin Franklin School,215,280,495,2011-12
0801111,0800011,Meriden School District,Casimir Pulaski School,355,350,705,2011-12
0806111,0800011,Meriden School District,Francis T. Maloney High School,620,639,1259,2011-12
0800311,0800011,Meriden School District,Hanover School,240,281,521,2011-12
0800411,0800011,Meriden School District,Israel Putnam School,252,286,538,2011-12
0800511,0800011,Meriden School District,John Barry School,258,252,510,2011-12
0805211,0800011,Meriden School District,Lincoln Middle School,339,384,723,2011-12
0806211,0800011,Meriden School District,Orville H. Platt High School,539,561,1100,2011-12
0800811,0800011,Meriden School District,Roger Sherman School,260,270,530,2011-12
0801011,0800011,Meriden School District,Thomas Hooker School,215,212,427,2011-12
0805411,0800011,Meriden School District,Washington Middle School,382,454,836,2011-12
0830211,0830011,Middletown School District,Bielefield School,167,166,333,2011-12
0830511,0830011,Middletown School District,Farm Hill School,172,180,352,2011-12
0831511,0830011,Middletown School District,Keigwin Middle School,156,192,348,2011-12
0831311,0830011,Middletown School District,Lawrence School,171,179,350,2011-12
0830911,0830011,Middletown School District,MacDonough School,127,135,262,2011-12
0836211,0830011,Middletown School District,Middletown High School,655,659,1314,2011-12
0831211,0830011,Middletown School District,Moody School,160,178,338,2011-12
0831111,0830011,Middletown School District,Snow School,170,198,368,2011-12
0830111,0830011,Middletown School District,Spencer School,168,167,335,2011-12
0839111,0830011,Middletown School District,Transition to Life Center,*,*,7,2011-12
0831411,0830011,Middletown School District,Wesley School,166,162,328,2011-12
0835411,0830011,Middletown School District,Woodrow Wilson Middle School,338,367,705,2011-12
0840111,0840011,Milford School District,Calf Pen Meadow School,154,156,310,2011-12
0845111,0840011,Milford School District,East Shore Middle School,221,281,502,2011-12
0845211,0840011,Milford School District,Harborside Middle School,283,324,607,2011-12
0841911,0840011,Milford School District,J. F. Kennedy School,202,222,424,2011-12
0846211,0840011,Milford School District,Jonathan Law High School,493,523,1016,2011-12
0846311,0840011,Milford School District,Joseph A. Foran High School,505,488,993,2011-12
0841611,0840011,Milford School District,Live Oaks School,149,156,305,2011-12
0841711,0840011,Milford School District,Mathewson School,184,221,405,2011-12
0840711,0840011,Milford School District,Meadowside School,223,265,488,2011-12
0840811,0840011,Milford School District,Orange Avenue School,202,199,401,2011-12
0841811,0840011,Milford School District,Orchard Hills School,184,199,383,2011-12
0841011,0840011,Milford School District,Pumpkin Delight School,187,205,392,2011-12
0845311,0840011,Milford School District,West Shore Middle School,283,297,580,2011-12
0850511,0850011,Monroe School District,Fawn Hollow Elementary School,253,303,556,2011-12
0855211,0850011,Monroe School District,Jockey Hollow School,420,468,888,2011-12
0856111,0850011,Monroe School District,Masuk High School,621,651,1272,2011-12
0850111,0850011,Monroe School District,Monroe Elementary School,184,196,380,2011-12
0850311,0850011,Monroe School District,Stepney Elementary School,241,244,485,2011-12
0860711,0860011,Montville School District,Dr. Charles E. Murphy School,168,195,363,2011-12
0865111,0860011,Montville School District,Leonard J. Tyl Middle School,319,319,638,2011-12
0860111,0860011,Montville School District,Mohegan School,202,174,376,2011-12
0866111,0860011,Montville School District,Montville High School,368,404,772,2011-12
0860511,0860011,Montville School District,Oakdale School,187,207,394,2011-12
0869011,0860011,Montville School District,Palmer Academy,9,17,26,2011-12
0880811,0880011,Naugatuck School District,Andrew Avenue School,91,103,194,2011-12
0888211,0880011,Naugatuck School District,Central Avenue Preschool,*,*,20,2011-12
0880111,0880011,Naugatuck School District,Central Avenue School,117,119,236,2011-12
0885111,0880011,Naugatuck School District,City Hill Middle School,332,377,709,2011-12
0880211,0880011,Naugatuck School District,Cross Street Intermediate School,146,138,284,2011-12
0888111,0880011,Naugatuck School District,Head Start,55,50,105,2011-12
0880411,0880011,Naugatuck School District,Hillside Intermediate School,195,213,408,2011-12
0880511,0880011,Naugatuck School District,Hop Brook Elementary School,158,181,339,2011-12
0880311,0880011,Naugatuck School District,Maple Hill School,161,198,359,2011-12
0886111,0880011,Naugatuck School District,Naugatuck High School,659,685,1344,2011-12
0880611,0880011,Naugatuck School District,Salem School,105,124,229,2011-12
0880711,0880011,Naugatuck School District,Western School,134,158,292,2011-12
2800113,2800013,New Beginnings Inc Family Academy District,New Beginnings Inc Family Academy,197,164,361,2011-12
0899111,0890011,New Britain School District,Brook Side School,9,30,39,2011-12
0899411,0890011,New Britain School District,CLIMB,15,15,30,2011-12
0890311,0890011,New Britain School District,Chamberlain  Elementary School,233,295,528,2011-12
0891111,0890011,New Britain School District,Frank J. DiLoreto School,513,410,923,2011-12
0890511,0890011,New Britain School District,Gaffney School,243,320,563,2011-12
0890611,0890011,New Britain School District,Holmes School,172,239,411,2011-12
0895411,0890011,New Britain School District,House of Arts Letters and Science (HALS)  Academy,94,71,165,2011-12
0890711,0890011,New Britain School District,Jefferson School,210,263,473,2011-12
0890811,0890011,New Britain School District,Lincoln School,308,341,649,2011-12
0896111,0890011,New Britain School District,New Britain High School,1225,1291,2516,2011-12
0899011,0890011,New Britain School District,New Britain Transition Center,8,23,31,2011-12
0890911,0890011,New Britain School District,Northend School,186,171,357,2011-12
0895311,0890011,New Britain School District,Pulaski Middle School,230,301,531,2011-12
0895111,0890011,New Britain School District,Roosevelt Middle School,218,224,442,2011-12
0895211,0890011,New Britain School District,Slade Middle School,327,372,699,2011-12
0891211,0890011,New Britain School District,Smalley Academy,275,296,571,2011-12
0891311,0890011,New Britain School District,Smith School,304,356,660,2011-12
0891511,0890011,New Britain School District,Vance School,273,304,577,2011-12
0900411,0900011,New Canaan School District,East School,237,285,522,2011-12
0906111,0900011,New Canaan School District,New Canaan High School,678,632,1310,2011-12
0905111,0900011,New Canaan School District,Saxe Middle School,608,624,1232,2011-12
0900211,0900011,New Canaan School District,South School,291,295,586,2011-12
0900311,0900011,New Canaan School District,West School,247,264,511,2011-12
0910111,0910011,New Fairfield School District,Consolidated School,278,310,588,2011-12
0910211,0910011,New Fairfield School District,Meeting House Hill School,270,323,593,2011-12
0916111,0910011,New Fairfield School District,New Fairfield High School,516,488,1004,2011-12
0915211,0910011,New Fairfield School District,New Fairfield Middle School,301,383,684,2011-12
0920311,0920011,New Hartford School District,Ann Antolini School,179,170,349,2011-12
0920111,0920011,New Hartford School District,Bakerville Consolidated School,57,61,118,2011-12
0920211,0920011,New Hartford School District,New Hartford Elementary School,62,53,115,2011-12
0931211,0930011,New Haven School District,Edgewood School,227,218,445,2011-12
0931411,0930011,New Haven School District,Nathan Hale School,267,287,554,2011-12
0931511,0930011,New Haven School District,Augusta Lewis Troup School,245,269,514,2011-12
0930211,0930011,New Haven School District,Barnard Environmental Magnet School,268,293,561,2011-12
0930311,0930011,New Haven School District,Beecher School,226,244,470,2011-12
0931811,0930011,New Haven School District,Benjamin Jepson Magnet School,257,305,562,2011-12
0935511,0930011,New Haven School District,Betsy Ross Arts Magnet School,328,161,489,2011-12
0934311,0930011,New Haven School District,Bishop Woods Architecture and Design Magnet School,254,243,497,2011-12
0932111,0930011,New Haven School District,Brennan Rogers School,171,173,344,2011-12
0934811,0930011,New Haven School District,"Celentano BioTech, Health and Medical Magnet School",207,237,444,2011-12
0930611,0930011,New Haven School District,Clinton Avenue School,268,294,562,2011-12
0934111,0930011,New Haven School District,Columbus Family Academy,251,222,473,2011-12
0933111,0930011,New Haven School District,Conte/West Hills Magnet School,294,307,601,2011-12
0936411,0930011,New Haven School District,Cooperative High School,452,203,655,2011-12
0936811,0930011,New Haven School District,Cortlandt V.R. Creed Health and Sport Sciences High School,52,157,209,2011-12
0930911,0930011,New Haven School District,Davis 21st Century Magnet Elementary School,259,255,514,2011-12
0935611,0930011,New Haven School District,Domus Academy,*,*,33,2011-12
0938211,0930011,New Haven School District,Dwight Early Childhood Program,28,20,48,2011-12
0938111,0930011,New Haven School District,Early Learning Center,64,57,121,2011-12
0934611,0930011,New Haven School District,East Rock Community Magnet School,205,216,421,2011-12
0931711,0930011,New Haven School District,Engineering - Science University Magnet School,96,224,320,2011-12
0931611,0930011,New Haven School District,Fair Haven School,330,360,690,2011-12
0938011,0930011,New Haven School District,Headstart,169,217,386,2011-12
0938311,0930011,New Haven School District,Helene Grant HeadStart,137,126,263,2011-12
0936611,0930011,New Haven School District,High School In The Community,150,123,273,2011-12
0930711,0930011,New Haven School District,Hill Central Music Academy,200,192,392,2011-12
0936311,0930011,New Haven School District,Hill Regional Career High School,435,268,703,2011-12
0936211,0930011,New Haven School District,James Hillhouse High School,494,486,980,2011-12
0931311,0930011,New Haven School District,John C. Daniels,256,285,541,2011-12
0930811,0930011,New Haven School District,John S. Martinez Sea and Sky STEM School,268,259,527,2011-12
0933011,0930011,New Haven School District,King/Robinson Magnet School,290,289,579,2011-12
0932011,0930011,New Haven School District,Lincoln-Bassett School,172,187,359,2011-12
0931911,0930011,New Haven School District,Mauro-Sheridan Magnet School,248,315,563,2011-12
0936011,0930011,New Haven School District,Metropolitan Business Academy,176,163,339,2011-12
0937011,0930011,New Haven School District,New Haven Academy,140,122,262,2011-12
0939211,0930011,New Haven School District,Polly T. McCabe Center,26,0,26,2011-12
0939111,0930011,New Haven School District,Riverside Education Academy,52,76,128,2011-12
0934211,0930011,New Haven School District,Roberto Clemente Leadership Academy for Global Awareness,267,268,535,2011-12
0931011,0930011,New Haven School District,Ross/Woodward School,297,278,575,2011-12
0936711,0930011,New Haven School District,Sound School,150,187,337,2011-12
0932811,0930011,New Haven School District,Strong 21st Century Communications Magnet and SCSU Lab School,205,217,422,2011-12
0932911,0930011,New Haven School District,Truman School,254,273,527,2011-12
0934911,0930011,New Haven School District,West Rock Authors Academy,112,133,245,2011-12
0933211,0930011,New Haven School District,Wexler/Grant Community School,187,211,398,2011-12
0936111,0930011,New Haven School District,Wilbur Cross High School,584,655,1239,2011-12
0933811,0930011,New Haven School District,Worthington Hooker School,204,227,431,2011-12
0950311,0950011,New London School District,Jennings School,276,253,529,2011-12
0955111,0950011,New London School District,Bennie Dover Jackson Middle School,256,315,571,2011-12
0950211,0950011,New London School District,Harbor School,130,175,305,2011-12
0950911,0950011,New London School District,Nathan Hale Arts Magnet School,123,161,284,2011-12
0959111,0950011,New London School District,New London Clinical Day Program,*,*,22,2011-12
0956111,0950011,New London School District,New London High School,424,510,934,2011-12
0950811,0950011,New London School District,Winthrop STEM Elementary Magnet School,140,179,319,2011-12
0960511,0960011,New Milford School District,Hill And Plain School,192,266,458,2011-12
0960711,0960011,New Milford School District,John Pettibone School,215,220,435,2011-12
0969011,0960011,New Milford School District,Litchfield Hills Transition Center,*,*,*,2011-12
0966111,0960011,New Milford School District,New Milford High School,751,760,1511,2011-12
0960811,0960011,New Milford School District,Northville Elementary School,255,269,524,2011-12
0960911,0960011,New Milford School District,Sarah Noble Intermediate School,479,556,1035,2011-12
0965211,0960011,New Milford School District,Schaghticoke Middle School,344,353,697,2011-12
0940611,0940011,Newington School District,Anna Reynolds School,235,235,470,2011-12
0940211,0940011,Newington School District,Elizabeth Green School,138,161,299,2011-12
0940811,0940011,Newington School District,John Paterson School,217,242,459,2011-12
0945311,0940011,Newington School District,John Wallace Middle School,330,348,678,2011-12
0945111,0940011,Newington School District,Martin Kellogg Middle School,294,296,590,2011-12
0946111,0940011,Newington School District,Newington High School,704,745,1449,2011-12
0940711,0940011,Newington School District,Ruth Chaffee School,208,200,408,2011-12
0970111,0970011,Newtown School District,Hawley Elementary School,172,212,384,2011-12
0970411,0970011,Newtown School District,Head O'Meadow Elementary School,156,186,342,2011-12
0970311,0970011,Newtown School District,Middle Gate Elementary School,253,223,476,2011-12
0976111,0970011,Newtown School District,Newtown High School,855,885,1740,2011-12
0975111,0970011,Newtown School District,Newtown Middle School,407,464,871,2011-12
0978011,0970011,Newtown School District,Newtown Preschool,37,45,82,2011-12
0970511,0970011,Newtown School District,Reed Intermediate School,419,459,878,2011-12
0979011,0970011,Newtown School District,STARR,*,*,*,2011-12
0970211,0970011,Newtown School District,Sandy Hook Elementary School,254,267,521,2011-12
0980111,0980011,Norfolk School District,Botelle Elementary School,57,61,118,2011-12
0989211,0980011,Norfolk School District,Bridges II,*,*,6,2011-12
0990411,0990011,North Branford School District,Jerome Harrison School,222,240,462,2011-12
0996111,0990011,North Branford School District,North Branford High School,335,314,649,2011-12
0995111,0990011,North Branford School District,North Branford Intermediate School,293,280,573,2011-12
0990611,0990011,North Branford School District,Totoket Valley Elementary School,250,244,494,2011-12
1000111,1000011,North Canaan School District,North Canaan Elementary School,160,148,308,2011-12
1010811,1010011,North Haven School District,Clintonville Elementary School,172,221,393,2011-12
1010711,1010011,North Haven School District,Green Acres Elementary School,178,209,387,2011-12
1010211,1010011,North Haven School District,Montowese Elementary School,187,177,364,2011-12
1016111,1010011,North Haven School District,North Haven High School,592,594,1186,2011-12
1015211,1010011,North Haven School District,North Haven Middle School,398,399,797,2011-12
1010311,1010011,North Haven School District,Ridge Road Elementary School,193,228,421,2011-12
1020111,1020011,North Stonington School District,North Stonington Elementary School,179,205,384,2011-12
1026111,1020011,North Stonington School District,Wheeler High School,99,117,216,2011-12
1025111,1020011,North Stonington School District,Wheeler Middle School,90,91,181,2011-12
1036211,1030011,Norwalk School District,Brien McMahon High School,877,853,1730,2011-12
1030211,1030011,Norwalk School District,Brookside Elementary School,245,294,539,2011-12
1030311,1030011,Norwalk School District,Columbus Magnet School,162,148,310,2011-12
1030411,1030011,Norwalk School District,Cranbury Elementary School,225,249,474,2011-12
1032011,1030011,Norwalk School District,Fox Run Elementary School,223,265,488,2011-12
1030711,1030011,Norwalk School District,Jefferson Magnet School,293,291,584,2011-12
1030811,1030011,Norwalk School District,Kendall Elementary School,243,254,497,2011-12
1032211,1030011,Norwalk School District,Marvin Elementary School,228,281,509,2011-12
1032111,1030011,Norwalk School District,Naramake Elementary School,235,233,468,2011-12
1035211,1030011,Norwalk School District,Nathan Hale Middle School,299,314,613,2011-12
1036111,1030011,Norwalk School District,Norwalk High School,782,749,1531,2011-12
1036311,1030011,Norwalk School District,Norwalk Pathways Academy at Briggs,28,41,69,2011-12
1035311,1030011,Norwalk School District,Ponus Ridge Middle School,284,325,609,2011-12
1035511,1030011,Norwalk School District,Roton Middle School,228,212,440,2011-12
1031311,1030011,Norwalk School District,Rowayton School,207,247,454,2011-12
1032311,1030011,Norwalk School District,Silvermine Elementary School,202,226,428,2011-12
1031411,1030011,Norwalk School District,Tracey School,192,209,401,2011-12
1035411,1030011,Norwalk School District,West Rocks Middle School,314,350,664,2011-12
1032411,1030011,Norwalk School District,Wolfpit School,142,159,301,2011-12
9016122,9010022,Norwich Free Academy District,Norwich Free Academy,1249,1066,2315,2011-12
1040111,1040011,Norwich School District,Bishop School Early Learning Center,10,7,17,2011-12
1049111,1040011,Norwich School District,Deborah-Tennant Zinewicz  School,12,32,44,2011-12
1049011,1040011,Norwich School District,Hickory Street School,*,*,16,2011-12
1041411,1040011,Norwich School District,John B. Stanton Network School,184,218,402,2011-12
1045111,1040011,Norwich School District,Kelly Middle School,305,319,624,2011-12
1042011,1040011,Norwich School District,Moriarty Magnet School,205,221,426,2011-12
1040811,1040011,Norwich School District,Samuel Huntington School,219,244,463,2011-12
1045211,1040011,Norwich School District,Teachers' Memorial Middle School,260,234,494,2011-12
1046111,1040011,Norwich School District,Thames River Academy,35,41,76,2011-12
1041711,1040011,Norwich School District,Thomas W. Mahan School,190,154,344,2011-12
1041911,1040011,Norwich School District,Uncas Network School,153,178,331,2011-12
1041811,1040011,Norwich School District,Veterans' Memorial School,152,168,320,2011-12
1041511,1040011,Norwich School District,Wequonnoc Magnet School,118,142,260,2011-12
2635113,2630013,Odyssey Community School District,Odyssey Community School,148,166,314,2011-12
1060211,1060011,Old Saybrook School District,Kathleen E. Goodwin School,217,215,432,2011-12
1065211,1060011,Old Saybrook School District,Old Saybrook Middle School,295,289,584,2011-12
1066111,1060011,Old Saybrook School District,Old Saybrook Senior High School,280,263,543,2011-12
1070211,1070011,Orange School District,Mary L. Tracy School,83,87,170,2011-12
1070511,1070011,Orange School District,Peck Place School,212,181,393,2011-12
1070311,1070011,Orange School District,Race Brook School,200,188,388,2011-12
1070411,1070011,Orange School District,Turkey Hill School,148,171,319,2011-12
1085111,1080011,Oxford School District,Great Oak School,264,268,532,2011-12
1080111,1080011,Oxford School District,Oxford Center School,263,255,518,2011-12
1086011,1080011,Oxford School District,Oxford High School,294,290,584,2011-12
1080311,1080011,Oxford School District,Quaker Farms School,252,252,504,2011-12
2835113,2830013,Park City Prep Charter School District,Park City Prep Charter School,123,134,257,2011-12
1098011,1090011,Plainfield School District,Early Childhood Center,*,*,16,2011-12
1090111,1090011,Plainfield School District,Moosup Elementary School,189,186,375,2011-12
1095111,1090011,Plainfield School District,Plainfield Central School,296,299,595,2011-12
1096111,1090011,Plainfield School District,Plainfield High School,377,381,758,2011-12
1090311,1090011,Plainfield School District,Plainfield Memorial School,190,217,407,2011-12
1090411,1090011,Plainfield School District,Shepard Hill Elementary School,198,218,416,2011-12
1100411,1100011,Plainville School District,Frank T. Wheeler School,120,151,271,2011-12
1100211,1100011,Plainville School District,Linden Street School,201,230,431,2011-12
1100511,1100011,Plainville School District,Louis Toffolon School,184,176,360,2011-12
1105211,1100011,Plainville School District,Middle School of Plainville,260,287,547,2011-12
1106111,1100011,Plainville School District,Plainville High School,383,372,755,2011-12
1108011,1100011,Plainville School District,Prekindergarten Program,15,27,42,2011-12
1115111,1110011,Plymouth School District,Eli Terry Jr. Middle School,196,231,427,2011-12
1110411,1110011,Plymouth School District,Harry S. Fisher Elementary School,169,180,349,2011-12
1110211,1110011,Plymouth School District,Plymouth Center School,173,191,364,2011-12
1116111,1110011,Plymouth School District,Terryville High School,232,276,508,2011-12
1120111,1120011,Pomfret School District,Pomfret Community School,235,236,471,2011-12
1130511,1130011,Portland School District,Brownstone Intermediate School,131,114,245,2011-12
1130411,1130011,Portland School District,Gildersleeve School,110,109,219,2011-12
1136111,1130011,Portland School District,Portland High School,175,185,360,2011-12
1135111,1130011,Portland School District,Portland Middle School,107,123,230,2011-12
1130211,1130011,Portland School District,Valley View School,159,153,312,2011-12
1145111,1140011,Preston School District,Preston Plains School,65,64,129,2011-12
1140411,1140011,Preston School District,Preston Veterans' Memorial School,138,129,267,2011-12
1169011,1160011,Putnam School District,Helping Hands,*,*,*,2011-12
1160311,1160011,Putnam School District,Putnam Elementary School,317,350,667,2011-12
1166111,1160011,Putnam School District,Putnam High School,127,172,299,2011-12
1165111,1160011,Putnam School District,Putnam Middle School,143,145,288,2011-12
1175111,1170011,Redding School District,John Read Middle School,305,287,592,2011-12
1170111,1170011,Redding School District,Redding Elementary School,294,321,615,2011-12
2016112,2010012,Regional School District 01,Housatonic Valley Regional High School,234,229,463,2011-12
2045112,2040012,Regional School District 04,John Winthrop Middle School,180,158,338,2011-12
2046112,2040012,Regional School District 04,Valley Regional High School,321,298,619,2011-12
2055112,2050012,Regional School District 05,Amity Middle School: Bethany,186,192,378,2011-12
2055212,2050012,Regional School District 05,Amity Middle School: Orange,185,205,390,2011-12
2056112,2050012,Regional School District 05,Amity Regional High School,801,856,1657,2011-12
2060112,2060012,Regional School District 06,Goshen Center School,106,105,211,2011-12
2060212,2060012,Regional School District 06,James Morris School,89,94,183,2011-12
2066112,2060012,Regional School District 06,Wamogo Regional High School,296,260,556,2011-12
2060312,2060012,Regional School District 06,Warren Elementary School,44,45,89,2011-12
2079112,2070012,Regional School District 07,AIM,6,9,15,2011-12
2079012,2070012,Regional School District 07,FLEX,0,*,*,2011-12
2079412,2070012,Regional School District 07,Intensive Learning Program,*,*,9,2011-12
2079212,2070012,Regional School District 07,Links,*,*,12,2011-12
2076112,2070012,Regional School District 07,Northwestern Regional High School,388,327,715,2011-12
2075112,2070012,Regional School District 07,Northwestern Regional Middle School,177,192,369,2011-12
2079312,2070012,Regional School District 07,STEP,8,18,26,2011-12
2086112,2080012,Regional School District 08,RHAM High School,540,635,1175,2011-12
2085112,2080012,Regional School District 08,RHAM Middle School,300,309,609,2011-12
2096112,2090012,Regional School District 09,Joel Barlow High School,519,487,1006,2011-12
2105112,2100012,Regional School District 10,Har-Bur Middle School,403,476,879,2011-12
2100312,2100012,Regional School District 10,Harwinton Consolidated School,221,224,445,2011-12
2100212,2100012,Regional School District 10,Lake Garda Elementary School,244,275,519,2011-12
2106112,2100012,Regional School District 10,Lewis S. Mills High School,412,410,822,2011-12
2116112,2110012,Regional School District 11,Parish Hill High School,131,161,292,2011-12
2120212,2120012,Regional School District 12,Booth Free School,51,56,107,2011-12
2128012,2120012,Regional School District 12,Early Childhood Education Center,8,9,17,2011-12
2126112,2120012,Regional School District 12,Shepaug Valley High School,140,166,306,2011-12
2125112,2120012,Regional School District 12,Shepaug Valley Middle School,95,118,213,2011-12
2120112,2120012,Regional School District 12,The Burnham School,34,49,83,2011-12
2120412,2120012,Regional School District 12,Washington Primary School,83,77,160,2011-12
2136112,2130012,Regional School District 13,Coginchaug Regional High School,299,283,582,2011-12
2130212,2130012,Regional School District 13,Francis E. Korn School,67,125,192,2011-12
2135112,2130012,Regional School District 13,Frank Ward Strong School,172,186,358,2011-12
2130112,2130012,Regional School District 13,Frederick Brewster School,114,121,235,2011-12
2130512,2130012,Regional School District 13,John Lyman School,152,148,300,2011-12
2130412,2130012,Regional School District 13,Middlefield Memorial School,158,167,325,2011-12
2140112,2140012,Regional School District 14,Bethlehem Elementary School,163,154,317,2011-12
2148012,2140012,Regional School District 14,Integrated Star Preschool Program,20,25,45,2011-12
2140212,2140012,Regional School District 14,Mitchell Elementary School,191,205,396,2011-12
2146112,2140012,Regional School District 14,Nonnewaug High School,469,348,817,2011-12
2145112,2140012,Regional School District 14,Woodbury Middle School,210,211,421,2011-12
2150412,2150012,Regional School District 15,Gainfield Elementary School,210,187,397,2011-12
2150712,2150012,Regional School District 15,Long Meadow Elementary School,280,313,593,2011-12
2155212,2150012,Regional School District 15,Memorial Middle School,257,253,510,2011-12
2150612,2150012,Regional School District 15,Middlebury Elementary School,203,248,451,2011-12
2156212,2150012,Regional School District 15,Pomperaug Regional High School,618,670,1288,2011-12
2150512,2150012,Regional School District 15,Pomperaug School,222,259,481,2011-12
2155112,2150012,Regional School District 15,Rochambeau Middle School,239,266,505,2011-12
2160312,2160012,Regional School District 16,Algonquin School,258,217,475,2011-12
2160212,2160012,Regional School District 16,Community School,98,110,208,2011-12
2160112,2160012,Regional School District 16,Laurel Ledge School,216,257,473,2011-12
2165112,2160012,Regional School District 16,Long River Middle School,306,273,579,2011-12
2166012,2160012,Regional School District 16,Woodland Regional High School,377,365,742,2011-12
2170212,2170012,Regional School District 17,Burr District Elementary School,143,157,300,2011-12
2170112,2170012,Regional School District 17,Haddam Elementary School,124,146,270,2011-12
2176112,2170012,Regional School District 17,Haddam-Killingworth High School,323,334,657,2011-12
2175112,2170012,Regional School District 17,Haddam-Killingworth Middle School,397,371,768,2011-12
2170312,2170012,Regional School District 17,Killingworth Elementary School,191,198,389,2011-12
2180312,2180012,Regional School District 18,Center School,138,122,260,2011-12
2180112,2180012,Regional School District 18,Lyme Consolidated School,75,81,156,2011-12
2186112,2180012,Regional School District 18,Lyme-Old Lyme High School,192,220,412,2011-12
2185112,2180012,Regional School District 18,Lyme-Old Lyme Middle School,171,179,350,2011-12
2180212,2180012,Regional School District 18,Mile Creek School,129,141,270,2011-12
2196112,2190012,Regional School District 19,E. O. Smith High School,612,613,1225,2011-12
1180811,1180011,Ridgefield School District,Barlow Mountain Elementary School,171,201,372,2011-12
1180611,1180011,Ridgefield School District,Branchville Elementary School,220,210,430,2011-12
1185111,1180011,Ridgefield School District,East Ridge Middle School,368,399,767,2011-12
1180411,1180011,Ridgefield School District,Farmingville Elementary School,165,175,340,2011-12
1180311,1180011,Ridgefield School District,Ridgebury Elementary School,205,203,408,2011-12
1189011,1180011,Ridgefield School District,Ridgefield 18-21 Transition Program,0,*,*,2011-12
1186111,1180011,Ridgefield School District,Ridgefield High School,859,912,1771,2011-12
1180511,1180011,Ridgefield School District,Scotland Elementary School,184,201,385,2011-12
1185211,1180011,Ridgefield School District,Scotts Ridge Middle School,269,269,538,2011-12
1180211,1180011,Ridgefield School District,Veterans Park Elementary School,149,200,349,2011-12
1195111,1190011,Rocky Hill School District,Albert D. Griswold Middle School,302,322,624,2011-12
1190411,1190011,Rocky Hill School District,Myrtle H. Stevens School,247,279,526,2011-12
1196111,1190011,Rocky Hill School District,Rocky Hill High School,389,373,762,2011-12
1190511,1190011,Rocky Hill School District,West Hill School,315,303,618,2011-12
1210111,1210011,Salem School District,Salem Elementary School,213,230,443,2011-12
1220111,1220011,Salisbury School District,Salisbury Central School,156,154,310,2011-12
1230111,1230011,Scotland School District,Scotland Elementary School,73,59,132,2011-12
1240311,1240011,Seymour School District,Anna L. Lopresti School,141,149,290,2011-12
1240111,1240011,Seymour School District,Bungay School,276,270,546,2011-12
1240411,1240011,Seymour School District,Paul E. Chatfield School,140,139,279,2011-12
1246111,1240011,Seymour School District,Seymour High School,295,301,596,2011-12
1245111,1240011,Seymour School District,Seymour Middle School,283,305,588,2011-12
1250111,1250011,Sharon School District,Sharon Center School,90,101,191,2011-12
1260911,1260011,Shelton School District,Mohegan School,195,185,380,2011-12
1261011,1260011,Shelton School District,Booth Hill School,156,204,360,2011-12
1260511,1260011,Shelton School District,Elizabeth Shelton School,220,253,473,2011-12
1265111,1260011,Shelton School District,Intermediate School,464,467,931,2011-12
1260811,1260011,Shelton School District,Long Hill School,218,223,441,2011-12
1261111,1260011,Shelton School District,Perry Hill Elementary School,398,431,829,2011-12
1266111,1260011,Shelton School District,Shelton High School,788,775,1563,2011-12
1260611,1260011,Shelton School District,Sunnyside School,112,139,251,2011-12
1270111,1270011,Sherman School District,Sherman School,191,206,397,2011-12
2700113,2700013,Side By Side Charter School District,Side By Side Charter School,110,122,232,2011-12
1280111,1280011,Simsbury School District,Central School,186,211,397,2011-12
1285111,1280011,Simsbury School District,Henry James Memorial School,379,412,791,2011-12
1280611,1280011,Simsbury School District,Latimer Lane School,221,233,454,2011-12
1286111,1280011,Simsbury School District,Simsbury High School,762,856,1618,2011-12
1280711,1280011,Simsbury School District,Squadron Line School,329,383,712,2011-12
1280311,1280011,Simsbury School District,Tariffville School,125,146,271,2011-12
1280411,1280011,Simsbury School District,Tootin' Hills School,206,218,424,2011-12
1295111,1290011,Somers School District,Mabelle B. Avery Middle School,177,200,377,2011-12
1290411,1290011,Somers School District,Somers Elementary School,339,345,684,2011-12
1296111,1290011,Somers School District,Somers High School,280,272,552,2011-12
1320211,1320011,South Windsor School District,Pleasant Valley School,180,208,388,2011-12
1320711,1320011,South Windsor School District,Eli Terry School,192,225,417,2011-12
1320611,1320011,South Windsor School District,Orchard Hill School,169,217,386,2011-12
1320111,1320011,South Windsor School District,Philip R. Smith School,161,172,333,2011-12
1326211,1320011,South Windsor School District,South Windsor High School,684,774,1458,2011-12
1325111,1320011,South Windsor School District,Timothy Edwards School,555,535,1090,2011-12
1320411,1320011,South Windsor School District,Wapping Elementary School,125,155,280,2011-12
1315311,1310011,Southington School District,John F. Kennedy Middle School,414,426,840,2011-12
1311511,1310011,Southington School District,Derynoski Elementary School,334,316,650,2011-12
1311311,1310011,Southington School District,Flanders Elementary School,134,151,285,2011-12
1310211,1310011,Southington School District,Hatton Elementary School,191,245,436,2011-12
1315111,1310011,Southington School District,Joseph A. Depaolo Middle School,367,405,772,2011-12
1310611,1310011,Southington School District,Plantsville Elementary School,153,122,275,2011-12
1310711,1310011,Southington School District,South End Elementary School,119,122,241,2011-12
1316211,1310011,Southington School District,Southington High School,1024,1004,2028,2011-12
1310811,1310011,Southington School District,Strong Elementary School,174,190,364,2011-12
1310911,1310011,Southington School District,Thalberg Elementary School,201,224,425,2011-12
1311411,1310011,Southington School District,Urbin T. Kelley School,183,204,387,2011-12
1330111,1330011,Sprague School District,Sayles School,180,194,374,2011-12
1340611,1340011,Stafford School District,Stafford Elementary School,236,261,497,2011-12
1346111,1340011,Stafford School District,Stafford High School,280,233,513,2011-12
1345211,1340011,Stafford School District,Stafford Middle School,204,203,407,2011-12
1340311,1340011,Stafford School District,Staffordville School,96,106,202,2011-12
1340411,1340011,Stafford School District,West Stafford School,101,99,200,2011-12
2826013,2820013,Stamford Academy District,Stamford Academy,48,90,138,2011-12
1355611,1350011,Stamford School District,Cloonan School,304,273,577,2011-12
1352011,1350011,Stamford School District,Davenport Ridge School,277,260,537,2011-12
1355311,1350011,Stamford School District,Dolan School,241,287,528,2011-12
1352211,1350011,Stamford School District,Hart School,266,289,555,2011-12
1351211,1350011,Stamford School District,Julia A. Stark School,277,290,567,2011-12
1350511,1350011,Stamford School District,K. T. Murphy School,273,254,527,2011-12
1350611,1350011,Stamford School District,Newfield School,336,351,687,2011-12
1351811,1350011,Stamford School District,Northeast School,335,352,687,2011-12
1358011,1350011,Stamford School District,Preschool Team,6,19,25,2011-12
1355811,1350011,Stamford School District,Rippowam Middle School,323,323,646,2011-12
1350811,1350011,Stamford School District,Rogers International School,400,404,804,2011-12
1350911,1350011,Stamford School District,Roxbury School,294,351,645,2011-12
1355711,1350011,Stamford School District,Scofield Middle School,306,323,629,2011-12
1351111,1350011,Stamford School District,Springdale School,306,314,620,2011-12
1356111,1350011,Stamford School District,Stamford High School,874,987,1861,2011-12
1352111,1350011,Stamford School District,Stillmeadow School,335,380,715,2011-12
1356411,1350011,Stamford School District,The Academy of Information Technology,290,402,692,2011-12
1351911,1350011,Stamford School District,Toquam Magnet School,331,316,647,2011-12
1355511,1350011,Stamford School District,Turn of River School,261,296,557,2011-12
1356311,1350011,Stamford School District,Westhill High School,1154,1121,2275,2011-12
1351411,1350011,Stamford School District,Westover School,335,374,709,2011-12
1360311,1360011,Sterling School District,Sterling Community School,227,262,489,2011-12
1370511,1370011,Stonington School District,Deans Mill School,236,272,508,2011-12
1375211,1370011,Stonington School District,Mystic Middle School,208,213,421,2011-12
1375111,1370011,Stonington School District,Pawcatuck Middle School,170,183,353,2011-12
1376111,1370011,Stonington School District,Stonington High School,387,386,773,2011-12
1370411,1370011,Stonington School District,West Broad Street School,70,76,146,2011-12
1370611,1370011,Stonington School District,West Vine Street School,84,119,203,2011-12
1381311,1380011,Stratford School District,Eli Whitney School,278,259,537,2011-12
1386211,1380011,Stratford School District,Bunnell High School,580,581,1161,2011-12
1380311,1380011,Stratford School District,Chapel School,261,300,561,2011-12
1385211,1380011,Stratford School District,David Wooster Middle School,252,291,543,2011-12
1380411,1380011,Stratford School District,Franklin School,151,140,291,2011-12
1385311,1380011,Stratford School District,Harry B. Flood Middle School,316,288,604,2011-12
1381611,1380011,Stratford School District,Honeyspot School,130,112,242,2011-12
1380811,1380011,Stratford School District,Lordship School,112,107,219,2011-12
1380911,1380011,Stratford School District,Nichols School,216,214,430,2011-12
1381011,1380011,Stratford School District,Second Hill Lane School,332,375,707,2011-12
1389111,1380011,Stratford School District,Secondary STEPS Program,0,9,9,2011-12
1381511,1380011,Stratford School District,Stratford Academy - Johnson House,224,234,458,2011-12
1386111,1380011,Stratford School District,Stratford High School,540,543,1083,2011-12
1389011,1380011,Stratford School District,Strive-Stratford,6,9,15,2011-12
1381411,1380011,Stratford School District,Wilcoxson School,173,209,382,2011-12
1390411,1390011,Suffield School District,A. Ward Spaulding School,242,230,472,2011-12
1390311,1390011,Suffield School District,McAlister Intermediate School,283,269,552,2011-12
1396111,1390011,Suffield School District,Suffield High School,452,415,867,2011-12
1395111,1390011,Suffield School District,Suffield Middle School,280,315,595,2011-12
2696113,2690013,The Bridge Academy District,The Bridge Academy,145,131,276,2011-12
9026122,9020022,The Gilbert School District,The Gilbert School,261,281,542,2011-12
1400111,1400011,Thomaston School District,Black Rock School,172,166,338,2011-12
1400211,1400011,Thomaston School District,Thomaston Center School,113,126,239,2011-12
1406211,1400011,Thomaston School District,Thomaston High School,235,242,477,2011-12
1410111,1410011,Thompson School District,Mary R. Fisher Elementary School,206,238,444,2011-12
1415111,1410011,Thompson School District,Thompson Middle School,220,183,403,2011-12
1416111,1410011,Thompson School District,Tourtellotte Memorial High School,165,173,338,2011-12
1420111,1420011,Tolland School District,Birch Grove Primary School,287,327,614,2011-12
1426111,1420011,Tolland School District,Tolland High School,447,469,916,2011-12
1420211,1420011,Tolland School District,Tolland Intermediate School,338,350,688,2011-12
1425111,1420011,Tolland School District,Tolland Middle School,370,363,733,2011-12
1430111,1430011,Torrington School District,East School,197,214,411,2011-12
1430211,1430011,Torrington School District,Forbes School,181,205,386,2011-12
1430811,1430011,Torrington School District,Southwest School,145,179,324,2011-12
1430911,1430011,Torrington School District,Torringford School,301,340,641,2011-12
1436111,1430011,Torrington School District,Torrington High School,528,585,1113,2011-12
1435111,1430011,Torrington School District,Torrington Middle School,545,582,1127,2011-12
1431311,1430011,Torrington School District,Vogel-Wetmore School,218,241,459,2011-12
2785113,2780013,Trailblazers Academy District,Trailblazers Academy,73,97,170,2011-12
1440111,1440011,Trumbull School District,Booth Hill School,259,262,521,2011-12
1440811,1440011,Trumbull School District,Daniels Farm School,222,250,472,2011-12
1441011,1440011,Trumbull School District,Frenchtown Elementary School,318,335,653,2011-12
1445211,1440011,Trumbull School District,Hillcrest Middle School,383,365,748,2011-12
1440411,1440011,Trumbull School District,Jane Ryan School,191,216,407,2011-12
1445111,1440011,Trumbull School District,Madison Middle School,422,435,857,2011-12
1440311,1440011,Trumbull School District,Middlebrook School,213,254,467,2011-12
1440911,1440011,Trumbull School District,Tashua School,203,189,392,2011-12
1448011,1440011,Trumbull School District,Trumbull Early Childhood Education Center,110,127,237,2011-12
1446111,1440011,Trumbull School District,Trumbull High School,1132,1055,2187,2011-12
3360115,3360015,Unified School District #1,Bridgeport Correctional Center,0,25,25,2011-12
3360215,3360015,Unified School District #1,Brooklyn Correctional Institution,0,*,*,2011-12
3360315,3360015,Unified School District #1,Cheshire Correctional Institution,0,25,25,2011-12
3362415,3360015,Unified School District #1,Corrigan/Radgowski Correctional Institution,0,45,45,2011-12
3360415,3360015,Unified School District #1,Enfield Correctional Institution,0,13,13,2011-12
3361915,3360015,Unified School District #1,Garner Correctional Institution,0,14,14,2011-12
3360615,3360015,Unified School District #1,Hartford Correctional Center,0,44,44,2011-12
3362215,3360015,Unified School District #1,MacDougall/Walker Correctional Institution,0,43,43,2011-12
3361115,3360015,Unified School District #1,Manson Youth Institution,0,400,400,2011-12
3360915,3360015,Unified School District #1,New Haven Correctional Center,0,10,10,2011-12
3362615,3360015,Unified School District #1,Northern Correctional Institution,0,30,30,2011-12
3361215,3360015,Unified School District #1,Osborn Correctional Institution,0,19,19,2011-12
3361315,3360015,Unified School District #1,Robinson Correctional Institution,0,20,20,2011-12
3361515,3360015,Unified School District #1,Willard/Cybulski Correctional Institution,0,24,24,2011-12
3362515,3360015,Unified School District #1,York Correctional Institution,29,0,29,2011-12
3470115,3470015,Unified School District #2,Children's Place School,*,*,25,2011-12
3470315,3470015,Unified School District #2,Riverview School,30,26,56,2011-12
3476715,3470015,Unified School District #2,Walter G. Cady School,0,99,99,2011-12
1450111,1450011,Union School District,Union Elementary School,40,33,73,2011-12
1460311,1460011,Vernon School District,Northeast School,132,160,292,2011-12
1461411,1460011,Vernon School District,Center Road School,255,244,499,2011-12
1460111,1460011,Vernon School District,Lake Street School,117,169,286,2011-12
1460211,1460011,Vernon School District,Maple Street School,140,170,310,2011-12
1469011,1460011,Vernon School District,Next Step Program (AACBP),*,*,14,2011-12
1466111,1460011,Vernon School District,Rockville High School,511,541,1052,2011-12
1461011,1460011,Vernon School District,Skinner Road School,178,197,375,2011-12
1465111,1460011,Vernon School District,Vernon Center Middle School,370,371,741,2011-12
1470111,1470011,Voluntown School District,Voluntown Elementary School,167,152,319,2011-12
1480211,1480011,Wallingford School District,Highland School,162,162,324,2011-12
1489011,1480011,Wallingford School District,A.R.T.S. Academy,7,10,17,2011-12
1481011,1480011,Wallingford School District,Cook Hill School,179,206,385,2011-12
1485211,1480011,Wallingford School District,Dag Hammarskjold Middle School,371,338,709,2011-12
1480911,1480011,Wallingford School District,Evarts C. Stevens School,175,209,384,2011-12
1489211,1480011,Wallingford School District,Harvest Park,0,7,7,2011-12
1485311,1480011,Wallingford School District,James H. Moran Middle School,379,376,755,2011-12
1486111,1480011,Wallingford School District,Lyman Hall High School,629,500,1129,2011-12
1486211,1480011,Wallingford School District,Mark T. Sheehan High School,473,444,917,2011-12
1480111,1480011,Wallingford School District,Moses Y. Beach School,172,182,354,2011-12
1489111,1480011,Wallingford School District,Multi-Vocational Life Skills Program,*,*,12,2011-12
1480311,1480011,Wallingford School District,Parker Farms School,167,161,328,2011-12
1481211,1480011,Wallingford School District,Pond Hill School,171,162,333,2011-12
1480411,1480011,Wallingford School District,Rock Hill School,167,182,349,2011-12
1480811,1480011,Wallingford School District,Yalesville School,197,200,397,2011-12
1515211,1510011,Waterbury School District,West Side Middle School,517,559,1076,2011-12
1512311,1510011,Waterbury School District,Washington School,179,169,348,2011-12
1512111,1510011,Waterbury School District,B. W. Tinker School,257,311,568,2011-12
1510511,1510011,Waterbury School District,Bucks Hill School,275,296,571,2011-12
1510611,1510011,Waterbury School District,Bunker Hill School,240,257,497,2011-12
1512711,1510011,Waterbury School District,Carrington School,230,232,462,2011-12
1516211,1510011,Waterbury School District,Crosby High School,646,731,1377,2011-12
1510911,1510011,Waterbury School District,Driggs School,262,282,544,2011-12
1511611,1510011,Waterbury School District,Duggan School,192,189,381,2011-12
1519111,1510011,Waterbury School District,Enlightenment School,68,108,176,2011-12
1511411,1510011,Waterbury School District,F. J. Kingsbury School,237,278,515,2011-12
1512611,1510011,Waterbury School District,Gilmartin School,199,201,400,2011-12
1510711,1510011,Waterbury School District,H. S. Chase School,370,386,756,2011-12
1511311,1510011,Waterbury School District,Hopeville School,219,226,445,2011-12
1516411,1510011,Waterbury School District,John F. Kennedy High School,670,744,1414,2011-12
1513111,1510011,Waterbury School District,Maloney Interdistrict Magnet School,279,324,603,2011-12
1511111,1510011,Waterbury School District,Margaret M. Generali Elementary School,248,285,533,2011-12
1515111,1510011,Waterbury School District,Michael F. Wallace Middle School,615,608,1223,2011-12
1515311,1510011,Waterbury School District,North End Middle School,551,644,1195,2011-12
1512811,1510011,Waterbury School District,Regan School,145,147,292,2011-12
1513311,1510011,Waterbury School District,Rotella Interdistrict Magnet School,328,287,615,2011-12
1518011,1510011,Waterbury School District,Special Education Preschool,90,123,213,2011-12
1512011,1510011,Waterbury School District,Sprague School,186,184,370,2011-12
1519011,1510011,Waterbury School District,State Street School,10,61,71,2011-12
1512211,1510011,Waterbury School District,Walsh School,254,245,499,2011-12
1516011,1510011,Waterbury School District,Waterbury Arts Magnet School (High),308,159,467,2011-12
1515011,1510011,Waterbury School District,Waterbury Arts Magnet School (Middle),185,145,330,2011-12
1510811,1510011,Waterbury School District,Wendell L. Cross School,176,201,377,2011-12
1516311,1510011,Waterbury School District,Wilby High School,639,682,1321,2011-12
1513211,1510011,Waterbury School District,Woodrow Wilson School,197,226,423,2011-12
1525111,1520011,Waterford School District,Clark Lane Middle School,317,366,683,2011-12
1520211,1520011,Waterford School District,Great Neck Elementary School,188,163,351,2011-12
1520611,1520011,Waterford School District,Oswegatchie Elementary School,189,210,399,2011-12
1520711,1520011,Waterford School District,Quaker Hill Elementary School,153,204,357,2011-12
1526111,1520011,Waterford School District,Waterford High School,422,473,895,2011-12
1530311,1530011,Watertown School District,Fletcher W. Judson School,162,162,324,2011-12
1530211,1530011,Watertown School District,John Trumbull Primary School,319,382,701,2011-12
1530411,1530011,Watertown School District,Polk School,162,183,345,2011-12
1535111,1530011,Watertown School District,Swift Middle School,378,393,771,2011-12
1536111,1530011,Watertown School District,Watertown High School,484,472,956,2011-12
1551711,1550011,West Hartford School District,Smith School,156,181,337,2011-12
1559111,1550011,West Hartford School District,Achieve,*,*,6,2011-12
1551611,1550011,West Hartford School District,Aiken School,229,242,471,2011-12
1550211,1550011,West Hartford School District,Braeburn School,201,216,417,2011-12
1555311,1550011,West Hartford School District,Bristow Middle School,207,216,423,2011-12
1550411,1550011,West Hartford School District,Bugbee School,234,221,455,2011-12
1550511,1550011,West Hartford School District,Charter Oak International Academy,145,154,299,2011-12
1556111,1550011,West Hartford School District,Conard High School,713,738,1451,2011-12
1550611,1550011,West Hartford School District,Duffy School,248,276,524,2011-12
1556211,1550011,West Hartford School District,Hall High School,770,761,1531,2011-12
1555111,1550011,West Hartford School District,King Philip Middle School,444,440,884,2011-12
1550911,1550011,West Hartford School District,Morley School,179,177,356,2011-12
1551011,1550011,West Hartford School District,Norfeldt School,196,229,425,2011-12
1555211,1550011,West Hartford School District,Sedgwick Middle School,473,469,942,2011-12
1559211,1550011,West Hartford School District,Strive-West Hartford,8,18,26,2011-12
1559011,1550011,West Hartford School District,WAAVE (W Hartford Applied Academic/Voc'l Experience),*,*,12,2011-12
1551211,1550011,West Hartford School District,Webster Hill School,245,227,472,2011-12
1551311,1550011,West Hartford School District,Whiting Lane School,244,309,553,2011-12
1551511,1550011,West Hartford School District,Wolcott School,252,261,513,2011-12
1561211,1560011,West Haven School District,Washington School,215,246,461,2011-12
1560811,1560011,West Haven School District,Alma E. Pagels School,158,201,359,2011-12
1565311,1560011,West Haven School District,Carrigan 5/6 Intermediate School,439,483,922,2011-12
1560611,1560011,West Haven School District,Edith E. Mackrille School,197,199,396,2011-12
1560311,1560011,West Haven School District,Forest School,231,245,476,2011-12
1565111,1560011,West Haven School District,Harry M. Bailey Middle School,492,456,948,2011-12
1561411,1560011,West Haven School District,Savin Rock Community School,244,266,510,2011-12
1560411,1560011,West Haven School District,Seth G. Haley School,235,237,472,2011-12
1566111,1560011,West Haven School District,West Haven High School,743,772,1515,2011-12
1540211,1540011,Westbrook School District,Daisy Ingraham School,152,184,336,2011-12
1546111,1540011,Westbrook School District,Westbrook High School,148,148,296,2011-12
1545111,1540011,Westbrook School District,Westbrook Middle School,144,146,290,2011-12
1570111,1570011,Weston School District,Hurlbutt Elementary School,245,280,525,2011-12
1576111,1570011,Weston School District,Weston High School,367,388,755,2011-12
1570211,1570011,Weston School District,Weston Intermediate School,273,297,570,2011-12
1575111,1570011,Weston School District,Weston Middle School,307,321,628,2011-12
1585111,1580011,Westport School District,Bedford Middle School,405,446,851,2011-12
1580311,1580011,Westport School District,Coleytown Elementary School,253,227,480,2011-12
1585311,1580011,Westport School District,Coleytown Middle School,247,254,501,2011-12
1580411,1580011,Westport School District,Green's Farms School,225,228,453,2011-12
1580511,1580011,Westport School District,King's Highway Elementary School,227,241,468,2011-12
1580711,1580011,Westport School District,Long Lots School,281,317,598,2011-12
1580811,1580011,Westport School District,Saugatuck Elementary School,243,279,522,2011-12
1586111,1580011,Westport School District,Staples High School,933,891,1824,2011-12
1588011,1580011,Westport School District,Stepping Stones Preschool,15,24,39,2011-12
1590811,1590011,Wethersfield School District,Alfred W. Hanmer School,191,215,406,2011-12
1591011,1590011,Wethersfield School District,Charles Wright School,165,127,292,2011-12
1590211,1590011,Wethersfield School District,Emerson-Williams School,205,221,426,2011-12
1591111,1590011,Wethersfield School District,Highcrest School,214,212,426,2011-12
1591211,1590011,Wethersfield School District,Samuel B. Webb Elementary School,190,204,394,2011-12
1595211,1590011,Wethersfield School District,Silas Deane Middle School,299,320,619,2011-12
1596111,1590011,Wethersfield School District,Wethersfield High School,540,581,1121,2011-12
1600111,1600011,Willington School District,Center School,109,98,207,2011-12
1605111,1600011,Willington School District,Hall Memorial School,132,153,285,2011-12
1615211,1610011,Wilton School District,Middlebrook School,532,526,1058,2011-12
1610711,1610011,Wilton School District,Cider Mill School,518,521,1039,2011-12
1610511,1610011,Wilton School District,Miller-Driscoll School,452,477,929,2011-12
1616111,1610011,Wilton School District,Wilton High School,620,671,1291,2011-12
1629211,1620011,Winchester School District,Batcheller - Bridges 1,*,*,*,2011-12
1620411,1620011,Winchester School District,Batcheller Early Education Center,89,108,197,2011-12
1620211,1620011,Winchester School District,Mary P. Hinsdale School,124,149,273,2011-12
1625111,1620011,Winchester School District,Pearson Middle School,80,134,214,2011-12
1638011,1630011,Windham School District,Early Headstart,13,18,31,2011-12
1630111,1630011,Windham School District,Natchaug School,109,126,235,2011-12
1630311,1630011,Windham School District,North Windham School,203,222,425,2011-12
1638411,1630011,Windham School District,Partial Day Program,*,*,6,2011-12
1630611,1630011,Windham School District,W. B. Sweeney School,160,183,343,2011-12
1630511,1630011,Windham School District,Windham Center School,129,160,289,2011-12
1638311,1630011,Windham School District,Windham Early Childhood Prospect Street,85,113,198,2011-12
1636111,1630011,Windham School District,Windham High School,331,398,729,2011-12
1635111,1630011,Windham School District,Windham Middle School,469,517,986,2011-12
1650111,1650011,Windsor Locks School District,North Street School,210,204,414,2011-12
1650411,1650011,Windsor Locks School District,South Elementary School,195,186,381,2011-12
1656111,1650011,Windsor Locks School District,Windsor Locks High School,282,276,558,2011-12
1655111,1650011,Windsor Locks School District,Windsor Locks Middle School,175,219,394,2011-12
1640111,1640011,Windsor School District,Clover Street School,125,102,227,2011-12
1640811,1640011,Windsor School District,John F. Kennedy School,137,151,288,2011-12
1640911,1640011,Windsor School District,Oliver Ellsworth School,190,209,399,2011-12
1640511,1640011,Windsor School District,Poquonock Elementary School,150,163,313,2011-12
1641011,1640011,Windsor School District,Roger Wolcott Early Child Center,109,144,253,2011-12
1645311,1640011,Windsor School District,Sage Park Middle School,389,398,787,2011-12
1646111,1640011,Windsor School District,Windsor High School,602,626,1228,2011-12
1660611,1660011,Wolcott School District,Alcott School,166,180,346,2011-12
1660211,1660011,Wolcott School District,Frisbie School,184,195,379,2011-12
1665111,1660011,Wolcott School District,Tyrrell Middle School,318,349,667,2011-12
1660511,1660011,Wolcott School District,Wakelee School,192,204,396,2011-12
1666111,1660011,Wolcott School District,Wolcott High School,437,424,861,2011-12
1670211,1670011,Woodbridge School District,Beecher Road Intermediate School,199,229,428,2011-12
1670111,1670011,Woodbridge School District,Beecher Road Primary School,157,152,309,2011-12
9036122,9030022,Woodstock Academy District,Woodstock Academy,572,526,1098,2011-12
1690211,1690011,Woodstock School District,Woodstock Elementary School,245,256,501,2011-12
1695111,1690011,Woodstock School District,Woodstock Middle School,188,201,389,2011-12
2880113,2880013,Achievement First Hartford Academy Inc. District,Achievement First Hartford Academy Inc.,385,439,824,2012-13
2795113,2790013,Amistad Academy District,Amistad Academy,442,462,904,2012-13
0010111,0010011,Andover School District,Andover Elementary School,140,174,314,2012-13
0026111,0020011,Ansonia School District,Ansonia High School,309,322,631,2012-13
0025111,0020011,Ansonia School District,Ansonia Middle School,218,245,463,2012-13
0020311,0020011,Ansonia School District,Mead School,312,307,619,2012-13
0020811,0020011,Ansonia School District,Prendergast School,322,377,699,2012-13
2449614,2440014,Area Cooperative Educational Services,Center for Autism Spectrum and Development Disorders,7,29,36,2012-13
2449414,2440014,Area Cooperative Educational Services,Mill Road School,19,128,147,2012-13
2445114,2440014,Area Cooperative Educational Services,Thomas Edison Magnet Middle School,338,384,722,2012-13
2449514,2440014,Area Cooperative Educational Services,Village School,45,104,149,2012-13
2449214,2440014,Area Cooperative Educational Services,Whitney High School East,32,82,114,2012-13
2449114,2440014,Area Cooperative Educational Services,Whitney High School North,20,69,89,2012-13
2449314,2440014,Area Cooperative Educational Services,Whitney High School West,10,35,45,2012-13
2440314,2440014,Area Cooperative Educational Services,Wintergreen Interdistrict  Magnet School,333,297,630,2012-13
0030111,0030011,Ashford School District,Ashford School,211,228,439,2012-13
0046111,0040011,Avon School District,Avon High School,549,534,1083,2012-13
0045111,0040011,Avon School District,Avon Middle School,295,316,611,2012-13
0040411,0040011,Avon School District,Pine Grove School,286,309,595,2012-13
0040311,0040011,Avon School District,Roaring Brook School,280,289,569,2012-13
0040511,0040011,Avon School District,Thompson Brook School,290,258,548,2012-13
0050111,0050011,Barkhamsted School District,Barkhamsted Elementary School,141,187,328,2012-13
0058011,0050011,Barkhamsted School District,Shared Services Integrated Preschool,10,11,21,2012-13
0076111,0070011,Berlin School District,Berlin High School,466,496,962,2012-13
0075111,0070011,Berlin School District,Catherine M. McGee Middle School,327,385,712,2012-13
0070411,0070011,Berlin School District,Emma Hart Willard School,221,280,501,2012-13
0070511,0070011,Berlin School District,Mary E. Griswold School,271,296,567,2012-13
0070111,0070011,Berlin School District,Richard D. Hubbard School,103,129,232,2012-13
0080111,0080011,Bethany School District,Bethany Community School,223,250,473,2012-13
0090411,0090011,Bethel School District,Anna H. Rockwell School,193,199,392,2012-13
0096111,0090011,Bethel School District,Bethel High School,459,500,959,2012-13
0095111,0090011,Bethel School District,Bethel Middle School,323,361,684,2012-13
0090111,0090011,Bethel School District,Frank A. Berry School,242,255,497,2012-13
0090511,0090011,Bethel School District,Ralph M. T. Johnson School,216,227,443,2012-13
0116111,0110011,Bloomfield School District,Bloomfield High School,264,277,541,2012-13
0110711,0110011,Bloomfield School District,Carmen Arace Intermediate School,107,113,220,2012-13
0115211,0110011,Bloomfield School District,Carmen Arace Middle School,128,133,261,2012-13
0116311,0110011,Bloomfield School District,Global Experience Magnet School,103,79,182,2012-13
0110611,0110011,Bloomfield School District,Laurel School,147,188,335,2012-13
0116411,0110011,Bloomfield School District,Learning Academy at Bloomfield,*,*,10,2012-13
0110511,0110011,Bloomfield School District,Metacomet School,117,120,237,2012-13
0110811,0110011,Bloomfield School District,Wintonbury Early Childhood Magnet School,162,160,322,2012-13
0120111,0120011,Bolton School District,Bolton Center School,267,266,533,2012-13
0126111,0120011,Bolton School District,Bolton High School,177,182,359,2012-13
0130111,0130011,Bozrah School District,Fields Memorial School,124,117,241,2012-13
0146111,0140011,Branford School District,Branford High School,552,497,1049,2012-13
0145111,0140011,Branford School District,Francis Walsh Intermediate School,474,515,989,2012-13
0148011,0140011,Branford School District,Indian Neck School,17,30,47,2012-13
0141611,0140011,Branford School District,John B. Sliney School,175,196,371,2012-13
0141511,0140011,Branford School District,Mary R. Tisko School,188,185,373,2012-13
0141411,0140011,Branford School District,Mary T. Murphy School,203,226,429,2012-13
2850113,2850013,Bridgeport Achievement First District,Achievement First Bridgeport Academy,347,355,702,2012-13
0150111,0150011,Bridgeport School District,Barnum School,293,332,625,2012-13
0156111,0150011,Bridgeport School District,Bassick High School,529,648,1177,2012-13
0150211,0150011,Bridgeport School District,Beardsley School,195,182,377,2012-13
0150311,0150011,Bridgeport School District,Black Rock School,154,194,348,2012-13
0154011,0150011,Bridgeport School District,Blackham School,542,588,1130,2012-13
0159011,0150011,Bridgeport School District,Bridgeport Learning Center,9,43,52,2012-13
0150411,0150011,Bridgeport School District,Bryant School,197,215,412,2012-13
0156211,0150011,Bridgeport School District,Central High School,1087,1050,2137,2012-13
0151411,0150011,Bridgeport School District,Cesar Batalla School,527,588,1115,2012-13
0152111,0150011,Bridgeport School District,Classical Studies Academy,161,149,310,2012-13
0150511,0150011,Bridgeport School District,Columbus School,400,477,877,2012-13
0153911,0150011,Bridgeport School District,Cross School,203,217,420,2012-13
0154211,0150011,Bridgeport School District,Curiale School,345,428,773,2012-13
0154111,0150011,Bridgeport School District,Dunbar School,153,160,313,2012-13
0150711,0150011,Bridgeport School District,Edison School,120,124,244,2012-13
0153211,0150011,Bridgeport School District,Geraldine Johnson School,396,422,818,2012-13
0151111,0150011,Bridgeport School District,Hall School,151,157,308,2012-13
0151211,0150011,Bridgeport School District,Hallen School,160,176,336,2012-13
0156311,0150011,Bridgeport School District,Harding High School,630,667,1297,2012-13
0154511,0150011,Bridgeport School District,High Horizons Magnet School,233,200,433,2012-13
0151311,0150011,Bridgeport School District,Hooker School,174,207,381,2012-13
0153711,0150011,Bridgeport School District,Interdistrict Discovery Magnet School,214,243,457,2012-13
0152211,0150011,Bridgeport School District,Jettie S. Tisdale School,309,320,629,2012-13
0151011,0150011,Bridgeport School District,Luis Munoz Marin School,408,463,871,2012-13
0152011,0150011,Bridgeport School District,Madison School,229,277,506,2012-13
0154611,0150011,Bridgeport School District,Multicultural Magnet School,264,192,456,2012-13
0159211,0150011,Bridgeport School District,Park City Academy,*,*,6,2012-13
0151711,0150011,Bridgeport School District,Park City Magnet School,290,236,526,2012-13
0152511,0150011,Bridgeport School District,Read School,392,465,857,2012-13
0152611,0150011,Bridgeport School District,Roosevelt School,256,268,524,2012-13
0154411,0150011,Bridgeport School District,Skane Center,78,153,231,2012-13
0153011,0150011,Bridgeport School District,Waltersville School,254,260,514,2012-13
0153611,0150011,Bridgeport School District,Winthrop School,355,331,686,2012-13
0179011,0170011,Bristol School District,Alternative Special Education Program (ASEP),*,*,19,2012-13
0176111,0170011,Bristol School District,Bristol Central High School,610,652,1262,2012-13
0176211,0170011,Bristol School District,Bristol Eastern High School,617,688,1305,2012-13
0175111,0170011,Bristol School District,Chippens Hill Middle School,370,388,758,2012-13
0179211,0170011,Bristol School District,Community/Vocational Program,*,*,10,2012-13
0170311,0170011,Bristol School District,Edgewood School,184,181,365,2012-13
0171411,0170011,Bristol School District,Ellen P. Hubbell School,209,227,436,2012-13
0170511,0170011,Bristol School District,Greene-Hills School,426,467,893,2012-13
0171911,0170011,Bristol School District,Ivy Drive School,196,227,423,2012-13
0171711,0170011,Bristol School District,Mountain View School,228,203,431,2012-13
0175211,0170011,Bristol School District,Northeast Middle School,240,260,500,2012-13
0171111,0170011,Bristol School District,South Side School,227,262,489,2012-13
0171211,0170011,Bristol School District,Stafford School,243,260,503,2012-13
0172011,0170011,Bristol School District,West Bristol School,430,471,901,2012-13
0186111,0180011,Brookfield School District,Brookfield High School,481,437,918,2012-13
0180311,0180011,Brookfield School District,Center Elementary School,198,218,416,2012-13
0180411,0180011,Brookfield School District,Huckleberry Hill Elementary School,290,315,605,2012-13
0185311,0180011,Brookfield School District,Whisconier Middle School,417,434,851,2012-13
0190111,0190011,Brooklyn School District,Brooklyn Elementary School,272,271,543,2012-13
0195111,0190011,Brooklyn School District,Brooklyn Middle School,174,220,394,2012-13
0210111,0210011,Canaan School District,Lee H. Kellogg School,39,36,75,2012-13
0220211,0220011,Canterbury School District,Canterbury Elementary School,118,141,259,2012-13
0225111,0220011,Canterbury School District,Dr. Helen Baldwin Middle School,105,126,231,2012-13
0236111,0230011,Canton School District,Canton High School,236,275,511,2012-13
0230311,0230011,Canton School District,Canton Intermediate School,230,200,430,2012-13
0235111,0230011,Canton School District,Canton Middle School,140,130,270,2012-13
0230211,0230011,Canton School District,Cherry Brook Primary School,268,269,537,2012-13
2415114,2410014,Capitol Region Education Council,Academy of Aerospace and Engineering,144,347,491,2012-13
2416514,2410014,Capitol Region Education Council,Academy of Science and Innovation,259,76,335,2012-13
2410614,2410014,Capitol Region Education Council,Ana Grace Academy of the Arts Elementary School,88,76,164,2012-13
2418114,2410014,Capitol Region Education Council,Discovery Academy,91,130,221,2012-13
2419214,2410014,Capitol Region Education Council,Farmington Valley Regional Diagnostic Center,9,12,21,2012-13
2410114,2410014,Capitol Region Education Council,Glastonbury/East Hartford Magnet School,183,204,387,2012-13
2416414,2410014,Capitol Region Education Council,Greater Hartford Academy of  the Arts High School - Full Time,307,116,423,2012-13
2415314,2410014,Capitol Region Education Council,Greater Hartford Academy of the Arts Magnet Middle,112,72,184,2012-13
2419414,2410014,Capitol Region Education Council,Integrated Program Models,*,*,6,2012-13
2410414,2410014,Capitol Region Education Council,International Magnet School for Global Citizenship,177,180,357,2012-13
2419014,2410014,Capitol Region Education Council,John J. Allison Polaris Center,20,38,58,2012-13
2419614,2410014,Capitol Region Education Council,Lincoln Academy Regional Interdistrict Collaborative,*,*,11,2012-13
2416114,2410014,Capitol Region Education Council,Metropolitan Learning Center for Global and International Studies,376,340,716,2012-13
2413114,2410014,Capitol Region Education Council,Montessori Magnet School,166,174,340,2012-13
2410514,2410014,Capitol Region Education Council,Museum Academy,164,147,311,2012-13
2415214,2410014,Capitol Region Education Council,Public Safety Academy,133,244,377,2012-13
2410314,2410014,Capitol Region Education Council,Reggio Magnet School of the Arts,172,184,356,2012-13
2419514,2410014,Capitol Region Education Council,River Street Early Learning Center (Site 2),17,47,64,2012-13
2419314,2410014,Capitol Region Education Council,River Street School,22,129,151,2012-13
2419114,2410014,Capitol Region Education Council,Soundbridge,42,44,86,2012-13
2416714,2410014,Capitol Region Education Council,Two Rivers Magnet High School,48,48,96,2012-13
2415014,2410014,Capitol Region Education Council,Two Rivers Magnet Middle School,319,344,663,2012-13
2410214,2410014,Capitol Region Education Council,University of Hartford Magnet School,208,232,440,2012-13
0240211,0240011,Chaplin School District,Chaplin Elementary School,91,94,185,2012-13
0250111,0250011,Cheshire School District,Chapman School,153,130,283,2012-13
0256111,0250011,Cheshire School District,Cheshire High School,746,768,1514,2012-13
0250211,0250011,Cheshire School District,Darcey School,145,161,306,2012-13
0255111,0250011,Cheshire School District,Dodd Middle School,353,404,757,2012-13
0250611,0250011,Cheshire School District,Doolittle School,276,263,539,2012-13
0250411,0250011,Cheshire School District,Highland School,377,399,776,2012-13
0259011,0250011,Cheshire School District,Humiston School,7,18,25,2012-13
0250511,0250011,Cheshire School District,Norton School,242,213,455,2012-13
0260111,0260011,Chester School District,Chester Elementary School,135,116,251,2012-13
0270111,0270011,Clinton School District,Abraham Pierson School,163,148,311,2012-13
0275111,0270011,Clinton School District,Jared Eliot School,230,216,446,2012-13
0270311,0270011,Clinton School District,Lewin G. Joel Jr. School,291,354,645,2012-13
0276111,0270011,Clinton School District,The Morgan School,277,302,579,2012-13
0286111,0280011,Colchester School District,Bacon Academy,494,443,937,2012-13
0280411,0280011,Colchester School District,Colchester Elementary School,292,320,612,2012-13
0280211,0280011,Colchester School District,Jack Jackter Intermediate School,299,331,630,2012-13
0285111,0280011,Colchester School District,William J. Johnston Middle School,343,358,701,2012-13
0290111,0290011,Colebrook School District,Colebrook Consolidated School,51,53,104,2012-13
0300111,0300011,Columbia School District,Horace W. Porter School,260,243,503,2012-13
2686113,2680013,Common Ground High School District,Common Ground High School,80,89,169,2012-13
9001516,9000016,Connecticut Technical High School System,A. I. Prince Technical High School,417,361,778,2012-13
9001116,9000016,Connecticut Technical High School System,Bullard-Havens Technical High School,437,391,828,2012-13
9001916,9000016,Connecticut Technical High School System,E. C. Goodwin Technical High School,256,379,635,2012-13
9001416,9000016,Connecticut Technical High School System,Eli Whitney Technical High School,225,275,500,2012-13
9002716,9000016,Connecticut Technical High School System,Ella T. Grasso Southeastern Technical High School,231,342,573,2012-13
9002516,9000016,Connecticut Technical High School System,Emmett O'Brien Technical High School,168,389,557,2012-13
9001716,9000016,Connecticut Technical High School System,H. C. Wilcox Technical High School,328,440,768,2012-13
9001316,9000016,Connecticut Technical High School System,H. H. Ellis Technical High School,115,416,531,2012-13
9001216,9000016,Connecticut Technical High School System,Henry Abbott Technical High School,218,423,641,2012-13
9001616,9000016,Connecticut Technical High School System,Howell Cheney Technical High School,150,535,685,2012-13
9002016,9000016,Connecticut Technical High School System,Norwich Technical High School,251,425,676,2012-13
9002216,9000016,Connecticut Technical High School System,Oliver Wolcott Technical High School,238,421,659,2012-13
9002616,9000016,Connecticut Technical High School System,Platt Technical High School,298,554,852,2012-13
9001816,9000016,Connecticut Technical High School System,Vinal Technical High School,190,450,640,2012-13
9002316,9000016,Connecticut Technical High School System,W. F. Kaynor Technical High School,347,411,758,2012-13
9002416,9000016,Connecticut Technical High School System,Windham Technical High School,196,374,570,2012-13
2439214,2430014,Cooperative Educational Services,Developmental Learning Center (DLC),26,65,91,2012-13
2439114,2430014,Cooperative Educational Services,Preschool-Primary Learning Center (PLC),14,40,54,2012-13
2439314,2430014,Cooperative Educational Services,RISE Transitional Program,*,*,14,2012-13
2438014,2430014,Cooperative Educational Services,School Readiness,32,22,54,2012-13
2430114,2430014,Cooperative Educational Services,Six-Six Magnet School,236,237,473,2012-13
2439414,2430014,Cooperative Educational Services,Therapeutic Day Program,26,126,152,2012-13
0310111,0310011,Cornwall School District,Cornwall Consolidated School,46,57,103,2012-13
0325111,0320011,Coventry School District,Capt. Nathan Hale School,204,204,408,2012-13
0328011,0320011,Coventry School District,Coventry Early Intervention Services,*,*,16,2012-13
0320211,0320011,Coventry School District,Coventry Grammar School,205,175,380,2012-13
0326111,0320011,Coventry School District,Coventry High School,262,249,511,2012-13
0320411,0320011,Coventry School District,George Hersey Robertson School,208,200,408,2012-13
0336111,0330011,Cromwell School District,Cromwell High School,270,265,535,2012-13
0335111,0330011,Cromwell School District,Cromwell Middle School,245,264,509,2012-13
0330211,0330011,Cromwell School District,Edna C. Stevens School,227,259,486,2012-13
0330311,0330011,Cromwell School District,Woodside Intermediate School,205,236,441,2012-13
0346211,0340011,Danbury School District,Alternative Center For Excellence,33,45,78,2012-13
0345111,0340011,Danbury School District,Broadview Middle School,506,588,1094,2012-13
0346111,0340011,Danbury School District,Danbury High School,1407,1480,2887,2012-13
0341411,0340011,Danbury School District,Ellsworth Avenue School,183,222,405,2012-13
0341111,0340011,Danbury School District,Great Plain School,169,158,327,2012-13
0340211,0340011,Danbury School District,Hayestown Avenue School,206,205,411,2012-13
0341711,0340011,Danbury School District,King Street Intermediate School,185,178,363,2012-13
0341311,0340011,Danbury School District,King Street Primary School,199,205,404,2012-13
0341811,0340011,Danbury School District,Mill Ridge Educational Center,57,108,165,2012-13
0340511,0340011,Danbury School District,Mill Ridge Primary School,199,202,401,2012-13
0340611,0340011,Danbury School District,Morris Street School,194,226,420,2012-13
0340811,0340011,Danbury School District,Park Avenue School,212,219,431,2012-13
0341511,0340011,Danbury School District,Pembroke School,177,185,362,2012-13
0345211,0340011,Danbury School District,Rogers Park Middle School,597,603,1200,2012-13
0341211,0340011,Danbury School District,Shelter Rock School,192,224,416,2012-13
0341011,0340011,Danbury School District,South Street School,181,187,368,2012-13
0341611,0340011,Danbury School District,Stadley Rough School,240,209,449,2012-13
0341911,0340011,Danbury School District,Western CT Academy of International Studies Elementary Magnet School,220,211,431,2012-13
0356111,0350011,Darien School District,Darien High School,671,658,1329,2012-13
0350211,0350011,Darien School District,Hindley Elementary School,273,306,579,2012-13
0350711,0350011,Darien School District,Holmes Elementary School,220,213,433,2012-13
0355111,0350011,Darien School District,Middlesex Middle School,538,597,1135,2012-13
0351311,0350011,Darien School District,Ox Ridge Elementary School,217,257,474,2012-13
0350511,0350011,Darien School District,Royle Elementary School,198,215,413,2012-13
0350611,0350011,Darien School District,Tokeneke Elementary School,238,258,496,2012-13
0360111,0360011,Deep River School District,Deep River Elementary School,176,171,347,2012-13
3370215,3370015,Department of Mental Health and Addiction Services,Connecticut Valley Hospital,*,*,*,2012-13
0370611,0370011,Derby School District,Bradley School,180,165,345,2012-13
0376111,0370011,Derby School District,Derby High School,175,186,361,2012-13
0375011,0370011,Derby School District,Derby Middle School,185,181,366,2012-13
0370411,0370011,Derby School District,Irving School,200,220,420,2012-13
0400111,0400011,East Granby School District,Allgrove School,100,141,241,2012-13
0406111,0400011,East Granby School District,East Granby High School,121,150,271,2012-13
0405111,0400011,East Granby School District,East Granby Middle School,104,109,213,2012-13
0400211,0400011,East Granby School District,R. Dudley Seymour School,76,61,137,2012-13
0410111,0410011,East Haddam School District,East Haddam Elementary School,172,165,337,2012-13
0416111,0410011,East Haddam School District,Nathan Hale-Ray High School,197,202,399,2012-13
0415111,0410011,East Haddam School District,Nathan Hale-Ray Middle School,250,258,508,2012-13
0420311,0420011,East Hampton School District,Center School,132,153,285,2012-13
0426111,0420011,East Hampton School District,East Hampton High School,282,241,523,2012-13
0425111,0420011,East Hampton School District,East Hampton Middle School,224,225,449,2012-13
0420111,0420011,East Hampton School District,Memorial School,300,331,631,2012-13
0429011,0420011,East Hampton School District,The Learning Center at East Hampton,*,*,6,2012-13
0430911,0430011,East Hartford School District,Anna E. Norris School,138,142,280,2012-13
0436311,0430011,East Hartford School District,Connecticut IB Academy,121,67,188,2012-13
0430611,0430011,East Hartford School District,Dr. Franklin H. Mayberry School,186,185,371,2012-13
0432211,0430011,East Hartford School District,Dr. John A. Langford School,169,218,387,2012-13
0431011,0430011,East Hartford School District,Dr. Thomas S. O'Connell School,241,263,504,2012-13
0436211,0430011,East Hartford School District,East Hartford High School,815,827,1642,2012-13
0435111,0430011,East Hartford School District,East Hartford Middle School,503,541,1044,2012-13
0432011,0430011,East Hartford School District,Governor William Pitkin School,151,172,323,2012-13
0430511,0430011,East Hartford School District,Hockanum School,149,144,293,2012-13
0430411,0430011,East Hartford School District,Joseph O. Goodwin School,160,154,314,2012-13
0431811,0430011,East Hartford School District,Robert J. O'Brien School,222,284,506,2012-13
0431211,0430011,East Hartford School District,Silver Lane School,142,133,275,2012-13
0436411,0430011,East Hartford School District,Stevens Alternate High School,52,121,173,2012-13
0432411,0430011,East Hartford School District,Sunset Ridge Middle School,174,134,308,2012-13
0438011,0430011,East Hartford School District,Willowbrook Early Childhood,105,132,237,2012-13
0439011,0430011,East Hartford School District,Woodland School,29,162,191,2012-13
0441711,0440011,East Haven School District,Carbone School/East Haven Academy,152,127,279,2012-13
0441411,0440011,East Haven School District,D. C. Moore School,130,139,269,2012-13
0440111,0440011,East Haven School District,Deer Run School,160,169,329,2012-13
0441311,0440011,East Haven School District,Dominick H. Ferrara School,107,121,228,2012-13
0446111,0440011,East Haven School District,East Haven High School,459,464,923,2012-13
0441011,0440011,East Haven School District,Grove J. Tuttle School,90,97,187,2012-13
0445111,0440011,East Haven School District,Joseph Melillo Middle School,272,322,594,2012-13
0440711,0440011,East Haven School District,Momauguin School,79,101,180,2012-13
0441811,0440011,East Haven School District,Overbrook Elementary School,93,97,190,2012-13
0449011,0440011,East Haven School District,Pathways,7,32,39,2012-13
0456111,0450011,East Lyme School District,East Lyme High School,579,550,1129,2012-13
0455111,0450011,East Lyme School District,East Lyme Middle School,449,422,871,2012-13
0450111,0450011,East Lyme School District,Flanders School,163,198,361,2012-13
0458011,0450011,East Lyme School District,Integrated Preschool,16,24,40,2012-13
0450411,0450011,East Lyme School District,Lillie B. Haynes School,164,171,335,2012-13
0450211,0450011,East Lyme School District,Niantic Center School,94,104,198,2012-13
0470111,0470011,East Windsor School District,Broad Brook Elementary School,265,249,514,2012-13
0476111,0470011,East Windsor School District,East Windsor High School,170,192,362,2012-13
0475411,0470011,East Windsor School District,East Windsor Middle School,192,186,378,2012-13
2536014,2530014,Eastern Connecticut Regional Educational Service Center (EASTCONN),Arts at the Capitol Theater Magnet School (ACT),95,41,136,2012-13
2539014,2530014,Eastern Connecticut Regional Educational Service Center (EASTCONN),EastConn Special Education,17,66,83,2012-13
2536114,2530014,Eastern Connecticut Regional Educational Service Center (EASTCONN),Quinebaug Middle College,57,54,111,2012-13
0390111,0390011,Eastford School District,Eastford Elementary School,82,86,168,2012-13
0465111,0460011,Easton School District,Helen Keller Middle School,166,224,390,2012-13
0460111,0460011,Easton School District,Samuel Staples Elementary School,300,329,629,2012-13
2428014,2420014,EdAdvance,EdAdvance Headstart,112,104,216,2012-13
2429014,2420014,EdAdvance,The ACCESS School at The Danuta M. Thibodeau Education Center,9,24,33,2012-13
0480111,0480011,Ellington School District,Center School,217,215,432,2012-13
0480211,0480011,Ellington School District,Crystal Lake School,91,119,210,2012-13
0486111,0480011,Ellington School District,Ellington High School,419,370,789,2012-13
0485111,0480011,Ellington School District,Ellington Middle School,200,228,428,2012-13
0480711,0480011,Ellington School District,Windermere Intermediate School,195,227,422,2012-13
0480611,0480011,Ellington School District,Windermere School,219,214,433,2012-13
2890113,2890013,Elm City College Preparatory School District,Elm City College Preparatory School,322,282,604,2012-13
0491311,0490011,Enfield School District,Edgar H. Parkman School,179,180,359,2012-13
0491611,0490011,Enfield School District,Eli Whitney School,184,212,396,2012-13
0496111,0490011,Enfield School District,Enfield High School,348,379,727,2012-13
0490211,0490011,Enfield School District,Enfield Street School,159,143,302,2012-13
0499011,0490011,Enfield School District,Enfield Transitional Learning Academy,11,10,21,2012-13
0496211,0490011,Enfield School District,Enrico Fermi High School,489,499,988,2012-13
0490411,0490011,Enfield School District,Hazardville Memorial School,177,204,381,2012-13
0498011,0490011,Enfield School District,Head Start Program,51,53,104,2012-13
0491811,0490011,Enfield School District,Henry Barnard School,182,203,385,2012-13
0495211,0490011,Enfield School District,John F. Kennedy Middle School,549,599,1148,2012-13
0491111,0490011,Enfield School District,Nathan Hale School,120,102,222,2012-13
0491511,0490011,Enfield School District,Prudence Crandall School,207,219,426,2012-13
0500111,0500011,Essex School District,Essex Elementary School,246,282,528,2012-13
2726113,2720013,Explorations District,Explorations,34,39,73,2012-13
0510211,0510011,Fairfield School District,Burr Elementary School,217,228,445,2012-13
0510111,0510011,Fairfield School District,Dwight Elementary School,136,142,278,2012-13
0518011,0510011,Fairfield School District,Early Childhood Center,46,86,132,2012-13
0516011,0510011,Fairfield School District,Fairfield Ludlowe High School,815,737,1552,2012-13
0516211,0510011,Fairfield School District,Fairfield Warde High School,691,727,1418,2012-13
0515211,0510011,Fairfield School District,Fairfield Woods Middle School,397,454,851,2012-13
0510411,0510011,Fairfield School District,Holland Hill School,201,179,380,2012-13
0511711,0510011,Fairfield School District,Jennings School,145,189,334,2012-13
0510611,0510011,Fairfield School District,McKinley School,220,220,440,2012-13
0510711,0510011,Fairfield School District,Mill Hill School,219,226,445,2012-13
0511611,0510011,Fairfield School District,North Stratfield School,211,243,454,2012-13
0511811,0510011,Fairfield School District,Osborn Hill School,247,271,518,2012-13
0511211,0510011,Fairfield School District,Riverfield School,200,209,409,2012-13
0515311,0510011,Fairfield School District,Roger Ludlowe Middle School,455,485,940,2012-13
0511311,0510011,Fairfield School District,Sherman School,233,216,449,2012-13
0511411,0510011,Fairfield School District,Stratfield School,230,275,505,2012-13
0515111,0510011,Fairfield School District,Tomlinson Middle School,364,380,744,2012-13
0520411,0520011,Farmington School District,East Farms School,211,224,435,2012-13
0528011,0520011,Farmington School District,Farmington Collaborative PK,28,33,61,2012-13
0526111,0520011,Farmington School District,Farmington High School,629,693,1322,2012-13
0525111,0520011,Farmington School District,Irving A. Robbins Middle School,280,330,610,2012-13
0520211,0520011,Farmington School District,Noah Wallace School,174,184,358,2012-13
0520111,0520011,Farmington School District,Union School,158,162,320,2012-13
0520311,0520011,Farmington School District,West District School,178,187,365,2012-13
0520511,0520011,Farmington School District,West Woods Upper Elementary School,273,305,578,2012-13
0530111,0530011,Franklin School District,Franklin Elementary School,99,101,200,2012-13
0540211,0540011,Glastonbury School District,Buttonball Lane School,254,232,486,2012-13
0540311,0540011,Glastonbury School District,Eastbury School,149,170,319,2012-13
0540811,0540011,Glastonbury School District,Gideon Welles School,246,279,525,2012-13
0546111,0540011,Glastonbury School District,Glastonbury High School,1153,1086,2239,2012-13
0540411,0540011,Glastonbury School District,Hebron Avenue School,228,243,471,2012-13
0540611,0540011,Glastonbury School District,Hopewell School,217,239,456,2012-13
0540711,0540011,Glastonbury School District,Naubuc School,238,204,442,2012-13
0540911,0540011,Glastonbury School District,Nayaug Elementary School,335,288,623,2012-13
0545211,0540011,Glastonbury School District,Smith Middle School,512,513,1025,2012-13
0560111,0560011,Granby School District,Frank M. Kearns Primary School,186,200,386,2012-13
0566111,0560011,Granby School District,Granby Memorial High School,370,389,759,2012-13
0565111,0560011,Granby School District,Granby Memorial Middle School,162,167,329,2012-13
0560411,0560011,Granby School District,Kelly Lane Primary School,161,166,327,2012-13
0560311,0560011,Granby School District,Wells Road Intermediate School,147,156,303,2012-13
0575111,0570011,Greenwich School District,Central Middle School,289,310,599,2012-13
0570211,0570011,Greenwich School District,Cos Cob School,217,217,434,2012-13
0575211,0570011,Greenwich School District,Eastern Middle School,392,390,782,2012-13
0570411,0570011,Greenwich School District,Glenville School,208,199,407,2012-13
0576111,0570011,Greenwich School District,Greenwich High School,1306,1371,2677,2012-13
0570511,0570011,Greenwich School District,Hamilton Avenue School,206,203,409,2012-13
0571311,0570011,Greenwich School District,International School At Dundee,202,167,369,2012-13
0570311,0570011,Greenwich School District,Julian Curtiss School,173,171,344,2012-13
0570611,0570011,Greenwich School District,New Lebanon School,114,147,261,2012-13
0570711,0570011,Greenwich School District,North Mianus School,222,243,465,2012-13
0570811,0570011,Greenwich School District,North Street School,195,219,414,2012-13
0570911,0570011,Greenwich School District,Old Greenwich School,205,220,425,2012-13
0571111,0570011,Greenwich School District,Parkway School,115,157,272,2012-13
0571011,0570011,Greenwich School District,Riverside School,212,270,482,2012-13
0575311,0570011,Greenwich School District,Western Middle School,242,262,504,2012-13
0580311,0580011,Griswold School District,Griswold Elementary School,361,388,749,2012-13
0586211,0580011,Griswold School District,Griswold High School,314,310,624,2012-13
0585111,0580011,Griswold School District,Griswold Middle School,288,297,585,2012-13
0595311,0590011,Groton School District,Carl C. Cutler Middle School,223,239,462,2012-13
0592011,0590011,Groton School District,Catherine Kolnaski Magnet School,187,231,418,2012-13
0591811,0590011,Groton School District,Charles Barnum School,217,184,401,2012-13
0590311,0590011,Groton School District,Claude Chester School,179,171,350,2012-13
0591711,0590011,Groton School District,Mary Morrisson School,176,187,363,2012-13
0591911,0590011,Groton School District,Northeast Academy Elementary School,196,207,403,2012-13
0591211,0590011,Groton School District,Pleasant Valley School,160,180,340,2012-13
0596111,0590011,Groton School District,Robert E. Fitch High School,600,583,1183,2012-13
0590111,0590011,Groton School District,S. B. Butler School,172,180,352,2012-13
0595211,0590011,Groton School District,West Side Middle School,244,262,506,2012-13
0600711,0600011,Guilford School District,A. Baldwin Middle School,288,278,566,2012-13
0600611,0600011,Guilford School District,A. W. Cox School,155,177,332,2012-13
0600411,0600011,Guilford School District,Calvin Leete School,138,154,292,2012-13
0605111,0600011,Guilford School District,E. C. Adams Middle School,300,292,592,2012-13
0606111,0600011,Guilford School District,Guilford High School,521,549,1070,2012-13
0600211,0600011,Guilford School District,Guilford Lakes School,177,185,362,2012-13
0600311,0600011,Guilford School District,Melissa Jones School,164,184,348,2012-13
0628011,0620011,Hamden School District,Alice Peck Learning Center,38,62,100,2012-13
0621211,0620011,Hamden School District,Bear Path School,230,233,463,2012-13
0620211,0620011,Hamden School District,Church Street School,187,183,370,2012-13
0620311,0620011,Hamden School District,Dunbar Hill School,148,160,308,2012-13
0626111,0620011,Hamden School District,Hamden High School,871,931,1802,2012-13
0625211,0620011,Hamden School District,Hamden Middle School,420,479,899,2012-13
0620411,0620011,Hamden School District,Helen Street School,116,172,288,2012-13
0621111,0620011,Hamden School District,Ridge Hill School,151,183,334,2012-13
0620111,0620011,Hamden School District,Shepherd Glen School,164,172,336,2012-13
0621011,0620011,Hamden School District,Spring Glen School,207,222,429,2012-13
0621411,0620011,Hamden School District,West Woods School,233,228,461,2012-13
0630111,0630011,Hampton School District,Hampton Elementary School,42,74,116,2012-13
0640711,0640011,Hartford School District,Asian Studies Academy at Bellizzi School,258,298,556,2012-13
0640411,0640011,Hartford School District,Batchelder School,240,280,520,2012-13
0642811,0640011,Hartford School District,Betances Early Reading Lab Magnet School,147,176,323,2012-13
0643811,0640011,Hartford School District,Betances STEM Magnet School,29,58,87,2012-13
0643511,0640011,Hartford School District,Breakthrough II Magnet School,112,110,222,2012-13
0643311,0640011,Hartford School District,Breakthrough Magnet School,189,166,355,2012-13
0647111,0640011,Hartford School District,Bulkeley High School,183,224,407,2012-13
0646111,0640011,Hartford School District,Bulkeley High School Lower School,252,334,586,2012-13
0640611,0640011,Hartford School District,Burns Latino Studies Academy,287,311,598,2012-13
0642311,0640011,Hartford School District,Burr School,335,394,729,2012-13
0646911,0640011,Hartford School District,Capital Preparatory Magnet School,353,321,674,2012-13
0642411,0640011,Hartford School District,Clark School,190,189,379,2012-13
0646411,0640011,Hartford School District,Classical Magnet School,410,291,701,2012-13
0646011,0640011,Hartford School District,Culinary Arts Academy at Weaver High School,120,124,244,2012-13
0645311,0640011,Hartford School District,Dr. Joseph Bellizzi Middle School,23,34,57,2012-13
0640911,0640011,Hartford School District,Environmental Sciences Magnet at Hooker School,242,328,570,2012-13
0643211,0640011,Hartford School District,Expeditionary Learning Academy at Moylan School,331,371,702,2012-13
0643611,0640011,Hartford School District,Global Communications Academy,222,198,420,2012-13
0647911,0640011,Hartford School District,Great Path Academy at MCC,171,103,274,2012-13
0647211,0640011,Hartford School District,HPHS Engineering and Green Technology Academy,132,306,438,2012-13
0647411,0640011,Hartford School District,HPHS Law and Government Academy,268,265,533,2012-13
0647511,0640011,Hartford School District,HPHS Nursing and Health Sciences Academy,330,159,489,2012-13
0645411,0640011,Hartford School District,Hartford Magnet Trinity College Academy,462,358,820,2012-13
0649011,0640011,Hartford School District,Hartford Transitional Learning Academy (Elementary),6,34,40,2012-13
0647611,0640011,Hartford School District,"High School, Inc.",185,188,373,2012-13
0647711,0640011,Hartford School District,Journalism and Media Academy Magnet School,86,109,195,2012-13
0641011,0640011,Hartford School District,Kennelly School,357,346,703,2012-13
0641111,0640011,Hartford School District,Kinsella Magnet School of Performing Arts,464,296,760,2012-13
0640811,0640011,Hartford School District,M. D. Fox School,256,277,533,2012-13
0641611,0640011,Hartford School District,"M. L. King, Jr. School",172,210,382,2012-13
0641211,0640011,Hartford School District,McDonough Middle School,182,203,385,2012-13
0641911,0640011,Hartford School District,Milner School,203,170,373,2012-13
0643711,0640011,Hartford School District,Montessori Magnet at Fisher School,143,136,279,2012-13
0641411,0640011,Hartford School District,Naylor/CCSU Leadership Academy,342,381,723,2012-13
0647811,0640011,Hartford School District,OPPortunity High School,47,63,110,2012-13
0641511,0640011,Hartford School District,Parkville Community School,275,289,564,2012-13
0646611,0640011,Hartford School District,Pathways Academy of Technology and Design,115,214,329,2012-13
0641711,0640011,Hartford School District,Rawson School,247,325,572,2012-13
0644011,0640011,Hartford School District,Renzulli Gifted and Talented Academy,76,45,121,2012-13
0640111,0640011,Hartford School District,SAND School,227,257,484,2012-13
0642511,0640011,Hartford School District,STEM Magnet at Fisher School,133,223,356,2012-13
0643011,0640011,Hartford School District,Sanchez School,231,263,494,2012-13
0642611,0640011,Hartford School District,Simpson-Waverly School,155,171,326,2012-13
0646511,0640011,Hartford School District,Sports and Medical Sciences Academy,346,346,692,2012-13
0646711,0640011,Hartford School District,University High School of Science and Engineering,130,273,403,2012-13
0642011,0640011,Hartford School District,Webster Micro Society Magnet School,288,338,626,2012-13
0642111,0640011,Hartford School District,West Middle School,294,341,635,2012-13
0642211,0640011,Hartford School District,Wish Museum School,195,197,392,2012-13
0650111,0650011,Hartland School District,Hartland School,94,120,214,2012-13
0670211,0670011,Hebron School District,Gilead Hill School,171,181,352,2012-13
0670111,0670011,Hebron School District,Hebron Elementary School,276,308,584,2012-13
2860113,2860013,Highville Charter School District,Highville Charter School,176,165,341,2012-13
2640113,2640013,Integrated Day Charter School District,Integrated Day Charter School,161,169,330,2012-13
2655113,2650013,Interdistrict School for Arts and Comm District,Interdistrict School For Arts And Communication,109,82,191,2012-13
2610113,2610013,Jumoke Academy District,Jumoke Academy,331,258,589,2012-13
0680111,0680011,Kent School District,Kent Center School,125,146,271,2012-13
0698011,0690011,Killingly School District,Goodyear Early Childhood Center,33,54,87,2012-13
0690111,0690011,Killingly School District,Killingly Central School,221,244,465,2012-13
0696111,0690011,Killingly School District,Killingly High School,453,440,893,2012-13
0695211,0690011,Killingly School District,Killingly Intermediate School,392,399,791,2012-13
0690311,0690011,Killingly School District,Killingly Memorial School,219,217,436,2012-13
2456014,2450014,Learn,Connecticut River Academy,181,140,321,2012-13
2455014,2450014,Learn,Dual Language & Arts Magnet Middle School,59,47,106,2012-13
2459014,2450014,Learn,Learn Special Education,*,*,28,2012-13
2456114,2450014,Learn,Marine Science Magnet High School of Southeastern Connecticut,84,94,178,2012-13
2450114,2450014,Learn,Regional Multicultural Magnet School,278,271,549,2012-13
2450214,2450014,Learn,The Friendship School,253,260,513,2012-13
2456214,2450014,Learn,Three Rivers Middle College Magnet School,22,11,33,2012-13
0710111,0710011,Lebanon School District,Lebanon Elementary School,208,230,438,2012-13
0715111,0710011,Lebanon School District,Lebanon Middle School,166,202,368,2012-13
0716211,0710011,Lebanon School District,Lyman Memorial High School,250,173,423,2012-13
0720211,0720011,Ledyard School District,Gales Ferry School,97,128,225,2012-13
0720411,0720011,Ledyard School District,Gallup Hill School,174,181,355,2012-13
0720311,0720011,Ledyard School District,Juliet W. Long School,142,142,284,2012-13
0720111,0720011,Ledyard School District,Ledyard Center School,187,231,418,2012-13
0726111,0720011,Ledyard School District,Ledyard High School,495,466,961,2012-13
0725111,0720011,Ledyard School District,Ledyard Middle School,170,178,348,2012-13
0736011,0730011,Lisbon School District,Community Connection - The Big Picture High School,7,14,21,2012-13
0730111,0730011,Lisbon School District,Lisbon Central School,196,226,422,2012-13
0740211,0740011,Litchfield School District,Center School,139,141,280,2012-13
0746111,0740011,Litchfield School District,Litchfield High School,242,256,498,2012-13
0740311,0740011,Litchfield School District,Litchfield Intermediate School,129,122,251,2012-13
0766111,0760011,Madison School District,Daniel Hand High School,640,615,1255,2012-13
0760611,0760011,Madison School District,Dr. Robert H. Brown Middle School,283,250,533,2012-13
0760211,0760011,Madison School District,Island Avenue Elementary School,115,151,266,2012-13
0760111,0760011,Madison School District,J. Milton Jeffrey Elementary School,186,276,462,2012-13
0760311,0760011,Madison School District,Kathleen H. Ryerson Elementary School,103,121,224,2012-13
0769011,0760011,Madison School District,Town Campus Learning Center,18,30,48,2012-13
0765211,0760011,Madison School District,Walter C. Polson Upper Middle School,275,316,591,2012-13
0770111,0770011,Manchester School District,Bowers School,187,220,407,2012-13
0770311,0770011,Manchester School District,Buckley School,151,181,332,2012-13
0771711,0770011,Manchester School District,Elisabeth M. Bennet Academy,205,201,406,2012-13
0770411,0770011,Manchester School District,Highland Park School,123,141,264,2012-13
0775311,0770011,Manchester School District,Illing Middle School,380,416,796,2012-13
0770611,0770011,Manchester School District,Keeney School,175,171,346,2012-13
0776111,0770011,Manchester School District,Manchester High School,805,888,1693,2012-13
0778011,0770011,Manchester School District,Manchester Preschool Center,86,106,192,2012-13
0779011,0770011,Manchester School District,Manchester Regional Academy,19,61,80,2012-13
0779111,0770011,Manchester School District,Manchester Transition Center,6,8,14,2012-13
0771611,0770011,Manchester School District,Martin School,156,134,290,2012-13
0771011,0770011,Manchester School District,Robertson School,169,186,355,2012-13
0771211,0770011,Manchester School District,Verplanck School,150,180,330,2012-13
0771311,0770011,Manchester School District,Waddell School,163,189,352,2012-13
0771411,0770011,Manchester School District,Washington School,187,192,379,2012-13
0780411,0780011,Mansfield School District,Annie E. Vinton School,140,134,274,2012-13
0780211,0780011,Mansfield School District,Dorothy C. Goodwin School,95,126,221,2012-13
0785111,0780011,Mansfield School District,Mansfield Middle School,283,287,570,2012-13
0780511,0780011,Mansfield School District,Southeast Elementary School,124,128,252,2012-13
0790111,0790011,Marlborough School District,Elmer Thienes-Mary Hall Elementary School,303,336,639,2012-13
0800711,0800011,Meriden School District,Nathan Hale School,293,317,610,2012-13
0800111,0800011,Meriden School District,Benjamin Franklin School,223,277,500,2012-13
0801111,0800011,Meriden School District,Casimir Pulaski School,301,293,594,2012-13
0806111,0800011,Meriden School District,Francis T. Maloney High School,596,621,1217,2012-13
0800311,0800011,Meriden School District,Hanover School,279,290,569,2012-13
0800411,0800011,Meriden School District,Israel Putnam School,275,289,564,2012-13
0800511,0800011,Meriden School District,John Barry School,238,241,479,2012-13
0805211,0800011,Meriden School District,Lincoln Middle School,343,412,755,2012-13
0806211,0800011,Meriden School District,Orville H. Platt High School,547,627,1174,2012-13
0800811,0800011,Meriden School District,Roger Sherman School,251,249,500,2012-13
0801011,0800011,Meriden School District,Thomas Hooker School,205,223,428,2012-13
0805411,0800011,Meriden School District,Washington Middle School,358,425,783,2012-13
0830211,0830011,Middletown School District,Bielefield School,157,148,305,2012-13
0830511,0830011,Middletown School District,Farm Hill School,164,163,327,2012-13
0831511,0830011,Middletown School District,Keigwin Middle School,173,160,333,2012-13
0831311,0830011,Middletown School District,Lawrence School,153,174,327,2012-13
0830911,0830011,Middletown School District,MacDonough School,119,143,262,2012-13
0836211,0830011,Middletown School District,Middletown High School,634,673,1307,2012-13
0831211,0830011,Middletown School District,Moody School,141,149,290,2012-13
0831111,0830011,Middletown School District,Snow School,164,198,362,2012-13
0830111,0830011,Middletown School District,Spencer School,164,182,346,2012-13
0839111,0830011,Middletown School District,Transition to Life Center,6,8,14,2012-13
0831411,0830011,Middletown School District,Wesley School,165,164,329,2012-13
0835411,0830011,Middletown School District,Woodrow Wilson Middle School,319,359,678,2012-13
0840111,0840011,Milford School District,Calf Pen Meadow School,128,141,269,2012-13
0845111,0840011,Milford School District,East Shore Middle School,239,253,492,2012-13
0845211,0840011,Milford School District,Harborside Middle School,291,323,614,2012-13
0841911,0840011,Milford School District,J. F. Kennedy School,202,198,400,2012-13
0846211,0840011,Milford School District,Jonathan Law High School,498,503,1001,2012-13
0846311,0840011,Milford School District,Joseph A. Foran High School,492,508,1000,2012-13
0841611,0840011,Milford School District,Live Oaks School,158,149,307,2012-13
0841711,0840011,Milford School District,Mathewson School,182,224,406,2012-13
0840711,0840011,Milford School District,Meadowside School,203,244,447,2012-13
0840811,0840011,Milford School District,Orange Avenue School,174,221,395,2012-13
0841811,0840011,Milford School District,Orchard Hills School,171,185,356,2012-13
0841011,0840011,Milford School District,Pumpkin Delight School,184,208,392,2012-13
0845311,0840011,Milford School District,West Shore Middle School,278,286,564,2012-13
0850511,0850011,Monroe School District,Fawn Hollow Elementary School,234,289,523,2012-13
0855211,0850011,Monroe School District,Jockey Hollow School,402,451,853,2012-13
0856111,0850011,Monroe School District,Masuk High School,617,610,1227,2012-13
0850111,0850011,Monroe School District,Monroe Elementary School,193,177,370,2012-13
0850311,0850011,Monroe School District,Stepney Elementary School,258,245,503,2012-13
0860711,0860011,Montville School District,Dr. Charles E. Murphy School,168,196,364,2012-13
0865111,0860011,Montville School District,Leonard J. Tyl Middle School,299,298,597,2012-13
0860111,0860011,Montville School District,Mohegan School,194,174,368,2012-13
0866111,0860011,Montville School District,Montville High School,351,370,721,2012-13
0860511,0860011,Montville School District,Oakdale School,174,199,373,2012-13
0869011,0860011,Montville School District,Palmer Academy,8,15,23,2012-13
0880811,0880011,Naugatuck School District,Andrew Avenue School,111,136,247,2012-13
0888211,0880011,Naugatuck School District,Central Avenue Preschool,*,*,20,2012-13
0885111,0880011,Naugatuck School District,City Hill Middle School,354,349,703,2012-13
0880211,0880011,Naugatuck School District,Cross Street Intermediate School,124,128,252,2012-13
0888111,0880011,Naugatuck School District,Head Start,61,58,119,2012-13
0880411,0880011,Naugatuck School District,Hillside Intermediate School,176,238,414,2012-13
0880511,0880011,Naugatuck School District,Hop Brook Elementary School,166,187,353,2012-13
0880311,0880011,Naugatuck School District,Maple Hill School,247,274,521,2012-13
0886111,0880011,Naugatuck School District,Naugatuck High School,621,678,1299,2012-13
0880611,0880011,Naugatuck School District,Salem School,123,148,271,2012-13
0880711,0880011,Naugatuck School District,Western School,127,153,280,2012-13
2800113,2800013,New Beginnings Inc Family Academy District,New Beginnings Inc Family Academy,197,202,399,2012-13
0899111,0890011,New Britain School District,Brook Side School,18,30,48,2012-13
0899411,0890011,New Britain School District,CLIMB,*,*,13,2012-13
0890311,0890011,New Britain School District,Chamberlain  Elementary School,264,300,564,2012-13
0891111,0890011,New Britain School District,Frank J. DiLoreto School,495,406,901,2012-13
0890511,0890011,New Britain School District,Gaffney School,245,334,579,2012-13
0890611,0890011,New Britain School District,Holmes School,176,232,408,2012-13
0895411,0890011,New Britain School District,House of Arts Letters and Science (HALS)  Academy,96,73,169,2012-13
0890711,0890011,New Britain School District,Jefferson School,213,269,482,2012-13
0890811,0890011,New Britain School District,Lincoln School,355,399,754,2012-13
0896111,0890011,New Britain School District,New Britain High School,1209,1321,2530,2012-13
0899011,0890011,New Britain School District,New Britain Transition Center,9,38,47,2012-13
0890911,0890011,New Britain School District,Northend School,98,57,155,2012-13
0895311,0890011,New Britain School District,Pulaski Middle School,224,293,517,2012-13
0895111,0890011,New Britain School District,Roosevelt Middle School,209,218,427,2012-13
0895211,0890011,New Britain School District,Slade Middle School,351,375,726,2012-13
0891211,0890011,New Britain School District,Smalley Academy,253,303,556,2012-13
0891311,0890011,New Britain School District,Smith School,348,384,732,2012-13
0891511,0890011,New Britain School District,Vance School,299,324,623,2012-13
0900411,0900011,New Canaan School District,East School,267,298,565,2012-13
0906111,0900011,New Canaan School District,New Canaan High School,648,627,1275,2012-13
0905111,0900011,New Canaan School District,Saxe Middle School,626,662,1288,2012-13
0900211,0900011,New Canaan School District,South School,274,280,554,2012-13
0900311,0900011,New Canaan School District,West School,259,272,531,2012-13
0910111,0910011,New Fairfield School District,Consolidated School,249,286,535,2012-13
0910211,0910011,New Fairfield School District,Meeting House Hill School,286,313,599,2012-13
0916111,0910011,New Fairfield School District,New Fairfield High School,494,516,1010,2012-13
0915211,0910011,New Fairfield School District,New Fairfield Middle School,289,365,654,2012-13
0920311,0920011,New Hartford School District,Ann Antolini School,175,168,343,2012-13
0920111,0920011,New Hartford School District,Bakerville Consolidated School,55,55,110,2012-13
0920211,0920011,New Hartford School District,New Hartford Elementary School,60,52,112,2012-13
0931211,0930011,New Haven School District,Edgewood School,218,231,449,2012-13
0931411,0930011,New Haven School District,Nathan Hale School,269,288,557,2012-13
0931511,0930011,New Haven School District,Augusta Lewis Troup School,247,266,513,2012-13
0930211,0930011,New Haven School District,Barnard Environmental Magnet School,260,294,554,2012-13
0930311,0930011,New Haven School District,Beecher School,241,245,486,2012-13
0931811,0930011,New Haven School District,Benjamin Jepson Magnet School,255,306,561,2012-13
0935511,0930011,New Haven School District,Betsy Ross Arts Magnet School,328,160,488,2012-13
0934311,0930011,New Haven School District,Bishop Woods Architecture and Design Magnet School,257,259,516,2012-13
0932111,0930011,New Haven School District,Brennan Rogers School,187,218,405,2012-13
0934811,0930011,New Haven School District,"Celentano BioTech, Health and Medical Magnet School",214,239,453,2012-13
0930611,0930011,New Haven School District,Clinton Avenue School,283,284,567,2012-13
0934111,0930011,New Haven School District,Columbus Family Academy,239,228,467,2012-13
0933111,0930011,New Haven School District,Conte/West Hills Magnet School,302,323,625,2012-13
0936411,0930011,New Haven School District,Cooperative High School,429,209,638,2012-13
0936811,0930011,New Haven School District,Cortlandt V.R. Creed Health and Sport Sciences High School,43,154,197,2012-13
0930911,0930011,New Haven School District,Davis 21st Century Magnet Elementary School,260,251,511,2012-13
0935611,0930011,New Haven School District,Domus Academy,7,34,41,2012-13
0938211,0930011,New Haven School District,Dwight Early Childhood Program,30,16,46,2012-13
0938111,0930011,New Haven School District,Early Learning Center,54,63,117,2012-13
0934611,0930011,New Haven School District,East Rock Community Magnet School,211,223,434,2012-13
0931711,0930011,New Haven School District,Engineering - Science University Magnet School,117,270,387,2012-13
0931611,0930011,New Haven School District,Fair Haven School,341,364,705,2012-13
0938011,0930011,New Haven School District,Headstart,175,159,334,2012-13
0938311,0930011,New Haven School District,Helene Grant HeadStart,149,132,281,2012-13
0936611,0930011,New Haven School District,High School In The Community,134,107,241,2012-13
0930711,0930011,New Haven School District,Hill Central Music Academy,239,224,463,2012-13
0936311,0930011,New Haven School District,Hill Regional Career High School,419,279,698,2012-13
0936211,0930011,New Haven School District,James Hillhouse High School,469,507,976,2012-13
0931311,0930011,New Haven School District,John C. Daniels,238,270,508,2012-13
0930811,0930011,New Haven School District,John S. Martinez Sea and Sky STEM School,270,267,537,2012-13
0933011,0930011,New Haven School District,King/Robinson Magnet School,281,299,580,2012-13
0932011,0930011,New Haven School District,Lincoln-Bassett School,195,189,384,2012-13
0931911,0930011,New Haven School District,Mauro-Sheridan Magnet School,238,308,546,2012-13
0936011,0930011,New Haven School District,Metropolitan Business Academy,203,181,384,2012-13
0937011,0930011,New Haven School District,New Haven Academy,160,127,287,2012-13
0939211,0930011,New Haven School District,Polly T. McCabe Center,25,0,25,2012-13
0933511,0930011,New Haven School District,Quinnipiac Real World Math STEM School,152,113,265,2012-13
0939111,0930011,New Haven School District,Riverside Education Academy,43,70,113,2012-13
0934211,0930011,New Haven School District,Roberto Clemente Leadership Academy for Global Awareness,243,282,525,2012-13
0931011,0930011,New Haven School District,Ross/Woodward School,310,286,596,2012-13
0936711,0930011,New Haven School District,Sound School,136,198,334,2012-13
0932811,0930011,New Haven School District,Strong 21st Century Communications Magnet and SCSU Lab School,230,247,477,2012-13
0932911,0930011,New Haven School District,Truman School,239,257,496,2012-13
0934911,0930011,New Haven School District,West Rock Authors Academy,110,116,226,2012-13
0933211,0930011,New Haven School District,Wexler/Grant Community School,186,224,410,2012-13
0936111,0930011,New Haven School District,Wilbur Cross High School,651,707,1358,2012-13
0933811,0930011,New Haven School District,Worthington Hooker School,202,211,413,2012-13
0950311,0950011,New London School District,Jennings School,290,240,530,2012-13
0955111,0950011,New London School District,Bennie Dover Jackson Middle School,284,309,593,2012-13
0950911,0950011,New London School District,Nathan Hale Arts Magnet School,220,246,466,2012-13
0959111,0950011,New London School District,New London Clinical Day Program,6,12,18,2012-13
0956111,0950011,New London School District,New London High School,400,533,933,2012-13
0950811,0950011,New London School District,Winthrop STEM Elementary Magnet School,221,307,528,2012-13
0960511,0960011,New Milford School District,Hill And Plain School,192,272,464,2012-13
0960711,0960011,New Milford School District,John Pettibone School,203,216,419,2012-13
0969011,0960011,New Milford School District,Litchfield Hills Transition Center,*,*,11,2012-13
0966111,0960011,New Milford School District,New Milford High School,755,725,1480,2012-13
0960811,0960011,New Milford School District,Northville Elementary School,228,253,481,2012-13
0960911,0960011,New Milford School District,Sarah Noble Intermediate School,488,543,1031,2012-13
0965211,0960011,New Milford School District,Schaghticoke Middle School,348,366,714,2012-13
0940611,0940011,Newington School District,Anna Reynolds School,231,240,471,2012-13
0940211,0940011,Newington School District,Elizabeth Green School,148,156,304,2012-13
0940811,0940011,Newington School District,John Paterson School,205,244,449,2012-13
0945311,0940011,Newington School District,John Wallace Middle School,352,353,705,2012-13
0945111,0940011,Newington School District,Martin Kellogg Middle School,298,279,577,2012-13
0946111,0940011,Newington School District,Newington High School,711,711,1422,2012-13
0940711,0940011,Newington School District,Ruth Chaffee School,203,191,394,2012-13
0970111,0970011,Newtown School District,Hawley Elementary School,161,200,361,2012-13
0970411,0970011,Newtown School District,Head O'Meadow Elementary School,159,180,339,2012-13
0970311,0970011,Newtown School District,Middle Gate Elementary School,231,220,451,2012-13
0976111,0970011,Newtown School District,Newtown High School,855,905,1760,2012-13
0975111,0970011,Newtown School District,Newtown Middle School,415,477,892,2012-13
0978011,0970011,Newtown School District,Newtown Preschool,15,41,56,2012-13
0970511,0970011,Newtown School District,Reed Intermediate School,404,415,819,2012-13
0979011,0970011,Newtown School District,STARR,*,*,*,2012-13
0970211,0970011,Newtown School District,Sandy Hook Elementary School,233,221,454,2012-13
0980111,0980011,Norfolk School District,Botelle Elementary School,51,65,116,2012-13
0989211,0980011,Norfolk School District,Bridges II,*,*,*,2012-13
0990411,0990011,North Branford School District,Jerome Harrison School,187,254,441,2012-13
0996111,0990011,North Branford School District,North Branford High School,324,312,636,2012-13
0995111,0990011,North Branford School District,North Branford Intermediate School,275,261,536,2012-13
0999011,0990011,North Branford School District,School to Work Program,*,*,*,2012-13
0990611,0990011,North Branford School District,Totoket Valley Elementary School,249,219,468,2012-13
1000111,1000011,North Canaan School District,North Canaan Elementary School,168,147,315,2012-13
1010811,1010011,North Haven School District,Clintonville Elementary School,167,210,377,2012-13
1010711,1010011,North Haven School District,Green Acres Elementary School,176,218,394,2012-13
1010211,1010011,North Haven School District,Montowese Elementary School,193,172,365,2012-13
1016111,1010011,North Haven School District,North Haven High School,598,589,1187,2012-13
1015211,1010011,North Haven School District,North Haven Middle School,371,402,773,2012-13
1010311,1010011,North Haven School District,Ridge Road Elementary School,199,205,404,2012-13
1020111,1020011,North Stonington School District,North Stonington Elementary School,191,194,385,2012-13
1026111,1020011,North Stonington School District,Wheeler High School,103,100,203,2012-13
1025111,1020011,North Stonington School District,Wheeler Middle School,77,99,176,2012-13
1036211,1030011,Norwalk School District,Brien McMahon High School,862,796,1658,2012-13
1030211,1030011,Norwalk School District,Brookside Elementary School,245,275,520,2012-13
1030311,1030011,Norwalk School District,Columbus Magnet School,176,152,328,2012-13
1030411,1030011,Norwalk School District,Cranbury Elementary School,242,261,503,2012-13
1032011,1030011,Norwalk School District,Fox Run Elementary School,212,244,456,2012-13
1030711,1030011,Norwalk School District,Jefferson Magnet School,283,296,579,2012-13
1030811,1030011,Norwalk School District,Kendall Elementary School,260,288,548,2012-13
1032211,1030011,Norwalk School District,Marvin Elementary School,222,262,484,2012-13
1032111,1030011,Norwalk School District,Naramake Elementary School,225,237,462,2012-13
1035211,1030011,Norwalk School District,Nathan Hale Middle School,298,312,610,2012-13
1036111,1030011,Norwalk School District,Norwalk High School,768,771,1539,2012-13
1036311,1030011,Norwalk School District,Norwalk Pathways Academy at Briggs,20,32,52,2012-13
1035311,1030011,Norwalk School District,Ponus Ridge Middle School,291,320,611,2012-13
1035511,1030011,Norwalk School District,Roton Middle School,216,229,445,2012-13
1031311,1030011,Norwalk School District,Rowayton School,219,242,461,2012-13
1032311,1030011,Norwalk School District,Silvermine Elementary School,225,245,470,2012-13
1031411,1030011,Norwalk School District,Tracey School,186,208,394,2012-13
1035411,1030011,Norwalk School District,West Rocks Middle School,305,345,650,2012-13
1032411,1030011,Norwalk School District,Wolfpit School,129,173,302,2012-13
9016122,9010022,Norwich Free Academy District,Norwich Free Academy,1193,1071,2264,2012-13
1040111,1040011,Norwich School District,Bishop School Early Learning Center,*,*,16,2012-13
1049111,1040011,Norwich School District,Deborah-Tennant Zinewicz  School,8,28,36,2012-13
1049011,1040011,Norwich School District,Hickory Street School,*,*,16,2012-13
1041411,1040011,Norwich School District,John B. Stanton Network School,184,228,412,2012-13
1045111,1040011,Norwich School District,Kelly Middle School,327,372,699,2012-13
1042011,1040011,Norwich School District,Moriarty Magnet School,229,217,446,2012-13
1040811,1040011,Norwich School District,Samuel Huntington School,218,245,463,2012-13
1045211,1040011,Norwich School District,Teachers' Memorial Middle School,235,216,451,2012-13
1041711,1040011,Norwich School District,Thomas W. Mahan School,189,150,339,2012-13
1041911,1040011,Norwich School District,Uncas Network School,128,149,277,2012-13
1041811,1040011,Norwich School District,Veterans' Memorial School,172,172,344,2012-13
1049211,1040011,Norwich School District,Virtual Learning Academy,*,*,14,2012-13
1041511,1040011,Norwich School District,Wequonnoc Magnet School,137,141,278,2012-13
2635113,2630013,Odyssey Community School District,Odyssey Community School,157,167,324,2012-13
1060211,1060011,Old Saybrook School District,Kathleen E. Goodwin School,219,196,415,2012-13
1065211,1060011,Old Saybrook School District,Old Saybrook Middle School,278,275,553,2012-13
1066111,1060011,Old Saybrook School District,Old Saybrook Senior High School,269,258,527,2012-13
1070211,1070011,Orange School District,Mary L. Tracy School,85,90,175,2012-13
1070511,1070011,Orange School District,Peck Place School,204,176,380,2012-13
1070311,1070011,Orange School District,Race Brook School,193,183,376,2012-13
1070411,1070011,Orange School District,Turkey Hill School,149,167,316,2012-13
1085111,1080011,Oxford School District,Great Oak School,260,269,529,2012-13
1080111,1080011,Oxford School District,Oxford Center School,270,237,507,2012-13
1086011,1080011,Oxford School District,Oxford High School,305,284,589,2012-13
1080311,1080011,Oxford School District,Quaker Farms School,234,236,470,2012-13
2835113,2830013,Park City Prep Charter School District,Park City Prep Charter School,116,135,251,2012-13
1098011,1090011,Plainfield School District,Early Childhood Center,7,11,18,2012-13
1090111,1090011,Plainfield School District,Moosup Elementary School,188,170,358,2012-13
1095111,1090011,Plainfield School District,Plainfield Central School,295,292,587,2012-13
1096111,1090011,Plainfield School District,Plainfield High School,370,370,740,2012-13
1090311,1090011,Plainfield School District,Plainfield Memorial School,194,192,386,2012-13
1090411,1090011,Plainfield School District,Shepard Hill Elementary School,195,208,403,2012-13
1100411,1100011,Plainville School District,Frank T. Wheeler School,126,141,267,2012-13
1100211,1100011,Plainville School District,Linden Street School,193,217,410,2012-13
1100511,1100011,Plainville School District,Louis Toffolon School,178,175,353,2012-13
1105211,1100011,Plainville School District,Middle School of Plainville,255,283,538,2012-13
1106111,1100011,Plainville School District,Plainville High School,374,367,741,2012-13
1108011,1100011,Plainville School District,Prekindergarten Program,19,29,48,2012-13
1115111,1110011,Plymouth School District,Eli Terry Jr. Middle School,194,228,422,2012-13
1110411,1110011,Plymouth School District,Harry S. Fisher Elementary School,170,164,334,2012-13
1110211,1110011,Plymouth School District,Plymouth Center School,167,193,360,2012-13
1116111,1110011,Plymouth School District,Terryville High School,226,264,490,2012-13
1120111,1120011,Pomfret School District,Pomfret Community School,235,237,472,2012-13
1130511,1130011,Portland School District,Brownstone Intermediate School,126,118,244,2012-13
1130411,1130011,Portland School District,Gildersleeve School,103,108,211,2012-13
1136111,1130011,Portland School District,Portland High School,186,188,374,2012-13
1135111,1130011,Portland School District,Portland Middle School,120,110,230,2012-13
1130211,1130011,Portland School District,Valley View School,163,153,316,2012-13
1145111,1140011,Preston School District,Preston Plains School,71,64,135,2012-13
1140411,1140011,Preston School District,Preston Veterans' Memorial School,137,134,271,2012-13
1169011,1160011,Putnam School District,Helping Hands,*,*,*,2012-13
1160311,1160011,Putnam School District,Putnam Elementary School,309,356,665,2012-13
1166111,1160011,Putnam School District,Putnam High School,133,161,294,2012-13
1165111,1160011,Putnam School District,Putnam Middle School,152,147,299,2012-13
1175111,1170011,Redding School District,John Read Middle School,274,279,553,2012-13
1170111,1170011,Redding School District,Redding Elementary School,275,304,579,2012-13
2016112,2010012,Regional School District 01,Housatonic Valley Regional High School,224,197,421,2012-13
2045112,2040012,Regional School District 04,John Winthrop Middle School,189,177,366,2012-13
2046112,2040012,Regional School District 04,Valley Regional High School,326,298,624,2012-13
2055112,2050012,Regional School District 05,Amity Middle School: Bethany,176,179,355,2012-13
2055212,2050012,Regional School District 05,Amity Middle School: Orange,184,188,372,2012-13
2056112,2050012,Regional School District 05,Amity Regional High School,776,845,1621,2012-13
2068112,2060012,Regional School District 06,Early Childhood Learning Center,15,26,41,2012-13
2060112,2060012,Regional School District 06,Goshen Center School,103,88,191,2012-13
2060212,2060012,Regional School District 06,James Morris School,72,86,158,2012-13
2066112,2060012,Regional School District 06,Wamogo Regional High School,283,278,561,2012-13
2060312,2060012,Regional School District 06,Warren Elementary School,41,37,78,2012-13
2079112,2070012,Regional School District 07,AIM,*,*,15,2012-13
2079012,2070012,Regional School District 07,FLEX,*,*,6,2012-13
2079412,2070012,Regional School District 07,Intensive Learning Program,*,*,*,2012-13
2079212,2070012,Regional School District 07,Links,*,*,13,2012-13
2076112,2070012,Regional School District 07,Northwestern Regional High School,367,347,714,2012-13
2075112,2070012,Regional School District 07,Northwestern Regional Middle School,192,168,360,2012-13
2079312,2070012,Regional School District 07,STEP,*,*,17,2012-13
2086112,2080012,Regional School District 08,RHAM High School,524,609,1133,2012-13
2085112,2080012,Regional School District 08,RHAM Middle School,296,331,627,2012-13
2086212,2080012,Regional School District 08,Region Alternative High School,*,*,7,2012-13
2096112,2090012,Regional School District 09,Joel Barlow High School,526,486,1012,2012-13
2105112,2100012,Regional School District 10,Har-Bur Middle School,412,438,850,2012-13
2100312,2100012,Regional School District 10,Harwinton Consolidated School,216,248,464,2012-13
2100212,2100012,Regional School District 10,Lake Garda Elementary School,234,274,508,2012-13
2106112,2100012,Regional School District 10,Lewis S. Mills High School,390,412,802,2012-13
2116112,2110012,Regional School District 11,Parish Hill High School,133,147,280,2012-13
2120212,2120012,Regional School District 12,Booth Free School,47,47,94,2012-13
2128012,2120012,Regional School District 12,Early Childhood Education Center,10,11,21,2012-13
2126112,2120012,Regional School District 12,Shepaug Valley High School,143,177,320,2012-13
2125112,2120012,Regional School District 12,Shepaug Valley Middle School,98,101,199,2012-13
2120112,2120012,Regional School District 12,The Burnham School,38,31,69,2012-13
2120412,2120012,Regional School District 12,Washington Primary School,75,63,138,2012-13
2136112,2130012,Regional School District 13,Coginchaug Regional High School,298,279,577,2012-13
2130212,2130012,Regional School District 13,Francis E. Korn School,69,105,174,2012-13
2135112,2130012,Regional School District 13,Frank Ward Strong School,156,178,334,2012-13
2130112,2130012,Regional School District 13,Frederick Brewster School,119,123,242,2012-13
2130512,2130012,Regional School District 13,John Lyman School,148,135,283,2012-13
2130412,2130012,Regional School District 13,Middlefield Memorial School,157,186,343,2012-13
2140112,2140012,Regional School District 14,Bethlehem Elementary School,159,122,281,2012-13
2148012,2140012,Regional School District 14,Integrated Star Preschool Program,25,21,46,2012-13
2140212,2140012,Regional School District 14,Mitchell Elementary School,172,207,379,2012-13
2146112,2140012,Regional School District 14,Nonnewaug High School,452,354,806,2012-13
2145112,2140012,Regional School District 14,Woodbury Middle School,207,204,411,2012-13
2150412,2150012,Regional School District 15,Gainfield Elementary School,195,179,374,2012-13
2150712,2150012,Regional School District 15,Long Meadow Elementary School,266,296,562,2012-13
2155212,2150012,Regional School District 15,Memorial Middle School,234,252,486,2012-13
2150612,2150012,Regional School District 15,Middlebury Elementary School,203,218,421,2012-13
2156212,2150012,Regional School District 15,Pomperaug Regional High School,607,652,1259,2012-13
2150512,2150012,Regional School District 15,Pomperaug School,205,242,447,2012-13
2155112,2150012,Regional School District 15,Rochambeau Middle School,237,289,526,2012-13
2160312,2160012,Regional School District 16,Algonquin School,252,211,463,2012-13
2160212,2160012,Regional School District 16,Community School,102,112,214,2012-13
2160112,2160012,Regional School District 16,Laurel Ledge School,202,259,461,2012-13
2165112,2160012,Regional School District 16,Long River Middle School,293,264,557,2012-13
2166012,2160012,Regional School District 16,Woodland Regional High School,364,356,720,2012-13
2170212,2170012,Regional School District 17,Burr District Elementary School,151,168,319,2012-13
2170112,2170012,Regional School District 17,Haddam Elementary School,111,141,252,2012-13
2176112,2170012,Regional School District 17,Haddam-Killingworth High School,324,310,634,2012-13
2175112,2170012,Regional School District 17,Haddam-Killingworth Middle School,391,377,768,2012-13
2170312,2170012,Regional School District 17,Killingworth Elementary School,160,179,339,2012-13
2180312,2180012,Regional School District 18,Center School,130,131,261,2012-13
2180112,2180012,Regional School District 18,Lyme Consolidated School,93,95,188,2012-13
2186112,2180012,Regional School District 18,Lyme-Old Lyme High School,193,228,421,2012-13
2185112,2180012,Regional School District 18,Lyme-Old Lyme Middle School,190,170,360,2012-13
2180212,2180012,Regional School District 18,Mile Creek School,106,110,216,2012-13
2196112,2190012,Regional School District 19,E. O. Smith High School,623,600,1223,2012-13
1180811,1180011,Ridgefield School District,Barlow Mountain Elementary School,166,196,362,2012-13
1180611,1180011,Ridgefield School District,Branchville Elementary School,212,193,405,2012-13
1185111,1180011,Ridgefield School District,East Ridge Middle School,364,413,777,2012-13
1180411,1180011,Ridgefield School District,Farmingville Elementary School,178,183,361,2012-13
1180311,1180011,Ridgefield School District,Ridgebury Elementary School,197,196,393,2012-13
1189011,1180011,Ridgefield School District,Ridgefield 18-21 Transition Program,0,*,*,2012-13
1186111,1180011,Ridgefield School District,Ridgefield High School,859,900,1759,2012-13
1180511,1180011,Ridgefield School District,Scotland Elementary School,182,203,385,2012-13
1185211,1180011,Ridgefield School District,Scotts Ridge Middle School,238,257,495,2012-13
1180211,1180011,Ridgefield School District,Veterans Park Elementary School,160,177,337,2012-13
1195111,1190011,Rocky Hill School District,Albert D. Griswold Middle School,280,283,563,2012-13
1190411,1190011,Rocky Hill School District,Myrtle H. Stevens School,256,280,536,2012-13
1196111,1190011,Rocky Hill School District,Rocky Hill High School,385,347,732,2012-13
1190511,1190011,Rocky Hill School District,West Hill School,319,312,631,2012-13
1210111,1210011,Salem School District,Salem Elementary School,200,222,422,2012-13
1220111,1220011,Salisbury School District,Salisbury Central School,149,160,309,2012-13
1230111,1230011,Scotland School District,Scotland Elementary School,71,56,127,2012-13
1240111,1240011,Seymour School District,Bungay School,264,243,507,2012-13
1240211,1240011,Seymour School District,Chatfield-LoPresti School,275,295,570,2012-13
1246111,1240011,Seymour School District,Seymour High School,307,303,610,2012-13
1245111,1240011,Seymour School District,Seymour Middle School,275,324,599,2012-13
1250111,1250011,Sharon School District,Sharon Center School,92,96,188,2012-13
1260911,1260011,Shelton School District,Mohegan School,170,156,326,2012-13
1261011,1260011,Shelton School District,Booth Hill School,152,171,323,2012-13
1260511,1260011,Shelton School District,Elizabeth Shelton School,218,242,460,2012-13
1265111,1260011,Shelton School District,Intermediate School,433,442,875,2012-13
1260811,1260011,Shelton School District,Long Hill School,220,231,451,2012-13
1261111,1260011,Shelton School District,Perry Hill Elementary School,411,451,862,2012-13
1266111,1260011,Shelton School District,Shelton High School,800,778,1578,2012-13
1260611,1260011,Shelton School District,Sunnyside School,110,127,237,2012-13
1270111,1270011,Sherman School District,Sherman School,182,201,383,2012-13
2700113,2700013,Side By Side Charter School District,Side By Side Charter School,115,118,233,2012-13
1280111,1280011,Simsbury School District,Central School,190,207,397,2012-13
1285111,1280011,Simsbury School District,Henry James Memorial School,355,393,748,2012-13
1280611,1280011,Simsbury School District,Latimer Lane School,224,220,444,2012-13
1286111,1280011,Simsbury School District,Simsbury High School,738,821,1559,2012-13
1280711,1280011,Simsbury School District,Squadron Line School,305,354,659,2012-13
1280311,1280011,Simsbury School District,Tariffville School,142,144,286,2012-13
1280411,1280011,Simsbury School District,Tootin' Hills School,214,221,435,2012-13
1295111,1290011,Somers School District,Mabelle B. Avery Middle School,183,180,363,2012-13
1290411,1290011,Somers School District,Somers Elementary School,329,345,674,2012-13
1296111,1290011,Somers School District,Somers High School,259,281,540,2012-13
1320211,1320011,South Windsor School District,Pleasant Valley School,183,177,360,2012-13
1320711,1320011,South Windsor School District,Eli Terry School,208,215,423,2012-13
1320611,1320011,South Windsor School District,Orchard Hill School,161,205,366,2012-13
1320111,1320011,South Windsor School District,Philip R. Smith School,166,177,343,2012-13
1329011,1320011,South Windsor School District,Project Worth Young Adult Academy,0,*,*,2012-13
1326211,1320011,South Windsor School District,South Windsor High School,687,722,1409,2012-13
1325111,1320011,South Windsor School District,Timothy Edwards School,496,569,1065,2012-13
1320411,1320011,South Windsor School District,Wapping Elementary School,151,155,306,2012-13
1315311,1310011,Southington School District,John F. Kennedy Middle School,419,426,845,2012-13
1311511,1310011,Southington School District,Derynoski Elementary School,354,312,666,2012-13
1311311,1310011,Southington School District,Flanders Elementary School,120,160,280,2012-13
1310211,1310011,Southington School District,Hatton Elementary School,197,261,458,2012-13
1315111,1310011,Southington School District,Joseph A. Depaolo Middle School,362,373,735,2012-13
1310611,1310011,Southington School District,Plantsville Elementary School,147,136,283,2012-13
1310711,1310011,Southington School District,South End Elementary School,118,117,235,2012-13
1316211,1310011,Southington School District,Southington High School,1014,1023,2037,2012-13
1310811,1310011,Southington School District,Strong Elementary School,168,188,356,2012-13
1310911,1310011,Southington School District,Thalberg Elementary School,208,220,428,2012-13
1311411,1310011,Southington School District,Urbin T. Kelley School,180,194,374,2012-13
1330111,1330011,Sprague School District,Sayles School,166,204,370,2012-13
1340611,1340011,Stafford School District,Stafford Elementary School,225,252,477,2012-13
1346111,1340011,Stafford School District,Stafford High School,262,218,480,2012-13
1345211,1340011,Stafford School District,Stafford Middle School,194,189,383,2012-13
1340311,1340011,Stafford School District,Staffordville School,83,95,178,2012-13
1340411,1340011,Stafford School District,West Stafford School,103,95,198,2012-13
2826013,2820013,Stamford Academy District,Stamford Academy,54,84,138,2012-13
1355611,1350011,Stamford School District,Cloonan School,303,294,597,2012-13
1352011,1350011,Stamford School District,Davenport Ridge School,280,262,542,2012-13
1355311,1350011,Stamford School District,Dolan School,244,287,531,2012-13
1352211,1350011,Stamford School District,Hart School,286,301,587,2012-13
1351211,1350011,Stamford School District,Julia A. Stark School,286,326,612,2012-13
1350511,1350011,Stamford School District,K. T. Murphy School,271,285,556,2012-13
1350611,1350011,Stamford School District,Newfield School,356,334,690,2012-13
1351811,1350011,Stamford School District,Northeast School,340,346,686,2012-13
1358011,1350011,Stamford School District,Preschool Team,15,33,48,2012-13
1355811,1350011,Stamford School District,Rippowam Middle School,340,314,654,2012-13
1350811,1350011,Stamford School District,Rogers International School,422,401,823,2012-13
1350911,1350011,Stamford School District,Roxbury School,296,351,647,2012-13
1355711,1350011,Stamford School District,Scofield Middle School,306,318,624,2012-13
1351111,1350011,Stamford School District,Springdale School,319,335,654,2012-13
1356111,1350011,Stamford School District,Stamford High School,925,1027,1952,2012-13
1352111,1350011,Stamford School District,Stillmeadow School,349,418,767,2012-13
1356411,1350011,Stamford School District,The Academy of Information Technology,287,397,684,2012-13
1351911,1350011,Stamford School District,Toquam Magnet School,332,348,680,2012-13
1355511,1350011,Stamford School District,Turn of River School,271,307,578,2012-13
1356311,1350011,Stamford School District,Westhill High School,1065,1065,2130,2012-13
1351411,1350011,Stamford School District,Westover School,340,376,716,2012-13
1360311,1360011,Sterling School District,Sterling Community School,226,272,498,2012-13
1370511,1370011,Stonington School District,Deans Mill School,228,257,485,2012-13
1375211,1370011,Stonington School District,Mystic Middle School,205,211,416,2012-13
1375111,1370011,Stonington School District,Pawcatuck Middle School,162,170,332,2012-13
1376111,1370011,Stonington School District,Stonington High School,377,394,771,2012-13
1370411,1370011,Stonington School District,West Broad Street School,68,63,131,2012-13
1370611,1370011,Stonington School District,West Vine Street School,92,118,210,2012-13
1381311,1380011,Stratford School District,Eli Whitney School,259,261,520,2012-13
1386211,1380011,Stratford School District,Bunnell High School,606,604,1210,2012-13
1380311,1380011,Stratford School District,Chapel School,260,295,555,2012-13
1385211,1380011,Stratford School District,David Wooster Middle School,255,274,529,2012-13
1380411,1380011,Stratford School District,Franklin School,151,142,293,2012-13
1385311,1380011,Stratford School District,Harry B. Flood Middle School,275,281,556,2012-13
1381611,1380011,Stratford School District,Honeyspot School,121,97,218,2012-13
1380811,1380011,Stratford School District,Lordship School,117,115,232,2012-13
1380911,1380011,Stratford School District,Nichols School,213,224,437,2012-13
1381011,1380011,Stratford School District,Second Hill Lane School,335,343,678,2012-13
1389111,1380011,Stratford School District,Secondary STEPS Program,*,*,13,2012-13
1381511,1380011,Stratford School District,Stratford Academy - Johnson House,233,237,470,2012-13
1386111,1380011,Stratford School District,Stratford High School,510,565,1075,2012-13
1389011,1380011,Stratford School District,Strive-Stratford,6,11,17,2012-13
1381411,1380011,Stratford School District,Wilcoxson School,163,213,376,2012-13
1390411,1390011,Suffield School District,A. Ward Spaulding School,235,209,444,2012-13
1390311,1390011,Suffield School District,McAlister Intermediate School,273,268,541,2012-13
1396111,1390011,Suffield School District,Suffield High School,453,407,860,2012-13
1395111,1390011,Suffield School District,Suffield Middle School,300,299,599,2012-13
2696113,2690013,The Bridge Academy District,The Bridge Academy,145,131,276,2012-13
9026122,9020022,The Gilbert School District,The Gilbert School,219,286,505,2012-13
1400111,1400011,Thomaston School District,Black Rock School,163,147,310,2012-13
1400211,1400011,Thomaston School District,Thomaston Center School,134,122,256,2012-13
1406211,1400011,Thomaston School District,Thomaston High School,204,234,438,2012-13
1410111,1410011,Thompson School District,Mary R. Fisher Elementary School,220,251,471,2012-13
1415111,1410011,Thompson School District,Thompson Middle School,199,181,380,2012-13
1416111,1410011,Thompson School District,Tourtellotte Memorial High School,141,161,302,2012-13
1420111,1420011,Tolland School District,Birch Grove Primary School,271,311,582,2012-13
1426111,1420011,Tolland School District,Tolland High School,456,444,900,2012-13
1420211,1420011,Tolland School District,Tolland Intermediate School,334,332,666,2012-13
1425111,1420011,Tolland School District,Tolland Middle School,341,347,688,2012-13
1430111,1430011,Torrington School District,East School,186,206,392,2012-13
1430211,1430011,Torrington School District,Forbes School,185,210,395,2012-13
1430811,1430011,Torrington School District,Southwest School,137,191,328,2012-13
1430911,1430011,Torrington School District,Torringford School,306,304,610,2012-13
1436111,1430011,Torrington School District,Torrington High School,510,591,1101,2012-13
1435111,1430011,Torrington School District,Torrington Middle School,516,540,1056,2012-13
1431311,1430011,Torrington School District,Vogel-Wetmore School,233,240,473,2012-13
2785113,2780013,Trailblazers Academy District,Trailblazers Academy,76,92,168,2012-13
1440111,1440011,Trumbull School District,Booth Hill School,265,261,526,2012-13
1440811,1440011,Trumbull School District,Daniels Farm School,231,237,468,2012-13
1441011,1440011,Trumbull School District,Frenchtown Elementary School,313,324,637,2012-13
1445211,1440011,Trumbull School District,Hillcrest Middle School,364,413,777,2012-13
1440411,1440011,Trumbull School District,Jane Ryan School,189,203,392,2012-13
1445111,1440011,Trumbull School District,Madison Middle School,403,445,848,2012-13
1440311,1440011,Trumbull School District,Middlebrook School,219,245,464,2012-13
1440911,1440011,Trumbull School District,Tashua School,195,191,386,2012-13
1448011,1440011,Trumbull School District,Trumbull Early Childhood Education Center,104,121,225,2012-13
1446111,1440011,Trumbull School District,Trumbull High School,1142,1053,2195,2012-13
3360115,3360015,Unified School District #1,Bridgeport Correctional Center,0,17,17,2012-13
3360215,3360015,Unified School District #1,Brooklyn Correctional Institution,0,*,*,2012-13
3360315,3360015,Unified School District #1,Cheshire Correctional Institution,0,29,29,2012-13
3362415,3360015,Unified School District #1,Corrigan/Radgowski Correctional Institution,0,21,21,2012-13
3360415,3360015,Unified School District #1,Enfield Correctional Institution,0,12,12,2012-13
3361915,3360015,Unified School District #1,Garner Correctional Institution,0,23,23,2012-13
3360615,3360015,Unified School District #1,Hartford Correctional Center,0,38,38,2012-13
3362215,3360015,Unified School District #1,MacDougall/Walker Correctional Institution,0,60,60,2012-13
3361115,3360015,Unified School District #1,Manson Youth Institution,0,315,315,2012-13
3360915,3360015,Unified School District #1,New Haven Correctional Center,0,17,17,2012-13
3362615,3360015,Unified School District #1,Northern Correctional Institution,0,19,19,2012-13
3361215,3360015,Unified School District #1,Osborn Correctional Institution,0,24,24,2012-13
3361315,3360015,Unified School District #1,Robinson Correctional Institution,0,15,15,2012-13
3361515,3360015,Unified School District #1,Willard/Cybulski Correctional Institution,0,12,12,2012-13
3362515,3360015,Unified School District #1,York Correctional Institution,36,0,36,2012-13
3470115,3470015,Unified School District #2,Children's Place School,0,23,23,2012-13
3470315,3470015,Unified School District #2,Riverview School,37,19,56,2012-13
3476715,3470015,Unified School District #2,Walter G. Cady School,0,88,88,2012-13
1450111,1450011,Union School District,Union Elementary School,41,30,71,2012-13
1460311,1460011,Vernon School District,Northeast School,160,162,322,2012-13
1461411,1460011,Vernon School District,Center Road School,242,254,496,2012-13
1460111,1460011,Vernon School District,Lake Street School,120,158,278,2012-13
1460211,1460011,Vernon School District,Maple Street School,152,182,334,2012-13
1469011,1460011,Vernon School District,Next Step Program (AACBP),*,*,11,2012-13
1466111,1460011,Vernon School District,Rockville High School,477,496,973,2012-13
1461011,1460011,Vernon School District,Skinner Road School,150,182,332,2012-13
1465111,1460011,Vernon School District,Vernon Center Middle School,346,353,699,2012-13
1470111,1470011,Voluntown School District,Voluntown Elementary School,165,150,315,2012-13
1480211,1480011,Wallingford School District,Highland School,134,151,285,2012-13
1489011,1480011,Wallingford School District,A.R.T.S. Academy,6,11,17,2012-13
1481011,1480011,Wallingford School District,Cook Hill School,175,190,365,2012-13
1485211,1480011,Wallingford School District,Dag Hammarskjold Middle School,345,336,681,2012-13
1480911,1480011,Wallingford School District,Evarts C. Stevens School,168,192,360,2012-13
1489211,1480011,Wallingford School District,Harvest Park,0,7,7,2012-13
1485311,1480011,Wallingford School District,James H. Moran Middle School,350,355,705,2012-13
1486111,1480011,Wallingford School District,Lyman Hall High School,652,483,1135,2012-13
1486211,1480011,Wallingford School District,Mark T. Sheehan High School,475,439,914,2012-13
1480111,1480011,Wallingford School District,Moses Y. Beach School,170,180,350,2012-13
1489111,1480011,Wallingford School District,Multi-Vocational Life Skills Program,*,*,13,2012-13
1480311,1480011,Wallingford School District,Parker Farms School,161,166,327,2012-13
1481211,1480011,Wallingford School District,Pond Hill School,176,179,355,2012-13
1480411,1480011,Wallingford School District,Rock Hill School,179,185,364,2012-13
1480811,1480011,Wallingford School District,Yalesville School,191,193,384,2012-13
1515211,1510011,Waterbury School District,West Side Middle School,505,552,1057,2012-13
1512311,1510011,Waterbury School District,Washington School,178,172,350,2012-13
1512111,1510011,Waterbury School District,B. W. Tinker School,256,307,563,2012-13
1510511,1510011,Waterbury School District,Bucks Hill School,208,216,424,2012-13
1510611,1510011,Waterbury School District,Bunker Hill School,244,261,505,2012-13
1512711,1510011,Waterbury School District,Carrington School,234,223,457,2012-13
1516211,1510011,Waterbury School District,Crosby High School,718,745,1463,2012-13
1510911,1510011,Waterbury School District,Driggs School,270,284,554,2012-13
1511611,1510011,Waterbury School District,Duggan School,208,229,437,2012-13
1519111,1510011,Waterbury School District,Enlightenment School,72,126,198,2012-13
1511411,1510011,Waterbury School District,F. J. Kingsbury School,247,263,510,2012-13
1512611,1510011,Waterbury School District,Gilmartin School,240,247,487,2012-13
1510711,1510011,Waterbury School District,H. S. Chase School,350,406,756,2012-13
1511311,1510011,Waterbury School District,Hopeville School,225,235,460,2012-13
1516411,1510011,Waterbury School District,John F. Kennedy High School,642,716,1358,2012-13
1513111,1510011,Waterbury School District,Maloney Interdistrict Magnet School,276,325,601,2012-13
1511111,1510011,Waterbury School District,Margaret M. Generali Elementary School,268,317,585,2012-13
1515111,1510011,Waterbury School District,Michael F. Wallace Middle School,603,617,1220,2012-13
1515311,1510011,Waterbury School District,North End Middle School,509,596,1105,2012-13
1513411,1510011,Waterbury School District,Reed School,161,168,329,2012-13
1512811,1510011,Waterbury School District,Regan School,131,123,254,2012-13
1513311,1510011,Waterbury School District,Rotella Interdistrict Magnet School,322,293,615,2012-13
1518011,1510011,Waterbury School District,Special Education Preschool,87,113,200,2012-13
1512011,1510011,Waterbury School District,Sprague School,193,207,400,2012-13
1519011,1510011,Waterbury School District,State Street School,20,64,84,2012-13
1512211,1510011,Waterbury School District,Walsh School,270,241,511,2012-13
1516011,1510011,Waterbury School District,Waterbury Arts Magnet School (High),304,165,469,2012-13
1515011,1510011,Waterbury School District,Waterbury Arts Magnet School (Middle),206,127,333,2012-13
1510811,1510011,Waterbury School District,Wendell L. Cross School,164,188,352,2012-13
1516311,1510011,Waterbury School District,Wilby High School,629,700,1329,2012-13
1513211,1510011,Waterbury School District,Woodrow Wilson School,205,220,425,2012-13
1525111,1520011,Waterford School District,Clark Lane Middle School,320,355,675,2012-13
1520211,1520011,Waterford School District,Great Neck Elementary School,187,166,353,2012-13
1520611,1520011,Waterford School District,Oswegatchie Elementary School,189,205,394,2012-13
1520711,1520011,Waterford School District,Quaker Hill Elementary School,158,203,361,2012-13
1526111,1520011,Waterford School District,Waterford High School,406,438,844,2012-13
1530311,1530011,Watertown School District,Fletcher W. Judson School,137,170,307,2012-13
1530211,1530011,Watertown School District,John Trumbull Primary School,320,362,682,2012-13
1530411,1530011,Watertown School District,Polk School,159,178,337,2012-13
1535111,1530011,Watertown School District,Swift Middle School,390,380,770,2012-13
1536111,1530011,Watertown School District,Watertown High School,467,461,928,2012-13
1551711,1550011,West Hartford School District,Smith School,167,197,364,2012-13
1559111,1550011,West Hartford School District,Achieve,*,*,9,2012-13
1551611,1550011,West Hartford School District,Aiken School,220,240,460,2012-13
1550211,1550011,West Hartford School District,Braeburn School,187,197,384,2012-13
1555311,1550011,West Hartford School District,Bristow Middle School,209,211,420,2012-13
1550411,1550011,West Hartford School District,Bugbee School,232,227,459,2012-13
1550511,1550011,West Hartford School District,Charter Oak International Academy,154,154,308,2012-13
1556111,1550011,West Hartford School District,Conard High School,768,774,1542,2012-13
1550611,1550011,West Hartford School District,Duffy School,244,259,503,2012-13
1556211,1550011,West Hartford School District,Hall High School,733,742,1475,2012-13
1555111,1550011,West Hartford School District,King Philip Middle School,456,456,912,2012-13
1550911,1550011,West Hartford School District,Morley School,163,171,334,2012-13
1551011,1550011,West Hartford School District,Norfeldt School,181,225,406,2012-13
1555211,1550011,West Hartford School District,Sedgwick Middle School,426,467,893,2012-13
1559211,1550011,West Hartford School District,Strive-West Hartford,6,19,25,2012-13
1559011,1550011,West Hartford School District,WAAVE (W Hartford Applied Academic/Voc'l Experience),*,*,9,2012-13
1551211,1550011,West Hartford School District,Webster Hill School,261,228,489,2012-13
1551311,1550011,West Hartford School District,Whiting Lane School,246,292,538,2012-13
1551511,1550011,West Hartford School District,Wolcott School,238,262,500,2012-13
1561211,1560011,West Haven School District,Washington School,211,229,440,2012-13
1560811,1560011,West Haven School District,Alma E. Pagels School,156,214,370,2012-13
1565311,1560011,West Haven School District,Carrigan 5/6 Intermediate School,420,469,889,2012-13
1560611,1560011,West Haven School District,Edith E. Mackrille School,164,193,357,2012-13
1560311,1560011,West Haven School District,Forest School,225,228,453,2012-13
1565111,1560011,West Haven School District,Harry M. Bailey Middle School,466,441,907,2012-13
1561411,1560011,West Haven School District,Savin Rock Community School,257,276,533,2012-13
1560411,1560011,West Haven School District,Seth G. Haley School,236,244,480,2012-13
1566111,1560011,West Haven School District,West Haven High School,792,798,1590,2012-13
1540211,1540011,Westbrook School District,Daisy Ingraham School,129,181,310,2012-13
1546111,1540011,Westbrook School District,Westbrook High School,140,146,286,2012-13
1545111,1540011,Westbrook School District,Westbrook Middle School,142,134,276,2012-13
1570111,1570011,Weston School District,Hurlbutt Elementary School,221,240,461,2012-13
1576111,1570011,Weston School District,Weston High School,384,393,777,2012-13
1570211,1570011,Weston School District,Weston Intermediate School,258,287,545,2012-13
1575111,1570011,Weston School District,Weston Middle School,298,338,636,2012-13
1585111,1580011,Westport School District,Bedford Middle School,415,453,868,2012-13
1580311,1580011,Westport School District,Coleytown Elementary School,235,212,447,2012-13
1585311,1580011,Westport School District,Coleytown Middle School,249,263,512,2012-13
1580411,1580011,Westport School District,Green's Farms School,231,221,452,2012-13
1580511,1580011,Westport School District,King's Highway Elementary School,241,245,486,2012-13
1580711,1580011,Westport School District,Long Lots School,265,318,583,2012-13
1580811,1580011,Westport School District,Saugatuck Elementary School,236,288,524,2012-13
1586111,1580011,Westport School District,Staples High School,928,951,1879,2012-13
1588011,1580011,Westport School District,Stepping Stones Preschool,21,25,46,2012-13
1590811,1590011,Wethersfield School District,Alfred W. Hanmer School,171,195,366,2012-13
1591011,1590011,Wethersfield School District,Charles Wright School,168,148,316,2012-13
1590211,1590011,Wethersfield School District,Emerson-Williams School,234,207,441,2012-13
1591111,1590011,Wethersfield School District,Highcrest School,214,208,422,2012-13
1591211,1590011,Wethersfield School District,Samuel B. Webb Elementary School,187,204,391,2012-13
1595211,1590011,Wethersfield School District,Silas Deane Middle School,304,278,582,2012-13
1596111,1590011,Wethersfield School District,Wethersfield High School,545,612,1157,2012-13
1600111,1600011,Willington School District,Center School,98,95,193,2012-13
1605111,1600011,Willington School District,Hall Memorial School,135,151,286,2012-13
1615211,1610011,Wilton School District,Middlebrook School,559,494,1053,2012-13
1610711,1610011,Wilton School District,Cider Mill School,484,512,996,2012-13
1610511,1610011,Wilton School District,Miller-Driscoll School,474,463,937,2012-13
1616111,1610011,Wilton School District,Wilton High School,620,689,1309,2012-13
1620411,1620011,Winchester School District,Batcheller Early Education Center,83,125,208,2012-13
1620211,1620011,Winchester School District,Mary P. Hinsdale School,123,132,255,2012-13
1625111,1620011,Winchester School District,Pearson Middle School,92,113,205,2012-13
1620111,1620011,Winchester School District,WISE Academy,*,*,6,2012-13
1638011,1630011,Windham School District,Early Headstart,10,12,22,2012-13
1630111,1630011,Windham School District,Natchaug School,155,211,366,2012-13
1630311,1630011,Windham School District,North Windham School,257,254,511,2012-13
1630611,1630011,Windham School District,W. B. Sweeney School,164,186,350,2012-13
1630511,1630011,Windham School District,Windham Center School,158,174,332,2012-13
1638311,1630011,Windham School District,Windham Early Childhood Prospect Street,106,111,217,2012-13
1636111,1630011,Windham School District,Windham High School,299,374,673,2012-13
1635111,1630011,Windham School District,Windham Middle School,341,377,718,2012-13
1650111,1650011,Windsor Locks School District,North Street School,241,219,460,2012-13
1650411,1650011,Windsor Locks School District,South Elementary School,173,189,362,2012-13
1656111,1650011,Windsor Locks School District,Windsor Locks High School,272,280,552,2012-13
1655111,1650011,Windsor Locks School District,Windsor Locks Middle School,171,201,372,2012-13
1640111,1640011,Windsor School District,Clover Street School,144,155,299,2012-13
1640811,1640011,Windsor School District,John F. Kennedy School,234,207,441,2012-13
1640911,1640011,Windsor School District,Oliver Ellsworth School,203,241,444,2012-13
1640511,1640011,Windsor School District,Poquonock Elementary School,129,125,254,2012-13
1645311,1640011,Windsor School District,Sage Park Middle School,376,375,751,2012-13
1646111,1640011,Windsor School District,Windsor High School,559,640,1199,2012-13
1660611,1660011,Wolcott School District,Alcott School,149,174,323,2012-13
1660211,1660011,Wolcott School District,Frisbie School,169,183,352,2012-13
1665111,1660011,Wolcott School District,Tyrrell Middle School,288,352,640,2012-13
1660511,1660011,Wolcott School District,Wakelee School,199,193,392,2012-13
1666111,1660011,Wolcott School District,Wolcott High School,445,420,865,2012-13
1670311,1670011,Woodbridge School District,Beecher Road School,375,369,744,2012-13
9036122,9030022,Woodstock Academy District,Woodstock Academy,543,512,1055,2012-13
1690211,1690011,Woodstock School District,Woodstock Elementary School,241,258,499,2012-13
1695111,1690011,Woodstock School District,Woodstock Middle School,197,197,394,2012-13
2880113,2880013,Achievement First Hartford Academy Inc. District,Achievement First Hartford Academy Inc.,415,455,870,2013-14
2795113,2790013,Amistad Academy District,Amistad Academy,470,467,937,2013-14
0010111,0010011,Andover School District,Andover Elementary School,140,158,298,2013-14
0026111,0020011,Ansonia School District,Ansonia High School,268,334,602,2013-14
0025111,0020011,Ansonia School District,Ansonia Middle School,227,266,493,2013-14
0020311,0020011,Ansonia School District,Mead School,288,278,566,2013-14
0020811,0020011,Ansonia School District,Prendergast School,308,353,661,2013-14
2449614,2440014,Area Cooperative Educational Services,Center for Autism Spectrum and Development Disorders,*,*,36,2013-14
2449414,2440014,Area Cooperative Educational Services,Mill Road School,20,131,151,2013-14
2445114,2440014,Area Cooperative Educational Services,Thomas Edison Magnet Middle School,339,372,711,2013-14
2449514,2440014,Area Cooperative Educational Services,Village School,42,109,151,2013-14
2449214,2440014,Area Cooperative Educational Services,Whitney High School East,35,79,114,2013-14
2449114,2440014,Area Cooperative Educational Services,Whitney High School North,29,71,100,2013-14
2449314,2440014,Area Cooperative Educational Services,Whitney High School West,8,31,39,2013-14
2440314,2440014,Area Cooperative Educational Services,Wintergreen Interdistrict  Magnet School,318,313,631,2013-14
0030111,0030011,Ashford School District,Ashford School,205,218,423,2013-14
0046111,0040011,Avon School District,Avon High School,552,505,1057,2013-14
0045111,0040011,Avon School District,Avon Middle School,301,283,584,2013-14
0040411,0040011,Avon School District,Pine Grove School,315,279,594,2013-14
0040311,0040011,Avon School District,Roaring Brook School,272,301,573,2013-14
0040511,0040011,Avon School District,Thompson Brook School,260,303,563,2013-14
0050111,0050011,Barkhamsted School District,Barkhamsted Elementary School,127,161,288,2013-14
0058011,0050011,Barkhamsted School District,Shared Services Integrated Preschool,8,10,18,2013-14
0076111,0070011,Berlin School District,Berlin High School,444,489,933,2013-14
0075111,0070011,Berlin School District,Catherine M. McGee Middle School,301,390,691,2013-14
0070411,0070011,Berlin School District,Emma Hart Willard School,231,283,514,2013-14
0070511,0070011,Berlin School District,Mary E. Griswold School,276,286,562,2013-14
0070111,0070011,Berlin School District,Richard D. Hubbard School,115,136,251,2013-14
0080111,0080011,Bethany School District,Bethany Community School,199,237,436,2013-14
0090411,0090011,Bethel School District,Anna H. Rockwell School,204,207,411,2013-14
0096111,0090011,Bethel School District,Bethel High School,452,481,933,2013-14
0095111,0090011,Bethel School District,Bethel Middle School,312,360,672,2013-14
0090111,0090011,Bethel School District,Frank A. Berry School,263,293,556,2013-14
0090511,0090011,Bethel School District,Ralph M. T. Johnson School,201,216,417,2013-14
0116111,0110011,Bloomfield School District,Bloomfield High School,269,286,555,2013-14
0110711,0110011,Bloomfield School District,Carmen Arace Intermediate School,104,112,216,2013-14
0115211,0110011,Bloomfield School District,Carmen Arace Middle School,93,120,213,2013-14
0116311,0110011,Bloomfield School District,Global Experience Magnet School,133,87,220,2013-14
0110611,0110011,Bloomfield School District,Laurel School,162,156,318,2013-14
0116411,0110011,Bloomfield School District,Learning Academy at Bloomfield,6,7,13,2013-14
0110511,0110011,Bloomfield School District,Metacomet School,105,126,231,2013-14
0110811,0110011,Bloomfield School District,Wintonbury Early Childhood Magnet School,157,164,321,2013-14
0120111,0120011,Bolton School District,Bolton Center School,260,268,528,2013-14
0126111,0120011,Bolton School District,Bolton High School,170,164,334,2013-14
0130111,0130011,Bozrah School District,Fields Memorial School,119,124,243,2013-14
0146111,0140011,Branford School District,Branford High School,513,537,1050,2013-14
0145111,0140011,Branford School District,Francis Walsh Intermediate School,479,463,942,2013-14
0148011,0140011,Branford School District,Indian Neck School,12,24,36,2013-14
0141611,0140011,Branford School District,John B. Sliney School,182,192,374,2013-14
0141511,0140011,Branford School District,Mary R. Tisko School,196,204,400,2013-14
0141411,0140011,Branford School District,Mary T. Murphy School,178,242,420,2013-14
2900113,2900013,Brass City Charter School District,Brass City Charter School,64,51,115,2013-14
2850113,2850013,Bridgeport Achievement First District,Achievement First Bridgeport Academy,420,415,835,2013-14
0150811,0150011,Bridgeport School District,"Aerospace/Hydrospace, Engineering and Physical Sciences HS at the Fairchild-Wheeler Magnet Campus",86,149,235,2013-14
0150111,0150011,Bridgeport School District,Barnum School,301,325,626,2013-14
0156111,0150011,Bridgeport School District,Bassick High School,490,630,1120,2013-14
0150211,0150011,Bridgeport School District,Beardsley School,192,184,376,2013-14
0150611,0150011,Bridgeport School District,"Biotechnology, Research and Zoological Studies HS at the Fairchild-Wheeler Magnet Campus",167,62,229,2013-14
0150311,0150011,Bridgeport School District,Black Rock School,188,218,406,2013-14
0154011,0150011,Bridgeport School District,Blackham School,517,610,1127,2013-14
0159011,0150011,Bridgeport School District,Bridgeport Learning Center,9,48,57,2013-14
0151611,0150011,Bridgeport School District,Bridgeport Military Academy,44,72,116,2013-14
0150411,0150011,Bridgeport School District,Bryant School,188,225,413,2013-14
0156211,0150011,Bridgeport School District,Central High School,922,916,1838,2013-14
0151411,0150011,Bridgeport School District,Cesar Batalla School,530,643,1173,2013-14
0152111,0150011,Bridgeport School District,Classical Studies Academy,172,168,340,2013-14
0150511,0150011,Bridgeport School District,Columbus School,419,467,886,2013-14
0153911,0150011,Bridgeport School District,Cross School,193,220,413,2013-14
0154211,0150011,Bridgeport School District,Curiale School,328,409,737,2013-14
0154111,0150011,Bridgeport School District,Dunbar School,153,150,303,2013-14
0150711,0150011,Bridgeport School District,Edison School,114,137,251,2013-14
0153211,0150011,Bridgeport School District,Geraldine Johnson School,409,434,843,2013-14
0151111,0150011,Bridgeport School District,Hall School,140,135,275,2013-14
0151211,0150011,Bridgeport School District,Hallen School,149,183,332,2013-14
0156311,0150011,Bridgeport School District,Harding High School,562,543,1105,2013-14
0154511,0150011,Bridgeport School District,High Horizons Magnet School,223,199,422,2013-14
0151311,0150011,Bridgeport School District,Hooker School,184,203,387,2013-14
0151511,0150011,Bridgeport School District,Information Technology and Software Engineering High School at the Fairchild-Wheeler Magnet Campus,86,150,236,2013-14
0153711,0150011,Bridgeport School District,Interdistrict Discovery Magnet School,248,263,511,2013-14
0152211,0150011,Bridgeport School District,Jettie S. Tisdale School,323,332,655,2013-14
0151011,0150011,Bridgeport School District,Luis Munoz Marin School,433,471,904,2013-14
0152011,0150011,Bridgeport School District,Madison School,243,296,539,2013-14
0154611,0150011,Bridgeport School District,Multicultural Magnet School,258,191,449,2013-14
0151711,0150011,Bridgeport School District,Park City Magnet School,272,219,491,2013-14
0151811,0150011,Bridgeport School District,Pride Academy,23,34,57,2013-14
0152511,0150011,Bridgeport School District,Read School,400,439,839,2013-14
0152611,0150011,Bridgeport School District,Roosevelt School,266,298,564,2013-14
0154411,0150011,Bridgeport School District,Skane Center,106,198,304,2013-14
0153011,0150011,Bridgeport School District,Waltersville School,252,262,514,2013-14
0153611,0150011,Bridgeport School District,Winthrop School,341,344,685,2013-14
0179011,0170011,Bristol School District,Alternative Special Education Program (ASEP),*,*,14,2013-14
0176111,0170011,Bristol School District,Bristol Central High School,592,650,1242,2013-14
0176211,0170011,Bristol School District,Bristol Eastern High School,627,672,1299,2013-14
0175111,0170011,Bristol School District,Chippens Hill Middle School,342,376,718,2013-14
0179211,0170011,Bristol School District,Community/Vocational Program,*,*,13,2013-14
0170311,0170011,Bristol School District,Edgewood School,171,184,355,2013-14
0171411,0170011,Bristol School District,Ellen P. Hubbell School,206,218,424,2013-14
0170511,0170011,Bristol School District,Greene-Hills School,425,465,890,2013-14
0171911,0170011,Bristol School District,Ivy Drive School,178,219,397,2013-14
0171711,0170011,Bristol School District,Mountain View School,227,210,437,2013-14
0175211,0170011,Bristol School District,Northeast Middle School,223,230,453,2013-14
0171111,0170011,Bristol School District,South Side School,237,266,503,2013-14
0171211,0170011,Bristol School District,Stafford School,252,252,504,2013-14
0172011,0170011,Bristol School District,West Bristol School,460,485,945,2013-14
0186111,0180011,Brookfield School District,Brookfield High School,458,443,901,2013-14
0180311,0180011,Brookfield School District,Center Elementary School,185,195,380,2013-14
0180411,0180011,Brookfield School District,Huckleberry Hill Elementary School,301,323,624,2013-14
0185311,0180011,Brookfield School District,Whisconier Middle School,440,419,859,2013-14
0190111,0190011,Brooklyn School District,Brooklyn Elementary School,265,280,545,2013-14
0195111,0190011,Brooklyn School District,Brooklyn Middle School,170,204,374,2013-14
0210111,0210011,Canaan School District,Lee H. Kellogg School,41,36,77,2013-14
0220211,0220011,Canterbury School District,Canterbury Elementary School,110,115,225,2013-14
0225111,0220011,Canterbury School District,Dr. Helen Baldwin Middle School,94,139,233,2013-14
0236111,0230011,Canton School District,Canton High School,225,274,499,2013-14
0230311,0230011,Canton School District,Canton Intermediate School,224,210,434,2013-14
0235111,0230011,Canton School District,Canton Middle School,140,125,265,2013-14
0230211,0230011,Canton School District,Cherry Brook Primary School,245,245,490,2013-14
2415114,2410014,Capitol Region Education Council,Academy of Aerospace and Engineering,146,416,562,2013-14
2410714,2410014,Capitol Region Education Council,Academy of Aerospace and Engineering Elementary,95,127,222,2013-14
2416514,2410014,Capitol Region Education Council,Academy of Science and Innovation,286,75,361,2013-14
2410614,2410014,Capitol Region Education Council,Ana Grace Academy of the Arts Elementary School,114,103,217,2013-14
2418114,2410014,Capitol Region Education Council,Discovery Academy,117,165,282,2013-14
2419214,2410014,Capitol Region Education Council,Farmington Valley Regional Diagnostic Center,8,14,22,2013-14
2410114,2410014,Capitol Region Education Council,Glastonbury/East Hartford Magnet School,191,219,410,2013-14
2416414,2410014,Capitol Region Education Council,Greater Hartford Academy of  the Arts High School - Full Time,333,105,438,2013-14
2415314,2410014,Capitol Region Education Council,Greater Hartford Academy of the Arts Magnet Middle,214,113,327,2013-14
2419414,2410014,Capitol Region Education Council,Integrated Program Models,*,*,*,2013-14
2410414,2410014,Capitol Region Education Council,International Magnet School for Global Citizenship,212,203,415,2013-14
2419014,2410014,Capitol Region Education Council,John J. Allison Polaris Center,17,36,53,2013-14
2419614,2410014,Capitol Region Education Council,Lincoln Academy Regional Interdistrict Collaborative,*,*,8,2013-14
2416114,2410014,Capitol Region Education Council,Metropolitan Learning Center for Global and International Studies,403,319,722,2013-14
2413114,2410014,Capitol Region Education Council,Montessori Magnet School,177,165,342,2013-14
2410514,2410014,Capitol Region Education Council,Museum Academy,217,188,405,2013-14
2415214,2410014,Capitol Region Education Council,Public Safety Academy,132,272,404,2013-14
2410314,2410014,Capitol Region Education Council,Reggio Magnet School of the Arts,191,201,392,2013-14
2419514,2410014,Capitol Region Education Council,River Street Early Learning Center (Site 2),16,48,64,2013-14
2419314,2410014,Capitol Region Education Council,River Street School,22,123,145,2013-14
2419114,2410014,Capitol Region Education Council,Soundbridge,39,44,83,2013-14
2419714,2410014,Capitol Region Education Council,Strive (Southern Transition Real-World and Independent Vocational Education Program,*,*,8,2013-14
2416714,2410014,Capitol Region Education Council,Two Rivers Magnet High School,92,97,189,2013-14
2415014,2410014,Capitol Region Education Council,Two Rivers Magnet Middle School,287,373,660,2013-14
2410214,2410014,Capitol Region Education Council,University of Hartford Magnet School,217,224,441,2013-14
0240211,0240011,Chaplin School District,Chaplin Elementary School,91,92,183,2013-14
0250111,0250011,Cheshire School District,Chapman School,158,140,298,2013-14
0256111,0250011,Cheshire School District,Cheshire High School,737,801,1538,2013-14
0250211,0250011,Cheshire School District,Darcey School,129,164,293,2013-14
0255111,0250011,Cheshire School District,Dodd Middle School,361,386,747,2013-14
0250611,0250011,Cheshire School District,Doolittle School,269,260,529,2013-14
0250411,0250011,Cheshire School District,Highland School,367,373,740,2013-14
0259011,0250011,Cheshire School District,Humiston School,7,13,20,2013-14
0250511,0250011,Cheshire School District,Norton School,224,205,429,2013-14
0260111,0260011,Chester School District,Chester Elementary School,127,101,228,2013-14
0270111,0270011,Clinton School District,Abraham Pierson School,129,167,296,2013-14
0275111,0270011,Clinton School District,Jared Eliot School,235,227,462,2013-14
0270311,0270011,Clinton School District,Lewin G. Joel Jr. School,310,328,638,2013-14
0276111,0270011,Clinton School District,The Morgan School,283,275,558,2013-14
0286111,0280011,Colchester School District,Bacon Academy,481,419,900,2013-14
0280411,0280011,Colchester School District,Colchester Elementary School,266,285,551,2013-14
0280211,0280011,Colchester School District,Jack Jackter Intermediate School,281,333,614,2013-14
0285111,0280011,Colchester School District,William J. Johnston Middle School,334,334,668,2013-14
0290111,0290011,Colebrook School District,Colebrook Consolidated School,45,54,99,2013-14
0300111,0300011,Columbia School District,Horace W. Porter School,231,236,467,2013-14
2686113,2680013,Common Ground High School District,Common Ground High School,82,98,180,2013-14
9001516,9000016,Connecticut Technical High School System,A. I. Prince Technical High School,427,374,801,2013-14
9001116,9000016,Connecticut Technical High School System,Bullard-Havens Technical High School,427,378,805,2013-14
9001916,9000016,Connecticut Technical High School System,E. C. Goodwin Technical High School,275,371,646,2013-14
9001416,9000016,Connecticut Technical High School System,Eli Whitney Technical High School,246,296,542,2013-14
9002716,9000016,Connecticut Technical High School System,Ella T. Grasso Southeastern Technical High School,205,330,535,2013-14
9002516,9000016,Connecticut Technical High School System,Emmett O'Brien Technical High School,199,368,567,2013-14
9001716,9000016,Connecticut Technical High School System,H. C. Wilcox Technical High School,354,447,801,2013-14
9001316,9000016,Connecticut Technical High School System,H. H. Ellis Technical High School,145,440,585,2013-14
9001216,9000016,Connecticut Technical High School System,Henry Abbott Technical High School,231,406,637,2013-14
9001616,9000016,Connecticut Technical High School System,Howell Cheney Technical High School,170,497,667,2013-14
9002016,9000016,Connecticut Technical High School System,Norwich Technical High School,248,432,680,2013-14
9002216,9000016,Connecticut Technical High School System,Oliver Wolcott Technical High School,229,418,647,2013-14
9002616,9000016,Connecticut Technical High School System,Platt Technical High School,311,525,836,2013-14
9001816,9000016,Connecticut Technical High School System,Vinal Technical High School,182,474,656,2013-14
9002316,9000016,Connecticut Technical High School System,W. F. Kaynor Technical High School,349,394,743,2013-14
9002416,9000016,Connecticut Technical High School System,Windham Technical High School,188,362,550,2013-14
2439214,2430014,Cooperative Educational Services,Developmental Learning Center (DLC),25,69,94,2013-14
2439114,2430014,Cooperative Educational Services,Preschool-Primary Learning Center (PLC),16,35,51,2013-14
2439314,2430014,Cooperative Educational Services,RISE Transitional Program,*,*,12,2013-14
2438014,2430014,Cooperative Educational Services,School Readiness,28,26,54,2013-14
2430114,2430014,Cooperative Educational Services,Six-Six Magnet School,236,235,471,2013-14
2439414,2430014,Cooperative Educational Services,Therapeutic Day Program,19,121,140,2013-14
0310111,0310011,Cornwall School District,Cornwall Consolidated School,42,63,105,2013-14
0325111,0320011,Coventry School District,Capt. Nathan Hale School,186,207,393,2013-14
0328011,0320011,Coventry School District,Coventry Early Intervention Services,*,*,20,2013-14
0320211,0320011,Coventry School District,Coventry Grammar School,190,187,377,2013-14
0326111,0320011,Coventry School District,Coventry High School,270,248,518,2013-14
0320411,0320011,Coventry School District,George Hersey Robertson School,195,182,377,2013-14
0336111,0330011,Cromwell School District,Cromwell High School,272,277,549,2013-14
0335111,0330011,Cromwell School District,Cromwell Middle School,228,226,454,2013-14
0330211,0330011,Cromwell School District,Edna C. Stevens School,215,253,468,2013-14
0330311,0330011,Cromwell School District,Woodside Intermediate School,225,252,477,2013-14
0346211,0340011,Danbury School District,Alternative Center For Excellence,44,39,83,2013-14
0345111,0340011,Danbury School District,Broadview Middle School,542,550,1092,2013-14
0340111,0340011,Danbury School District,DPS Early Childhood Center,57,82,139,2013-14
0346111,0340011,Danbury School District,Danbury High School,1375,1503,2878,2013-14
0341411,0340011,Danbury School District,Ellsworth Avenue School,201,234,435,2013-14
0341111,0340011,Danbury School District,Great Plain School,178,178,356,2013-14
0340211,0340011,Danbury School District,Hayestown Avenue School,237,232,469,2013-14
0341711,0340011,Danbury School District,King Street Intermediate School,192,178,370,2013-14
0341311,0340011,Danbury School District,King Street Primary School,209,208,417,2013-14
0340511,0340011,Danbury School District,Mill Ridge Primary School,207,205,412,2013-14
0340611,0340011,Danbury School District,Morris Street School,208,260,468,2013-14
0340811,0340011,Danbury School District,Park Avenue School,220,213,433,2013-14
0341511,0340011,Danbury School District,Pembroke School,169,207,376,2013-14
0345211,0340011,Danbury School District,Rogers Park Middle School,603,597,1200,2013-14
0341211,0340011,Danbury School District,Shelter Rock School,195,221,416,2013-14
0341011,0340011,Danbury School District,South Street School,172,203,375,2013-14
0341611,0340011,Danbury School District,Stadley Rough School,218,214,432,2013-14
0341911,0340011,Danbury School District,Western CT Academy of International Studies Elementary Magnet School,222,201,423,2013-14
0356111,0350011,Darien School District,Darien High School,671,683,1354,2013-14
0350211,0350011,Darien School District,Hindley Elementary School,268,297,565,2013-14
0350711,0350011,Darien School District,Holmes Elementary School,228,226,454,2013-14
0355111,0350011,Darien School District,Middlesex Middle School,547,581,1128,2013-14
0351311,0350011,Darien School District,Ox Ridge Elementary School,208,250,458,2013-14
0350511,0350011,Darien School District,Royle Elementary School,208,244,452,2013-14
0350611,0350011,Darien School District,Tokeneke Elementary School,244,248,492,2013-14
0360111,0360011,Deep River School District,Deep River Elementary School,167,163,330,2013-14
3370215,3370015,Department of Mental Health and Addiction Services,Connecticut Valley Hospital,*,*,*,2013-14
3370515,3370015,Department of Mental Health and Addiction Services,Greater Bridgeport Community Mental Health Center,0,*,*,2013-14
0370611,0370011,Derby School District,Bradley School,190,186,376,2013-14
0376111,0370011,Derby School District,Derby High School,186,195,381,2013-14
0375011,0370011,Derby School District,Derby Middle School,187,177,364,2013-14
0370411,0370011,Derby School District,Irving School,184,194,378,2013-14
0400111,0400011,East Granby School District,Allgrove School,88,106,194,2013-14
0406111,0400011,East Granby School District,East Granby High School,120,139,259,2013-14
0405111,0400011,East Granby School District,East Granby Middle School,109,99,208,2013-14
0400211,0400011,East Granby School District,R. Dudley Seymour School,95,112,207,2013-14
0410111,0410011,East Haddam School District,East Haddam Elementary School,167,159,326,2013-14
0416111,0410011,East Haddam School District,Nathan Hale-Ray High School,192,180,372,2013-14
0415111,0410011,East Haddam School District,Nathan Hale-Ray Middle School,226,262,488,2013-14
0420311,0420011,East Hampton School District,Center School,138,157,295,2013-14
0426111,0420011,East Hampton School District,East Hampton High School,286,234,520,2013-14
0425111,0420011,East Hampton School District,East Hampton Middle School,197,226,423,2013-14
0420111,0420011,East Hampton School District,Memorial School,305,321,626,2013-14
0429011,0420011,East Hampton School District,The Learning Center at East Hampton,*,*,7,2013-14
0430911,0430011,East Hartford School District,Anna E. Norris School,137,159,296,2013-14
0436311,0430011,East Hartford School District,Connecticut IB Academy,124,73,197,2013-14
0430611,0430011,East Hartford School District,Dr. Franklin H. Mayberry School,176,188,364,2013-14
0432211,0430011,East Hartford School District,Dr. John A. Langford School,186,216,402,2013-14
0431011,0430011,East Hartford School District,Dr. Thomas S. O'Connell School,261,272,533,2013-14
0436211,0430011,East Hartford School District,East Hartford High School,853,829,1682,2013-14
0435111,0430011,East Hartford School District,East Hartford Middle School,517,584,1101,2013-14
0432011,0430011,East Hartford School District,Governor William Pitkin School,169,174,343,2013-14
0430511,0430011,East Hartford School District,Hockanum School,167,155,322,2013-14
0430411,0430011,East Hartford School District,Joseph O. Goodwin School,145,156,301,2013-14
0431811,0430011,East Hartford School District,Robert J. O'Brien School,226,272,498,2013-14
0431211,0430011,East Hartford School District,Silver Lane School,159,145,304,2013-14
0436411,0430011,East Hartford School District,Stevens Alternate High School,36,69,105,2013-14
0432411,0430011,East Hartford School District,Sunset Ridge Middle School,152,101,253,2013-14
0438011,0430011,East Hartford School District,Willowbrook Early Childhood,105,126,231,2013-14
0439011,0430011,East Hartford School District,Woodland School,30,169,199,2013-14
0441711,0440011,East Haven School District,Carbone School/East Haven Academy,143,126,269,2013-14
0441411,0440011,East Haven School District,D. C. Moore School,102,113,215,2013-14
0440111,0440011,East Haven School District,Deer Run School,165,164,329,2013-14
0441311,0440011,East Haven School District,Dominick H. Ferrara School,97,105,202,2013-14
0446111,0440011,East Haven School District,East Haven High School,447,460,907,2013-14
0441011,0440011,East Haven School District,Grove J. Tuttle School,90,83,173,2013-14
0445111,0440011,East Haven School District,Joseph Melillo Middle School,250,321,571,2013-14
0440711,0440011,East Haven School District,Momauguin School,77,75,152,2013-14
0441811,0440011,East Haven School District,Overbrook Elementary School,85,108,193,2013-14
0449011,0440011,East Haven School District,Pathways,11,29,40,2013-14
0456111,0450011,East Lyme School District,East Lyme High School,536,527,1063,2013-14
0455111,0450011,East Lyme School District,East Lyme Middle School,438,437,875,2013-14
0450111,0450011,East Lyme School District,Flanders School,162,192,354,2013-14
0458011,0450011,East Lyme School District,Integrated Preschool,20,21,41,2013-14
0450411,0450011,East Lyme School District,Lillie B. Haynes School,169,170,339,2013-14
0450211,0450011,East Lyme School District,Niantic Center School,99,91,190,2013-14
0470111,0470011,East Windsor School District,Broad Brook Elementary School,248,258,506,2013-14
0476111,0470011,East Windsor School District,East Windsor High School,166,182,348,2013-14
0475411,0470011,East Windsor School District,East Windsor Middle School,174,171,345,2013-14
2536014,2530014,Eastern Connecticut Regional Educational Service Center (EASTCONN),Arts at the Capitol Theater Magnet School (ACT),104,40,144,2013-14
2539014,2530014,Eastern Connecticut Regional Educational Service Center (EASTCONN),EastConn Special Education,20,75,95,2013-14
2536114,2530014,Eastern Connecticut Regional Educational Service Center (EASTCONN),Quinebaug Middle College,72,55,127,2013-14
0390111,0390011,Eastford School District,Eastford Elementary School,74,78,152,2013-14
0465111,0460011,Easton School District,Helen Keller Middle School,147,204,351,2013-14
0460111,0460011,Easton School District,Samuel Staples Elementary School,300,310,610,2013-14
2428014,2420014,EdAdvance,EdAdvance Headstart,93,96,189,2013-14
2429014,2420014,EdAdvance,The ACCESS School at The Danuta M. Thibodeau Education Center,13,27,40,2013-14
0480111,0480011,Ellington School District,Center School,201,192,393,2013-14
0480211,0480011,Ellington School District,Crystal Lake School,98,105,203,2013-14
0486111,0480011,Ellington School District,Ellington High School,405,392,797,2013-14
0485111,0480011,Ellington School District,Ellington Middle School,197,212,409,2013-14
0480711,0480011,Ellington School District,Windermere Intermediate School,190,226,416,2013-14
0480611,0480011,Ellington School District,Windermere School,220,219,439,2013-14
2890113,2890013,Elm City College Preparatory School District,Elm City College Preparatory School,346,278,624,2013-14
0491311,0490011,Enfield School District,Edgar H. Parkman School,169,167,336,2013-14
0491611,0490011,Enfield School District,Eli Whitney School,176,208,384,2013-14
0496111,0490011,Enfield School District,Enfield High School,342,365,707,2013-14
0490211,0490011,Enfield School District,Enfield Street School,144,144,288,2013-14
0499011,0490011,Enfield School District,Enfield Transitional Learning Academy,8,7,15,2013-14
0496211,0490011,Enfield School District,Enrico Fermi High School,442,476,918,2013-14
0490411,0490011,Enfield School District,Hazardville Memorial School,156,198,354,2013-14
0498011,0490011,Enfield School District,Head Start Program,59,45,104,2013-14
0491811,0490011,Enfield School District,Henry Barnard School,165,175,340,2013-14
0495211,0490011,Enfield School District,John F. Kennedy Middle School,532,589,1121,2013-14
0491111,0490011,Enfield School District,Nathan Hale School,117,104,221,2013-14
0491511,0490011,Enfield School District,Prudence Crandall School,207,211,418,2013-14
0500111,0500011,Essex School District,Essex Elementary School,237,271,508,2013-14
2726113,2720013,Explorations District,Explorations,41,42,83,2013-14
0510211,0510011,Fairfield School District,Burr Elementary School,213,240,453,2013-14
0510111,0510011,Fairfield School District,Dwight Elementary School,142,164,306,2013-14
0518011,0510011,Fairfield School District,Early Childhood Center,35,75,110,2013-14
0516011,0510011,Fairfield School District,Fairfield Ludlowe High School,799,710,1509,2013-14
0516211,0510011,Fairfield School District,Fairfield Warde High School,728,731,1459,2013-14
0515211,0510011,Fairfield School District,Fairfield Woods Middle School,440,486,926,2013-14
0510411,0510011,Fairfield School District,Holland Hill School,205,193,398,2013-14
0511711,0510011,Fairfield School District,Jennings School,133,194,327,2013-14
0510611,0510011,Fairfield School District,McKinley School,230,228,458,2013-14
0510711,0510011,Fairfield School District,Mill Hill School,211,218,429,2013-14
0511611,0510011,Fairfield School District,North Stratfield School,212,232,444,2013-14
0511811,0510011,Fairfield School District,Osborn Hill School,254,272,526,2013-14
0511211,0510011,Fairfield School District,Riverfield School,194,205,399,2013-14
0515311,0510011,Fairfield School District,Roger Ludlowe Middle School,423,437,860,2013-14
0511311,0510011,Fairfield School District,Sherman School,234,223,457,2013-14
0511411,0510011,Fairfield School District,Stratfield School,227,270,497,2013-14
0515111,0510011,Fairfield School District,Tomlinson Middle School,352,346,698,2013-14
0520411,0520011,Farmington School District,East Farms School,212,221,433,2013-14
0528011,0520011,Farmington School District,Farmington Collaborative PK,38,38,76,2013-14
0526111,0520011,Farmington School District,Farmington High School,606,708,1314,2013-14
0525111,0520011,Farmington School District,Irving A. Robbins Middle School,269,302,571,2013-14
0520211,0520011,Farmington School District,Noah Wallace School,163,175,338,2013-14
0520111,0520011,Farmington School District,Union School,154,162,316,2013-14
0520311,0520011,Farmington School District,West District School,162,179,341,2013-14
0520511,0520011,Farmington School District,West Woods Upper Elementary School,315,305,620,2013-14
0530111,0530011,Franklin School District,Franklin Elementary School,85,96,181,2013-14
0540211,0540011,Glastonbury School District,Buttonball Lane School,246,233,479,2013-14
0540311,0540011,Glastonbury School District,Eastbury School,143,151,294,2013-14
0540811,0540011,Glastonbury School District,Gideon Welles School,261,248,509,2013-14
0546111,0540011,Glastonbury School District,Glastonbury High School,1119,1021,2140,2013-14
0540411,0540011,Glastonbury School District,Hebron Avenue School,208,233,441,2013-14
0540611,0540011,Glastonbury School District,Hopewell School,209,229,438,2013-14
0540111,0540011,Glastonbury School District,Links Academy,22,16,38,2013-14
0540711,0540011,Glastonbury School District,Naubuc School,220,193,413,2013-14
0540911,0540011,Glastonbury School District,Nayaug Elementary School,319,290,609,2013-14
0545211,0540011,Glastonbury School District,Smith Middle School,495,539,1034,2013-14
0560111,0560011,Granby School District,Frank M. Kearns Primary School,192,198,390,2013-14
0566111,0560011,Granby School District,Granby Memorial High School,350,374,724,2013-14
0565111,0560011,Granby School District,Granby Memorial Middle School,165,167,332,2013-14
0560411,0560011,Granby School District,Kelly Lane Primary School,154,162,316,2013-14
0560311,0560011,Granby School District,Wells Road Intermediate School,142,146,288,2013-14
0575111,0570011,Greenwich School District,Central Middle School,289,306,595,2013-14
0570211,0570011,Greenwich School District,Cos Cob School,220,224,444,2013-14
0575211,0570011,Greenwich School District,Eastern Middle School,386,393,779,2013-14
0570411,0570011,Greenwich School District,Glenville School,209,196,405,2013-14
0576111,0570011,Greenwich School District,Greenwich High School,1300,1336,2636,2013-14
0570511,0570011,Greenwich School District,Hamilton Avenue School,192,194,386,2013-14
0571311,0570011,Greenwich School District,International School At Dundee,195,183,378,2013-14
0570311,0570011,Greenwich School District,Julian Curtiss School,168,176,344,2013-14
0570611,0570011,Greenwich School District,New Lebanon School,114,150,264,2013-14
0570711,0570011,Greenwich School District,North Mianus School,221,226,447,2013-14
0570811,0570011,Greenwich School District,North Street School,184,210,394,2013-14
0570911,0570011,Greenwich School District,Old Greenwich School,208,220,428,2013-14
0571111,0570011,Greenwich School District,Parkway School,123,142,265,2013-14
0571011,0570011,Greenwich School District,Riverside School,228,268,496,2013-14
0575311,0570011,Greenwich School District,Western Middle School,230,274,504,2013-14
0580311,0580011,Griswold School District,Griswold Elementary School,363,423,786,2013-14
0586211,0580011,Griswold School District,Griswold High School,296,306,602,2013-14
0585111,0580011,Griswold School District,Griswold Middle School,293,284,577,2013-14
0595311,0590011,Groton School District,Carl C. Cutler Middle School,212,237,449,2013-14
0592011,0590011,Groton School District,Catherine Kolnaski Magnet School,176,235,411,2013-14
0591811,0590011,Groton School District,Charles Barnum School,197,188,385,2013-14
0590311,0590011,Groton School District,Claude Chester School,191,171,362,2013-14
0591711,0590011,Groton School District,Mary Morrisson School,204,218,422,2013-14
0591911,0590011,Groton School District,Northeast Academy Elementary School,198,212,410,2013-14
0591211,0590011,Groton School District,Pleasant Valley School,141,153,294,2013-14
0596111,0590011,Groton School District,Robert E. Fitch High School,556,567,1123,2013-14
0590111,0590011,Groton School District,S. B. Butler School,163,170,333,2013-14
0595211,0590011,Groton School District,West Side Middle School,236,244,480,2013-14
0600711,0600011,Guilford School District,A. Baldwin Middle School,292,288,580,2013-14
0600611,0600011,Guilford School District,A. W. Cox School,147,166,313,2013-14
0600411,0600011,Guilford School District,Calvin Leete School,123,164,287,2013-14
0605111,0600011,Guilford School District,E. C. Adams Middle School,300,283,583,2013-14
0606111,0600011,Guilford School District,Guilford High School,521,546,1067,2013-14
0600211,0600011,Guilford School District,Guilford Lakes School,170,173,343,2013-14
0600311,0600011,Guilford School District,Melissa Jones School,157,180,337,2013-14
0628011,0620011,Hamden School District,Alice Peck Learning Center,56,81,137,2013-14
0621211,0620011,Hamden School District,Bear Path School,223,226,449,2013-14
0620211,0620011,Hamden School District,Church Street School,173,179,352,2013-14
0620311,0620011,Hamden School District,Dunbar Hill School,158,151,309,2013-14
0626111,0620011,Hamden School District,Hamden High School,865,946,1811,2013-14
0625211,0620011,Hamden School District,Hamden Middle School,410,455,865,2013-14
0620411,0620011,Hamden School District,Helen Street School,146,184,330,2013-14
0621111,0620011,Hamden School District,Ridge Hill School,127,172,299,2013-14
0620111,0620011,Hamden School District,Shepherd Glen School,161,167,328,2013-14
0621011,0620011,Hamden School District,Spring Glen School,219,216,435,2013-14
0621411,0620011,Hamden School District,West Woods School,213,237,450,2013-14
0630111,0630011,Hampton School District,Hampton Elementary School,45,66,111,2013-14
0640711,0640011,Hartford School District,Asian Studies Academy at Bellizzi School,305,330,635,2013-14
0640411,0640011,Hartford School District,Batchelder School,232,295,527,2013-14
0642811,0640011,Hartford School District,Betances Early Reading Lab Magnet School,136,142,278,2013-14
0643811,0640011,Hartford School District,Betances STEM Magnet School,66,107,173,2013-14
0643511,0640011,Hartford School District,Breakthrough II Magnet School,120,132,252,2013-14
0643311,0640011,Hartford School District,Breakthrough Magnet School,191,170,361,2013-14
0647111,0640011,Hartford School District,Bulkeley High School,166,212,378,2013-14
0646111,0640011,Hartford School District,Bulkeley High School Lower School,195,298,493,2013-14
0640611,0640011,Hartford School District,Burns Latino Studies Academy,255,286,541,2013-14
0642311,0640011,Hartford School District,Burr School,324,384,708,2013-14
0646911,0640011,Hartford School District,Capital Preparatory Magnet School,345,356,701,2013-14
0642411,0640011,Hartford School District,Clark School,190,179,369,2013-14
0646411,0640011,Hartford School District,Classical Magnet School,389,301,690,2013-14
0646011,0640011,Hartford School District,Culinary Arts Academy at Weaver High School,140,154,294,2013-14
0640911,0640011,Hartford School District,Environmental Sciences Magnet at Hooker School,255,341,596,2013-14
0643211,0640011,Hartford School District,Expeditionary Learning Academy at Moylan School,290,303,593,2013-14
0643611,0640011,Hartford School District,Global Communications Academy,258,234,492,2013-14
0647911,0640011,Hartford School District,Great Path Academy at MCC,152,97,249,2013-14
0647211,0640011,Hartford School District,HPHS Engineering and Green Technology Academy,110,304,414,2013-14
0647411,0640011,Hartford School District,HPHS Law and Government Academy,224,257,481,2013-14
0647511,0640011,Hartford School District,HPHS Nursing and Health Sciences Academy,326,132,458,2013-14
0645411,0640011,Hartford School District,Hartford Magnet Trinity College Academy,518,400,918,2013-14
0641311,0640011,Hartford School District,Hartford PreKindergarten Magnet School,69,51,120,2013-14
0649011,0640011,Hartford School District,Hartford Transitional Learning Academy (Elementary),8,35,43,2013-14
0647611,0640011,Hartford School District,"High School, Inc.",167,176,343,2013-14
0647711,0640011,Hartford School District,Journalism and Media Academy Magnet School,97,104,201,2013-14
0641011,0640011,Hartford School District,Kennelly School,327,331,658,2013-14
0641111,0640011,Hartford School District,Kinsella Magnet School of Performing Arts,504,315,819,2013-14
0640811,0640011,Hartford School District,M. D. Fox School,304,265,569,2013-14
0641611,0640011,Hartford School District,"M. L. King, Jr. School",138,178,316,2013-14
0641211,0640011,Hartford School District,McDonough Middle School,142,149,291,2013-14
0641911,0640011,Hartford School District,Milner School,204,172,376,2013-14
0643711,0640011,Hartford School District,Montessori Magnet at Fisher School,140,151,291,2013-14
0640511,0640011,Hartford School District,Montessori Magnet at Moylan School,87,71,158,2013-14
0641411,0640011,Hartford School District,Naylor/CCSU Leadership Academy,318,342,660,2013-14
0647811,0640011,Hartford School District,OPPortunity High School,53,46,99,2013-14
0641511,0640011,Hartford School District,Parkville Community School,261,282,543,2013-14
0646611,0640011,Hartford School District,Pathways Academy of Technology and Design,109,221,330,2013-14
0641711,0640011,Hartford School District,Rawson School,228,270,498,2013-14
0644011,0640011,Hartford School District,Renzulli Gifted and Talented Academy,74,54,128,2013-14
0640111,0640011,Hartford School District,SAND School,215,244,459,2013-14
0642511,0640011,Hartford School District,STEM Magnet at Fisher School,143,216,359,2013-14
0643011,0640011,Hartford School District,Sanchez School,233,259,492,2013-14
0642611,0640011,Hartford School District,Simpson-Waverly School,144,153,297,2013-14
0646511,0640011,Hartford School District,Sports and Medical Sciences Academy,322,383,705,2013-14
0646711,0640011,Hartford School District,University High School of Science and Engineering,124,284,408,2013-14
0642011,0640011,Hartford School District,Webster Micro Society Magnet School,320,355,675,2013-14
0642111,0640011,Hartford School District,West Middle School,236,262,498,2013-14
0642211,0640011,Hartford School District,Wish Museum School,159,195,354,2013-14
0650111,0650011,Hartland School District,Hartland School,94,110,204,2013-14
0670211,0670011,Hebron School District,Gilead Hill School,160,184,344,2013-14
0670111,0670011,Hebron School District,Hebron Elementary School,258,265,523,2013-14
2860113,2860013,Highville Charter School District,Highville Charter School,181,180,361,2013-14
2640113,2640013,Integrated Day Charter School District,Integrated Day Charter School,163,167,330,2013-14
2655113,2650013,Interdistrict School for Arts and Comm District,Interdistrict School For Arts And Communication,139,107,246,2013-14
2610113,2610013,Jumoke Academy District,Jumoke Academy,384,320,704,2013-14
0680111,0680011,Kent School District,Kent Center School,119,153,272,2013-14
0698011,0690011,Killingly School District,Goodyear Early Childhood Center,41,60,101,2013-14
0690111,0690011,Killingly School District,Killingly Central School,204,223,427,2013-14
0696111,0690011,Killingly School District,Killingly High School,442,413,855,2013-14
0695211,0690011,Killingly School District,Killingly Intermediate School,386,375,761,2013-14
0690311,0690011,Killingly School District,Killingly Memorial School,237,213,450,2013-14
0690411,0690011,Killingly School District,Sunrise Community School,9,38,47,2013-14
2456014,2450014,Learn,Connecticut River Academy,224,168,392,2013-14
2455014,2450014,Learn,Dual Language & Arts Magnet Middle School,64,54,118,2013-14
2459014,2450014,Learn,Learn Special Education,*,*,32,2013-14
2456114,2450014,Learn,Marine Science Magnet High School of Southeastern Connecticut,126,127,253,2013-14
2450114,2450014,Learn,Regional Multicultural Magnet School,271,262,533,2013-14
2450314,2450014,Learn,Riverside Magnet School at Goodwin College,116,119,235,2013-14
2450214,2450014,Learn,The Friendship School,247,266,513,2013-14
2456214,2450014,Learn,Three Rivers Middle College Magnet School,39,22,61,2013-14
0710111,0710011,Lebanon School District,Lebanon Elementary School,178,214,392,2013-14
0715111,0710011,Lebanon School District,Lebanon Middle School,162,196,358,2013-14
0716211,0710011,Lebanon School District,Lyman Memorial High School,229,167,396,2013-14
0720211,0720011,Ledyard School District,Gales Ferry School,102,123,225,2013-14
0720411,0720011,Ledyard School District,Gallup Hill School,183,177,360,2013-14
0720311,0720011,Ledyard School District,Juliet W. Long School,134,140,274,2013-14
0720111,0720011,Ledyard School District,Ledyard Center School,198,220,418,2013-14
0726111,0720011,Ledyard School District,Ledyard High School,499,434,933,2013-14
0725111,0720011,Ledyard School District,Ledyard Middle School,165,182,347,2013-14
0730111,0730011,Lisbon School District,Lisbon Central School,184,212,396,2013-14
0740211,0740011,Litchfield School District,Center School,132,136,268,2013-14
0746111,0740011,Litchfield School District,Litchfield High School,223,249,472,2013-14
0740311,0740011,Litchfield School District,Litchfield Intermediate School,132,113,245,2013-14
0766111,0760011,Madison School District,Daniel Hand High School,628,623,1251,2013-14
0760611,0760011,Madison School District,Dr. Robert H. Brown Middle School,266,280,546,2013-14
0760211,0760011,Madison School District,Island Avenue Elementary School,137,159,296,2013-14
0760111,0760011,Madison School District,J. Milton Jeffrey Elementary School,142,201,343,2013-14
0760311,0760011,Madison School District,Kathleen H. Ryerson Elementary School,115,127,242,2013-14
0769011,0760011,Madison School District,Town Campus Learning Center,16,29,45,2013-14
0765211,0760011,Madison School District,Walter C. Polson Upper Middle School,273,287,560,2013-14
0770111,0770011,Manchester School District,Bowers School,203,222,425,2013-14
0770311,0770011,Manchester School District,Buckley School,161,199,360,2013-14
0771711,0770011,Manchester School District,Elisabeth M. Bennet Academy,178,196,374,2013-14
0770411,0770011,Manchester School District,Highland Park School,123,144,267,2013-14
0775311,0770011,Manchester School District,Illing Middle School,375,426,801,2013-14
0770611,0770011,Manchester School District,Keeney School,170,166,336,2013-14
0776111,0770011,Manchester School District,Manchester High School,827,792,1619,2013-14
0778011,0770011,Manchester School District,Manchester Preschool Center,85,106,191,2013-14
0779011,0770011,Manchester School District,Manchester Regional Academy,28,64,92,2013-14
0779111,0770011,Manchester School District,Manchester Transition Center,8,7,15,2013-14
0771611,0770011,Manchester School District,Martin School,156,126,282,2013-14
0771011,0770011,Manchester School District,Robertson School,206,174,380,2013-14
0771211,0770011,Manchester School District,Verplanck School,171,193,364,2013-14
0771311,0770011,Manchester School District,Waddell School,152,190,342,2013-14
0771411,0770011,Manchester School District,Washington School,168,194,362,2013-14
0780411,0780011,Mansfield School District,Annie E. Vinton School,127,129,256,2013-14
0780211,0780011,Mansfield School District,Dorothy C. Goodwin School,89,112,201,2013-14
0785111,0780011,Mansfield School District,Mansfield Middle School,267,279,546,2013-14
0780511,0780011,Mansfield School District,Southeast Elementary School,126,116,242,2013-14
0790111,0790011,Marlborough School District,Elmer Thienes-Mary Hall Elementary School,289,316,605,2013-14
0800711,0800011,Meriden School District,Nathan Hale School,289,323,612,2013-14
0800111,0800011,Meriden School District,Benjamin Franklin School,198,216,414,2013-14
0801111,0800011,Meriden School District,Casimir Pulaski School,282,299,581,2013-14
0806111,0800011,Meriden School District,Francis T. Maloney High School,559,614,1173,2013-14
0800311,0800011,Meriden School District,Hanover School,277,325,602,2013-14
0800411,0800011,Meriden School District,Israel Putnam School,311,300,611,2013-14
0800511,0800011,Meriden School District,John Barry School,244,265,509,2013-14
0805211,0800011,Meriden School District,Lincoln Middle School,362,407,769,2013-14
0806211,0800011,Meriden School District,Orville H. Platt High School,547,609,1156,2013-14
0800811,0800011,Meriden School District,Roger Sherman School,230,247,477,2013-14
0801011,0800011,Meriden School District,Thomas Hooker School,232,214,446,2013-14
0805411,0800011,Meriden School District,Washington Middle School,364,397,761,2013-14
0830211,0830011,Middletown School District,Bielefield School,153,169,322,2013-14
0830511,0830011,Middletown School District,Farm Hill School,184,183,367,2013-14
0831511,0830011,Middletown School District,Keigwin Middle School,175,144,319,2013-14
0831311,0830011,Middletown School District,Lawrence School,143,160,303,2013-14
0830911,0830011,Middletown School District,MacDonough School,102,102,204,2013-14
0836211,0830011,Middletown School District,Middletown High School,629,623,1252,2013-14
0831211,0830011,Middletown School District,Moody School,129,154,283,2013-14
0831111,0830011,Middletown School District,Snow School,185,214,399,2013-14
0830111,0830011,Middletown School District,Spencer School,154,176,330,2013-14
0839111,0830011,Middletown School District,Transition to Life Center,7,11,18,2013-14
0831411,0830011,Middletown School District,Wesley School,157,165,322,2013-14
0835411,0830011,Middletown School District,Woodrow Wilson Middle School,325,341,666,2013-14
0840111,0840011,Milford School District,Calf Pen Meadow School,125,129,254,2013-14
0845111,0840011,Milford School District,East Shore Middle School,229,237,466,2013-14
0845211,0840011,Milford School District,Harborside Middle School,259,295,554,2013-14
0841911,0840011,Milford School District,J. F. Kennedy School,186,195,381,2013-14
0846211,0840011,Milford School District,Jonathan Law High School,515,498,1013,2013-14
0846311,0840011,Milford School District,Joseph A. Foran High School,458,505,963,2013-14
0841611,0840011,Milford School District,Live Oaks School,146,164,310,2013-14
0841711,0840011,Milford School District,Mathewson School,181,196,377,2013-14
0840711,0840011,Milford School District,Meadowside School,204,257,461,2013-14
0840811,0840011,Milford School District,Orange Avenue School,167,221,388,2013-14
0841811,0840011,Milford School District,Orchard Hills School,173,168,341,2013-14
0841011,0840011,Milford School District,Pumpkin Delight School,192,182,374,2013-14
0845311,0840011,Milford School District,West Shore Middle School,237,286,523,2013-14
0850511,0850011,Monroe School District,Fawn Hollow Elementary School,241,281,522,2013-14
0855211,0850011,Monroe School District,Jockey Hollow School,379,433,812,2013-14
0856111,0850011,Monroe School District,Masuk High School,579,609,1188,2013-14
0850111,0850011,Monroe School District,Monroe Elementary School,182,189,371,2013-14
0850311,0850011,Monroe School District,Stepney Elementary School,245,229,474,2013-14
0860711,0860011,Montville School District,Dr. Charles E. Murphy School,167,187,354,2013-14
0865111,0860011,Montville School District,Leonard J. Tyl Middle School,284,292,576,2013-14
0860111,0860011,Montville School District,Mohegan School,200,165,365,2013-14
0866111,0860011,Montville School District,Montville High School,350,352,702,2013-14
0860511,0860011,Montville School District,Oakdale School,174,212,386,2013-14
0869011,0860011,Montville School District,Palmer Academy,7,18,25,2013-14
0880811,0880011,Naugatuck School District,Andrew Avenue School,108,131,239,2013-14
0888211,0880011,Naugatuck School District,Central Avenue Preschool,*,*,16,2013-14
0885111,0880011,Naugatuck School District,City Hill Middle School,335,344,679,2013-14
0880211,0880011,Naugatuck School District,Cross Street Intermediate School,145,144,289,2013-14
0888111,0880011,Naugatuck School District,Head Start,61,65,126,2013-14
0880411,0880011,Naugatuck School District,Hillside Intermediate School,148,212,360,2013-14
0880511,0880011,Naugatuck School District,Hop Brook Elementary School,140,186,326,2013-14
0880311,0880011,Naugatuck School District,Maple Hill School,239,270,509,2013-14
0886111,0880011,Naugatuck School District,Naugatuck High School,604,663,1267,2013-14
0880611,0880011,Naugatuck School District,Salem School,119,155,274,2013-14
0880711,0880011,Naugatuck School District,Western School,130,131,261,2013-14
2800113,2800013,New Beginnings Inc Family Academy District,New Beginnings Inc Family Academy,202,200,402,2013-14
0899111,0890011,New Britain School District,Brook Side School,11,38,49,2013-14
0899411,0890011,New Britain School District,CLIMB,8,17,25,2013-14
0890311,0890011,New Britain School District,Chamberlain  Elementary School,228,273,501,2013-14
0891111,0890011,New Britain School District,Frank J. DiLoreto School,419,360,779,2013-14
0890511,0890011,New Britain School District,Gaffney School,251,342,593,2013-14
0890611,0890011,New Britain School District,Holmes School,224,265,489,2013-14
0895411,0890011,New Britain School District,House of Arts Letters and Science (HALS)  Academy,86,81,167,2013-14
0890711,0890011,New Britain School District,Jefferson School,216,208,424,2013-14
0890811,0890011,New Britain School District,Lincoln School,349,359,708,2013-14
0896111,0890011,New Britain School District,New Britain High School,1182,1299,2481,2013-14
0899011,0890011,New Britain School District,New Britain Transition Center,12,28,40,2013-14
0890911,0890011,New Britain School District,Northend School,138,150,288,2013-14
0895311,0890011,New Britain School District,Pulaski Middle School,282,351,633,2013-14
0895111,0890011,New Britain School District,Roosevelt Middle School,177,217,394,2013-14
0895211,0890011,New Britain School District,Slade Middle School,301,317,618,2013-14
0891211,0890011,New Britain School District,Smalley Academy,296,358,654,2013-14
0891311,0890011,New Britain School District,Smith School,321,350,671,2013-14
0891511,0890011,New Britain School District,Vance School,270,267,537,2013-14
0900411,0900011,New Canaan School District,East School,243,287,530,2013-14
0906111,0900011,New Canaan School District,New Canaan High School,625,639,1264,2013-14
0905111,0900011,New Canaan School District,Saxe Middle School,648,666,1314,2013-14
0900211,0900011,New Canaan School District,South School,265,270,535,2013-14
0900311,0900011,New Canaan School District,West School,272,265,537,2013-14
0910111,0910011,New Fairfield School District,Consolidated School,255,294,549,2013-14
0910211,0910011,New Fairfield School District,Meeting House Hill School,266,294,560,2013-14
0916111,0910011,New Fairfield School District,New Fairfield High School,464,526,990,2013-14
0915211,0910011,New Fairfield School District,New Fairfield Middle School,302,324,626,2013-14
0920311,0920011,New Hartford School District,Ann Antolini School,173,150,323,2013-14
0920111,0920011,New Hartford School District,Bakerville Consolidated School,58,59,117,2013-14
0920211,0920011,New Hartford School District,New Hartford Elementary School,51,53,104,2013-14
0931211,0930011,New Haven School District,Edgewood School,222,226,448,2013-14
0931411,0930011,New Haven School District,Nathan Hale School,259,295,554,2013-14
0931511,0930011,New Haven School District,Augusta Lewis Troup School,244,243,487,2013-14
0930211,0930011,New Haven School District,Barnard Environmental Magnet School,282,300,582,2013-14
0930311,0930011,New Haven School District,Beecher School,228,257,485,2013-14
0931811,0930011,New Haven School District,Benjamin Jepson Magnet School,241,291,532,2013-14
0935511,0930011,New Haven School District,Betsy Ross Arts Magnet School,321,149,470,2013-14
0934311,0930011,New Haven School District,Bishop Woods Architecture and Design Magnet School,240,265,505,2013-14
0932111,0930011,New Haven School District,Brennan Rogers School,222,260,482,2013-14
0934811,0930011,New Haven School District,"Celentano BioTech, Health and Medical Magnet School",198,196,394,2013-14
0930611,0930011,New Haven School District,Clinton Avenue School,269,288,557,2013-14
0934111,0930011,New Haven School District,Columbus Family Academy,227,221,448,2013-14
0933111,0930011,New Haven School District,Conte/West Hills Magnet School,315,323,638,2013-14
0936411,0930011,New Haven School District,Cooperative High School,424,211,635,2013-14
0936811,0930011,New Haven School District,Cortlandt V.R. Creed Health and Sport Sciences High School,44,164,208,2013-14
0930911,0930011,New Haven School District,Davis 21st Century Magnet Elementary School,267,249,516,2013-14
0935611,0930011,New Haven School District,Domus Academy,*,*,42,2013-14
0938211,0930011,New Haven School District,Dwight Early Childhood Program,14,16,30,2013-14
0938111,0930011,New Haven School District,Early Learning Center,50,69,119,2013-14
0934611,0930011,New Haven School District,East Rock Community Magnet School,245,242,487,2013-14
0931711,0930011,New Haven School District,Engineering - Science University Magnet School,150,339,489,2013-14
0931611,0930011,New Haven School District,Fair Haven School,377,382,759,2013-14
0938011,0930011,New Haven School District,Headstart,192,165,357,2013-14
0938311,0930011,New Haven School District,Helene Grant HeadStart,143,125,268,2013-14
0936611,0930011,New Haven School District,High School In The Community,160,102,262,2013-14
0930711,0930011,New Haven School District,Hill Central Music Academy,214,236,450,2013-14
0936311,0930011,New Haven School District,Hill Regional Career High School,396,287,683,2013-14
0936211,0930011,New Haven School District,James Hillhouse High School,449,532,981,2013-14
0931311,0930011,New Haven School District,John C. Daniels,245,268,513,2013-14
0930811,0930011,New Haven School District,John S. Martinez Sea and Sky STEM School,251,263,514,2013-14
0933011,0930011,New Haven School District,King/Robinson Magnet School,294,318,612,2013-14
0932011,0930011,New Haven School District,Lincoln-Bassett School,155,188,343,2013-14
0931911,0930011,New Haven School District,Mauro-Sheridan Magnet School,227,321,548,2013-14
0936011,0930011,New Haven School District,Metropolitan Business Academy,209,180,389,2013-14
0937011,0930011,New Haven School District,New Haven Academy,148,129,277,2013-14
0939211,0930011,New Haven School District,Polly T. McCabe Center,14,0,14,2013-14
0933511,0930011,New Haven School District,Quinnipiac Real World Math STEM School,182,147,329,2013-14
0939111,0930011,New Haven School District,Riverside Education Academy,41,63,104,2013-14
0934211,0930011,New Haven School District,Roberto Clemente Leadership Academy for Global Awareness,242,249,491,2013-14
0931011,0930011,New Haven School District,Ross/Woodward School,352,299,651,2013-14
0936711,0930011,New Haven School District,Sound School,134,200,334,2013-14
0932811,0930011,New Haven School District,Strong 21st Century Communications Magnet and SCSU Lab School,212,238,450,2013-14
0932911,0930011,New Haven School District,Truman School,223,239,462,2013-14
0934911,0930011,New Haven School District,West Rock Authors Academy,98,124,222,2013-14
0933211,0930011,New Haven School District,Wexler/Grant Community School,176,224,400,2013-14
0936111,0930011,New Haven School District,Wilbur Cross High School,702,719,1421,2013-14
0933811,0930011,New Haven School District,Worthington Hooker School,210,204,414,2013-14
0950311,0950011,New London School District,Jennings School,308,280,588,2013-14
0955111,0950011,New London School District,Bennie Dover Jackson Middle School,260,293,553,2013-14
0950911,0950011,New London School District,Nathan Hale Arts Magnet School,257,273,530,2013-14
0956111,0950011,New London School District,New London High School,374,507,881,2013-14
0950811,0950011,New London School District,Winthrop STEM Elementary Magnet School,220,297,517,2013-14
0960511,0960011,New Milford School District,Hill And Plain School,216,257,473,2013-14
0960711,0960011,New Milford School District,John Pettibone School,198,188,386,2013-14
0969011,0960011,New Milford School District,Litchfield Hills Transition Center,*,*,11,2013-14
0966111,0960011,New Milford School District,New Milford High School,716,710,1426,2013-14
0960811,0960011,New Milford School District,Northville Elementary School,210,250,460,2013-14
0960911,0960011,New Milford School District,Sarah Noble Intermediate School,486,567,1053,2013-14
0965211,0960011,New Milford School District,Schaghticoke Middle School,334,341,675,2013-14
0940611,0940011,Newington School District,Anna Reynolds School,229,243,472,2013-14
0940211,0940011,Newington School District,Elizabeth Green School,150,152,302,2013-14
0940811,0940011,Newington School District,John Paterson School,203,224,427,2013-14
0945311,0940011,Newington School District,John Wallace Middle School,321,379,700,2013-14
0945111,0940011,Newington School District,Martin Kellogg Middle School,295,299,594,2013-14
0946111,0940011,Newington School District,Newington High School,697,664,1361,2013-14
0940711,0940011,Newington School District,Ruth Chaffee School,194,170,364,2013-14
0970111,0970011,Newtown School District,Hawley Elementary School,173,176,349,2013-14
0970411,0970011,Newtown School District,Head O'Meadow Elementary School,146,157,303,2013-14
0970311,0970011,Newtown School District,Middle Gate Elementary School,209,209,418,2013-14
0976111,0970011,Newtown School District,Newtown High School,831,882,1713,2013-14
0975111,0970011,Newtown School District,Newtown Middle School,409,446,855,2013-14
0978011,0970011,Newtown School District,Newtown Preschool,25,45,70,2013-14
0970511,0970011,Newtown School District,Reed Intermediate School,367,420,787,2013-14
0979011,0970011,Newtown School District,STARR,*,*,*,2013-14
0970211,0970011,Newtown School District,Sandy Hook Elementary School,211,184,395,2013-14
0980111,0980011,Norfolk School District,Botelle Elementary School,53,59,112,2013-14
0989211,0980011,Norfolk School District,Bridges II,*,*,*,2013-14
0990411,0990011,North Branford School District,Jerome Harrison School,173,242,415,2013-14
0996111,0990011,North Branford School District,North Branford High School,309,301,610,2013-14
0995111,0990011,North Branford School District,North Branford Intermediate School,260,248,508,2013-14
0999011,0990011,North Branford School District,School to Work Program,*,*,*,2013-14
0990611,0990011,North Branford School District,Totoket Valley Elementary School,236,235,471,2013-14
1000111,1000011,North Canaan School District,North Canaan Elementary School,149,146,295,2013-14
1010811,1010011,North Haven School District,Clintonville Elementary School,152,188,340,2013-14
1010711,1010011,North Haven School District,Green Acres Elementary School,179,200,379,2013-14
1010211,1010011,North Haven School District,Montowese Elementary School,174,163,337,2013-14
1016111,1010011,North Haven School District,North Haven High School,578,545,1123,2013-14
1015211,1010011,North Haven School District,North Haven Middle School,360,423,783,2013-14
1010311,1010011,North Haven School District,Ridge Road Elementary School,199,205,404,2013-14
1020111,1020011,North Stonington School District,North Stonington Elementary School,190,188,378,2013-14
1026111,1020011,North Stonington School District,Wheeler High School,105,113,218,2013-14
1025111,1020011,North Stonington School District,Wheeler Middle School,57,97,154,2013-14
1036211,1030011,Norwalk School District,Brien McMahon High School,859,820,1679,2013-14
1030211,1030011,Norwalk School District,Brookside Elementary School,242,286,528,2013-14
1030311,1030011,Norwalk School District,Columbus Magnet School,170,153,323,2013-14
1030411,1030011,Norwalk School District,Cranbury Elementary School,230,264,494,2013-14
1032011,1030011,Norwalk School District,Fox Run Elementary School,207,237,444,2013-14
1030711,1030011,Norwalk School District,Jefferson Magnet School,276,305,581,2013-14
1030811,1030011,Norwalk School District,Kendall Elementary School,267,305,572,2013-14
1032211,1030011,Norwalk School District,Marvin Elementary School,231,263,494,2013-14
1032111,1030011,Norwalk School District,Naramake Elementary School,229,226,455,2013-14
1035211,1030011,Norwalk School District,Nathan Hale Middle School,287,292,579,2013-14
1036111,1030011,Norwalk School District,Norwalk High School,751,788,1539,2013-14
1036311,1030011,Norwalk School District,Norwalk Pathways Academy at Briggs,38,28,66,2013-14
1035311,1030011,Norwalk School District,Ponus Ridge Middle School,316,316,632,2013-14
1035511,1030011,Norwalk School District,Roton Middle School,206,223,429,2013-14
1031311,1030011,Norwalk School District,Rowayton School,222,229,451,2013-14
1032311,1030011,Norwalk School District,Silvermine Elementary School,234,244,478,2013-14
1031411,1030011,Norwalk School District,Tracey School,188,197,385,2013-14
1035411,1030011,Norwalk School District,West Rocks Middle School,302,352,654,2013-14
1032411,1030011,Norwalk School District,Wolfpit School,137,171,308,2013-14
9016122,9010022,Norwich Free Academy District,Norwich Free Academy,1249,1075,2324,2013-14
1040111,1040011,Norwich School District,Bishop School Early Learning Center,105,113,218,2013-14
1049111,1040011,Norwich School District,Deborah-Tennant Zinewicz  School,11,21,32,2013-14
1049011,1040011,Norwich School District,Hickory Street School,0,19,19,2013-14
1041411,1040011,Norwich School District,John B. Stanton Network School,195,203,398,2013-14
1045111,1040011,Norwich School District,Kelly Middle School,305,353,658,2013-14
1042011,1040011,Norwich School District,Moriarty Magnet School,225,189,414,2013-14
1040811,1040011,Norwich School District,Samuel Huntington School,180,237,417,2013-14
1045211,1040011,Norwich School District,Teachers' Memorial Middle School,243,225,468,2013-14
1041711,1040011,Norwich School District,Thomas W. Mahan School,147,128,275,2013-14
1041911,1040011,Norwich School District,Uncas Network School,140,140,280,2013-14
1041811,1040011,Norwich School District,Veterans' Memorial School,146,151,297,2013-14
1049211,1040011,Norwich School District,Virtual Learning Academy,*,*,9,2013-14
1041511,1040011,Norwich School District,Wequonnoc Magnet School,120,135,255,2013-14
2635113,2630013,Odyssey Community School District,Odyssey Community School,153,172,325,2013-14
1060211,1060011,Old Saybrook School District,Kathleen E. Goodwin School,202,189,391,2013-14
1065211,1060011,Old Saybrook School District,Old Saybrook Middle School,281,279,560,2013-14
1066111,1060011,Old Saybrook School District,Old Saybrook Senior High School,249,237,486,2013-14
1070211,1070011,Orange School District,Mary L. Tracy School,59,75,134,2013-14
1070511,1070011,Orange School District,Peck Place School,198,176,374,2013-14
1070311,1070011,Orange School District,Race Brook School,190,184,374,2013-14
1070411,1070011,Orange School District,Turkey Hill School,139,170,309,2013-14
1085111,1080011,Oxford School District,Great Oak School,260,254,514,2013-14
1080111,1080011,Oxford School District,Oxford Center School,268,235,503,2013-14
1086011,1080011,Oxford School District,Oxford High School,292,308,600,2013-14
1080311,1080011,Oxford School District,Quaker Farms School,205,223,428,2013-14
2835113,2830013,Park City Prep Charter School District,Park City Prep Charter School,134,126,260,2013-14
1098011,1090011,Plainfield School District,Early Childhood Center,10,8,18,2013-14
1090111,1090011,Plainfield School District,Moosup Elementary School,178,161,339,2013-14
1095111,1090011,Plainfield School District,Plainfield Central School,293,300,593,2013-14
1096111,1090011,Plainfield School District,Plainfield High School,340,360,700,2013-14
1090311,1090011,Plainfield School District,Plainfield Memorial School,187,185,372,2013-14
1090411,1090011,Plainfield School District,Shepard Hill Elementary School,216,213,429,2013-14
1100411,1100011,Plainville School District,Frank T. Wheeler School,135,141,276,2013-14
1100211,1100011,Plainville School District,Linden Street School,183,216,399,2013-14
1100511,1100011,Plainville School District,Louis Toffolon School,181,173,354,2013-14
1105211,1100011,Plainville School District,Middle School of Plainville,256,275,531,2013-14
1106111,1100011,Plainville School District,Plainville High School,358,365,723,2013-14
1108011,1100011,Plainville School District,Prekindergarten Program,19,17,36,2013-14
1115111,1110011,Plymouth School District,Eli Terry Jr. Middle School,186,194,380,2013-14
1110411,1110011,Plymouth School District,Harry S. Fisher Elementary School,169,177,346,2013-14
1117111,1110011,Plymouth School District,Plymouth Alternative High School,9,7,16,2013-14
1110211,1110011,Plymouth School District,Plymouth Center School,159,193,352,2013-14
1116111,1110011,Plymouth School District,Terryville High School,208,262,470,2013-14
1120111,1120011,Pomfret School District,Pomfret Community School,207,217,424,2013-14
1130511,1130011,Portland School District,Brownstone Intermediate School,107,118,225,2013-14
1130411,1130011,Portland School District,Gildersleeve School,110,93,203,2013-14
1136111,1130011,Portland School District,Portland High School,193,191,384,2013-14
1135111,1130011,Portland School District,Portland Middle School,131,119,250,2013-14
1130211,1130011,Portland School District,Valley View School,148,168,316,2013-14
1145111,1140011,Preston School District,Preston Plains School,84,71,155,2013-14
1140411,1140011,Preston School District,Preston Veterans' Memorial School,136,132,268,2013-14
1169011,1160011,Putnam School District,Helping Hands,*,*,*,2013-14
1160311,1160011,Putnam School District,Putnam Elementary School,318,359,677,2013-14
1166111,1160011,Putnam School District,Putnam High School,123,154,277,2013-14
1165111,1160011,Putnam School District,Putnam Middle School,150,139,289,2013-14
1175111,1170011,Redding School District,John Read Middle School,250,270,520,2013-14
1170111,1170011,Redding School District,Redding Elementary School,267,273,540,2013-14
2016112,2010012,Regional School District 01,Housatonic Valley Regional High School,232,196,428,2013-14
2045112,2040012,Regional School District 04,John Winthrop Middle School,178,179,357,2013-14
2046112,2040012,Regional School District 04,Valley Regional High School,322,299,621,2013-14
2055112,2050012,Regional School District 05,Amity Middle School: Bethany,193,196,389,2013-14
2055212,2050012,Regional School District 05,Amity Middle School: Orange,200,185,385,2013-14
2056112,2050012,Regional School District 05,Amity Regional High School,752,825,1577,2013-14
2068112,2060012,Regional School District 06,Early Childhood Learning Center,24,27,51,2013-14
2060112,2060012,Regional School District 06,Goshen Center School,98,76,174,2013-14
2060212,2060012,Regional School District 06,James Morris School,65,73,138,2013-14
2066112,2060012,Regional School District 06,Wamogo Regional High School,286,266,552,2013-14
2060312,2060012,Regional School District 06,Warren Elementary School,40,40,80,2013-14
2079112,2070012,Regional School District 07,AIM,*,*,10,2013-14
2079012,2070012,Regional School District 07,FLEX,*,*,7,2013-14
2079412,2070012,Regional School District 07,Intensive Learning Program,*,*,*,2013-14
2079212,2070012,Regional School District 07,Links,*,*,14,2013-14
2076112,2070012,Regional School District 07,Northwestern Regional High School,387,329,716,2013-14
2075112,2070012,Regional School District 07,Northwestern Regional Middle School,183,177,360,2013-14
2079312,2070012,Regional School District 07,STEP,*,*,12,2013-14
2086112,2080012,Regional School District 08,RHAM High School,530,588,1118,2013-14
2085112,2080012,Regional School District 08,RHAM Middle School,281,327,608,2013-14
2086212,2080012,Regional School District 08,Region Alternative High School,*,*,10,2013-14
2096112,2090012,Regional School District 09,Joel Barlow High School,537,527,1064,2013-14
2105112,2100012,Regional School District 10,Har-Bur Middle School,402,429,831,2013-14
2100312,2100012,Regional School District 10,Harwinton Consolidated School,214,230,444,2013-14
2100212,2100012,Regional School District 10,Lake Garda Elementary School,228,266,494,2013-14
2106112,2100012,Regional School District 10,Lewis S. Mills High School,383,413,796,2013-14
2116112,2110012,Regional School District 11,Parish Hill High School,137,150,287,2013-14
2120212,2120012,Regional School District 12,Booth Free School,44,41,85,2013-14
2120312,2120012,Regional School District 12,Shepaug Valley School,239,253,492,2013-14
2120112,2120012,Regional School District 12,The Burnham School,34,30,64,2013-14
2120412,2120012,Regional School District 12,Washington Primary School,85,70,155,2013-14
2136112,2130012,Regional School District 13,Coginchaug Regional High School,286,290,576,2013-14
2130212,2130012,Regional School District 13,Francis E. Korn School,72,74,146,2013-14
2135112,2130012,Regional School District 13,Frank Ward Strong School,155,179,334,2013-14
2130112,2130012,Regional School District 13,Frederick Brewster School,106,118,224,2013-14
2130512,2130012,Regional School District 13,John Lyman School,131,123,254,2013-14
2130412,2130012,Regional School District 13,Middlefield Memorial School,140,190,330,2013-14
2140112,2140012,Regional School District 14,Bethlehem Elementary School,157,126,283,2013-14
2148012,2140012,Regional School District 14,Integrated Star Preschool Program,25,26,51,2013-14
2140212,2140012,Regional School District 14,Mitchell Elementary School,173,206,379,2013-14
2146112,2140012,Regional School District 14,Nonnewaug High School,459,342,801,2013-14
2145112,2140012,Regional School District 14,Woodbury Middle School,187,184,371,2013-14
2150412,2150012,Regional School District 15,Gainfield Elementary School,190,183,373,2013-14
2150712,2150012,Regional School District 15,Long Meadow Elementary School,258,295,553,2013-14
2155212,2150012,Regional School District 15,Memorial Middle School,226,245,471,2013-14
2150612,2150012,Regional School District 15,Middlebury Elementary School,177,190,367,2013-14
2156212,2150012,Regional School District 15,Pomperaug Regional High School,606,648,1254,2013-14
2150512,2150012,Regional School District 15,Pomperaug School,210,220,430,2013-14
2155112,2150012,Regional School District 15,Rochambeau Middle School,248,282,530,2013-14
2160312,2160012,Regional School District 16,Algonquin School,231,195,426,2013-14
2160212,2160012,Regional School District 16,Community School,106,110,216,2013-14
2160112,2160012,Regional School District 16,Laurel Ledge School,188,234,422,2013-14
2165112,2160012,Regional School District 16,Long River Middle School,277,283,560,2013-14
2166012,2160012,Regional School District 16,Woodland Regional High School,383,332,715,2013-14
2170212,2170012,Regional School District 17,Burr District Elementary School,131,176,307,2013-14
2170112,2170012,Regional School District 17,Haddam Elementary School,116,135,251,2013-14
2176112,2170012,Regional School District 17,Haddam-Killingworth High School,321,298,619,2013-14
2175112,2170012,Regional School District 17,Haddam-Killingworth Middle School,383,417,800,2013-14
2170312,2170012,Regional School District 17,Killingworth Elementary School,141,151,292,2013-14
2180312,2180012,Regional School District 18,Center School,77,82,159,2013-14
2180112,2180012,Regional School District 18,Lyme Consolidated School,103,104,207,2013-14
2186112,2180012,Regional School District 18,Lyme-Old Lyme High School,193,235,428,2013-14
2185112,2180012,Regional School District 18,Lyme-Old Lyme Middle School,195,170,365,2013-14
2180212,2180012,Regional School District 18,Mile Creek School,118,128,246,2013-14
2196112,2190012,Regional School District 19,E. O. Smith High School,607,589,1196,2013-14
1180811,1180011,Ridgefield School District,Barlow Mountain Elementary School,175,205,380,2013-14
1180611,1180011,Ridgefield School District,Branchville Elementary School,194,205,399,2013-14
1185111,1180011,Ridgefield School District,East Ridge Middle School,358,411,769,2013-14
1180411,1180011,Ridgefield School District,Farmingville Elementary School,186,178,364,2013-14
1180311,1180011,Ridgefield School District,Ridgebury Elementary School,175,193,368,2013-14
1189011,1180011,Ridgefield School District,Ridgefield 18-21 Transition Program,*,0,*,2013-14
1186111,1180011,Ridgefield School District,Ridgefield High School,880,904,1784,2013-14
1180511,1180011,Ridgefield School District,Scotland Elementary School,190,190,380,2013-14
1185211,1180011,Ridgefield School District,Scotts Ridge Middle School,248,241,489,2013-14
1180211,1180011,Ridgefield School District,Veterans Park Elementary School,165,168,333,2013-14
1195111,1190011,Rocky Hill School District,Albert D. Griswold Middle School,303,287,590,2013-14
1190411,1190011,Rocky Hill School District,Myrtle H. Stevens School,237,255,492,2013-14
1196111,1190011,Rocky Hill School District,Rocky Hill High School,376,351,727,2013-14
1190511,1190011,Rocky Hill School District,West Hill School,295,315,610,2013-14
1210111,1210011,Salem School District,Salem Elementary School,207,223,430,2013-14
1220111,1220011,Salisbury School District,Salisbury Central School,140,139,279,2013-14
1230111,1230011,Scotland School District,Scotland Elementary School,72,61,133,2013-14
1240111,1240011,Seymour School District,Bungay School,251,253,504,2013-14
1240211,1240011,Seymour School District,Chatfield-LoPresti School,282,303,585,2013-14
1246111,1240011,Seymour School District,Seymour High School,305,320,625,2013-14
1245111,1240011,Seymour School District,Seymour Middle School,282,300,582,2013-14
1250111,1250011,Sharon School District,Sharon Center School,83,94,177,2013-14
1260911,1260011,Shelton School District,Mohegan School,157,155,312,2013-14
1261011,1260011,Shelton School District,Booth Hill School,145,151,296,2013-14
1260511,1260011,Shelton School District,Elizabeth Shelton School,208,232,440,2013-14
1265111,1260011,Shelton School District,Intermediate School,415,425,840,2013-14
1260811,1260011,Shelton School District,Long Hill School,206,229,435,2013-14
1261111,1260011,Shelton School District,Perry Hill Elementary School,392,449,841,2013-14
1266111,1260011,Shelton School District,Shelton High School,790,766,1556,2013-14
1260611,1260011,Shelton School District,Sunnyside School,108,131,239,2013-14
1270111,1270011,Sherman School District,Sherman School,180,192,372,2013-14
2700113,2700013,Side By Side Charter School District,Side By Side Charter School,113,122,235,2013-14
1280111,1280011,Simsbury School District,Central School,193,199,392,2013-14
1285111,1280011,Simsbury School District,Henry James Memorial School,340,385,725,2013-14
1280611,1280011,Simsbury School District,Latimer Lane School,218,205,423,2013-14
1286111,1280011,Simsbury School District,Simsbury High School,712,800,1512,2013-14
1280711,1280011,Simsbury School District,Squadron Line School,288,337,625,2013-14
1280311,1280011,Simsbury School District,Tariffville School,145,129,274,2013-14
1280411,1280011,Simsbury School District,Tootin' Hills School,195,202,397,2013-14
1295111,1290011,Somers School District,Mabelle B. Avery Middle School,184,186,370,2013-14
1290411,1290011,Somers School District,Somers Elementary School,320,329,649,2013-14
1296111,1290011,Somers School District,Somers High School,239,249,488,2013-14
1320211,1320011,South Windsor School District,Pleasant Valley School,176,171,347,2013-14
1320711,1320011,South Windsor School District,Eli Terry School,211,231,442,2013-14
1320611,1320011,South Windsor School District,Orchard Hill School,176,211,387,2013-14
1320111,1320011,South Windsor School District,Philip R. Smith School,181,171,352,2013-14
1329011,1320011,South Windsor School District,Project Worth Young Adult Academy,*,*,7,2013-14
1326211,1320011,South Windsor School District,South Windsor High School,699,664,1363,2013-14
1325111,1320011,South Windsor School District,Timothy Edwards School,473,570,1043,2013-14
1320411,1320011,South Windsor School District,Wapping Elementary School,136,165,301,2013-14
1315311,1310011,Southington School District,John F. Kennedy Middle School,404,444,848,2013-14
1311511,1310011,Southington School District,Derynoski Elementary School,340,300,640,2013-14
1311311,1310011,Southington School District,Flanders Elementary School,124,169,293,2013-14
1310211,1310011,Southington School District,Hatton Elementary School,198,257,455,2013-14
1315111,1310011,Southington School District,Joseph A. Depaolo Middle School,389,387,776,2013-14
1310611,1310011,Southington School District,Plantsville Elementary School,148,128,276,2013-14
1310711,1310011,Southington School District,South End Elementary School,117,120,237,2013-14
1316211,1310011,Southington School District,Southington High School,1016,1020,2036,2013-14
1310811,1310011,Southington School District,Strong Elementary School,166,161,327,2013-14
1310911,1310011,Southington School District,Thalberg Elementary School,208,215,423,2013-14
1311411,1310011,Southington School District,Urbin T. Kelley School,187,173,360,2013-14
1330111,1330011,Sprague School District,Sayles School,171,189,360,2013-14
1340611,1340011,Stafford School District,Stafford Elementary School,226,256,482,2013-14
1346111,1340011,Stafford School District,Stafford High School,251,227,478,2013-14
1345211,1340011,Stafford School District,Stafford Middle School,176,166,342,2013-14
1340311,1340011,Stafford School District,Staffordville School,75,86,161,2013-14
1340411,1340011,Stafford School District,West Stafford School,87,77,164,2013-14
2826013,2820013,Stamford Academy District,Stamford Academy,67,80,147,2013-14
1355611,1350011,Stamford School District,Cloonan School,302,320,622,2013-14
1352011,1350011,Stamford School District,Davenport Ridge School,283,269,552,2013-14
1355311,1350011,Stamford School District,Dolan School,265,308,573,2013-14
1352211,1350011,Stamford School District,Hart School,284,318,602,2013-14
1351211,1350011,Stamford School District,Julia A. Stark School,291,325,616,2013-14
1350511,1350011,Stamford School District,K. T. Murphy School,259,268,527,2013-14
1350611,1350011,Stamford School District,Newfield School,352,355,707,2013-14
1351811,1350011,Stamford School District,Northeast School,322,342,664,2013-14
1358011,1350011,Stamford School District,Preschool Team,43,109,152,2013-14
1355811,1350011,Stamford School District,Rippowam Middle School,373,315,688,2013-14
1350811,1350011,Stamford School District,Rogers International School,417,387,804,2013-14
1350911,1350011,Stamford School District,Roxbury School,299,343,642,2013-14
1355711,1350011,Stamford School District,Scofield Middle School,329,295,624,2013-14
1351111,1350011,Stamford School District,Springdale School,347,364,711,2013-14
1356111,1350011,Stamford School District,Stamford High School,909,1019,1928,2013-14
1352111,1350011,Stamford School District,Stillmeadow School,320,368,688,2013-14
1356411,1350011,Stamford School District,The Academy of Information Technology,285,410,695,2013-14
1351911,1350011,Stamford School District,Toquam Magnet School,325,356,681,2013-14
1355511,1350011,Stamford School District,Turn of River School,278,268,546,2013-14
1356311,1350011,Stamford School District,Westhill High School,1083,1063,2146,2013-14
1351411,1350011,Stamford School District,Westover School,319,369,688,2013-14
1360311,1360011,Sterling School District,Sterling Community School,219,260,479,2013-14
1370511,1370011,Stonington School District,Deans Mill School,203,210,413,2013-14
1375211,1370011,Stonington School District,Mystic Middle School,192,234,426,2013-14
1375111,1370011,Stonington School District,Pawcatuck Middle School,163,149,312,2013-14
1370111,1370011,Stonington School District,Stonington BOE Pre-School,13,13,26,2013-14
1370211,1370011,Stonington School District,Stonington HS PreK,9,11,20,2013-14
1376111,1370011,Stonington School District,Stonington High School,390,381,771,2013-14
1370411,1370011,Stonington School District,West Broad Street School,64,62,126,2013-14
1370611,1370011,Stonington School District,West Vine Street School,86,125,211,2013-14
1381311,1380011,Stratford School District,Eli Whitney School,252,265,517,2013-14
1386211,1380011,Stratford School District,Bunnell High School,589,564,1153,2013-14
1380311,1380011,Stratford School District,Chapel School,267,293,560,2013-14
1385211,1380011,Stratford School District,David Wooster Middle School,265,258,523,2013-14
1380411,1380011,Stratford School District,Franklin School,159,154,313,2013-14
1385311,1380011,Stratford School District,Harry B. Flood Middle School,278,298,576,2013-14
1381611,1380011,Stratford School District,Honeyspot School,126,98,224,2013-14
1380811,1380011,Stratford School District,Lordship School,124,111,235,2013-14
1380911,1380011,Stratford School District,Nichols School,212,219,431,2013-14
1381011,1380011,Stratford School District,Second Hill Lane School,330,368,698,2013-14
1389111,1380011,Stratford School District,Secondary STEPS Program,*,*,11,2013-14
1381511,1380011,Stratford School District,Stratford Academy - Johnson House,227,244,471,2013-14
1386111,1380011,Stratford School District,Stratford High School,483,558,1041,2013-14
1389011,1380011,Stratford School District,Strive-Stratford,*,*,21,2013-14
1381411,1380011,Stratford School District,Wilcoxson School,170,208,378,2013-14
1390411,1390011,Suffield School District,A. Ward Spaulding School,254,227,481,2013-14
1390311,1390011,Suffield School District,McAlister Intermediate School,242,254,496,2013-14
1396111,1390011,Suffield School District,Suffield High School,435,406,841,2013-14
1395111,1390011,Suffield School District,Suffield Middle School,305,289,594,2013-14
2696113,2690013,The Bridge Academy District,The Bridge Academy,143,134,277,2013-14
9026122,9020022,The Gilbert School District,The Gilbert School,222,315,537,2013-14
1400111,1400011,Thomaston School District,Black Rock School,151,133,284,2013-14
1400211,1400011,Thomaston School District,Thomaston Center School,122,118,240,2013-14
1406211,1400011,Thomaston School District,Thomaston High School,193,221,414,2013-14
1410111,1410011,Thompson School District,Mary R. Fisher Elementary School,217,225,442,2013-14
1415111,1410011,Thompson School District,Thompson Middle School,173,176,349,2013-14
1416111,1410011,Thompson School District,Tourtellotte Memorial High School,138,139,277,2013-14
1420111,1420011,Tolland School District,Birch Grove Primary School,269,295,564,2013-14
1426111,1420011,Tolland School District,Tolland High School,432,415,847,2013-14
1420211,1420011,Tolland School District,Tolland Intermediate School,293,324,617,2013-14
1425111,1420011,Tolland School District,Tolland Middle School,336,346,682,2013-14
1430111,1430011,Torrington School District,East School,174,203,377,2013-14
1430211,1430011,Torrington School District,Forbes School,155,208,363,2013-14
1430811,1430011,Torrington School District,Southwest School,146,184,330,2013-14
1430911,1430011,Torrington School District,Torringford School,312,311,623,2013-14
1436111,1430011,Torrington School District,Torrington High School,484,571,1055,2013-14
1435111,1430011,Torrington School District,Torrington Middle School,494,547,1041,2013-14
1431311,1430011,Torrington School District,Vogel-Wetmore School,235,240,475,2013-14
2785113,2780013,Trailblazers Academy District,Trailblazers Academy,73,89,162,2013-14
1440111,1440011,Trumbull School District,Booth Hill School,252,257,509,2013-14
1440811,1440011,Trumbull School District,Daniels Farm School,236,234,470,2013-14
1441011,1440011,Trumbull School District,Frenchtown Elementary School,324,347,671,2013-14
1445211,1440011,Trumbull School District,Hillcrest Middle School,362,404,766,2013-14
1440411,1440011,Trumbull School District,Jane Ryan School,199,204,403,2013-14
1445111,1440011,Trumbull School District,Madison Middle School,382,411,793,2013-14
1440311,1440011,Trumbull School District,Middlebrook School,211,243,454,2013-14
1440911,1440011,Trumbull School District,Tashua School,189,196,385,2013-14
1448011,1440011,Trumbull School District,Trumbull Early Childhood Education Center,104,116,220,2013-14
1446111,1440011,Trumbull School District,Trumbull High School,1129,1009,2138,2013-14
3360115,3360015,Unified School District #1,Bridgeport Correctional Center,0,9,9,2013-14
3360215,3360015,Unified School District #1,Brooklyn Correctional Institution,0,*,*,2013-14
3360315,3360015,Unified School District #1,Cheshire Correctional Institution,0,15,15,2013-14
3362415,3360015,Unified School District #1,Corrigan/Radgowski Correctional Institution,0,29,29,2013-14
3360415,3360015,Unified School District #1,Enfield Correctional Institution,0,11,11,2013-14
3361915,3360015,Unified School District #1,Garner Correctional Institution,0,27,27,2013-14
3360615,3360015,Unified School District #1,Hartford Correctional Center,0,26,26,2013-14
3362215,3360015,Unified School District #1,MacDougall/Walker Correctional Institution,0,29,29,2013-14
3361115,3360015,Unified School District #1,Manson Youth Institution,0,310,310,2013-14
3360915,3360015,Unified School District #1,New Haven Correctional Center,0,16,16,2013-14
3362615,3360015,Unified School District #1,Northern Correctional Institution,0,10,10,2013-14
3361215,3360015,Unified School District #1,Osborn Correctional Institution,0,12,12,2013-14
3361315,3360015,Unified School District #1,Robinson Correctional Institution,0,13,13,2013-14
3361515,3360015,Unified School District #1,Willard/Cybulski Correctional Institution,0,7,7,2013-14
3362515,3360015,Unified School District #1,York Correctional Institution,22,0,22,2013-14
3470115,3470015,Unified School District #2,Children's Place School,0,22,22,2013-14
3470315,3470015,Unified School District #2,Riverview School,37,17,54,2013-14
3476715,3470015,Unified School District #2,Walter G. Cady School,*,*,121,2013-14
1450111,1450011,Union School District,Union Elementary School,45,33,78,2013-14
1460311,1460011,Vernon School District,Northeast School,163,166,329,2013-14
1461411,1460011,Vernon School District,Center Road School,248,254,502,2013-14
1460111,1460011,Vernon School District,Lake Street School,117,139,256,2013-14
1460511,1460011,Vernon School District,Loveland Hill School,*,*,8,2013-14
1460211,1460011,Vernon School District,Maple Street School,151,172,323,2013-14
1469011,1460011,Vernon School District,Next Step Program (AACBP),*,*,10,2013-14
1466111,1460011,Vernon School District,Rockville High School,468,458,926,2013-14
1461011,1460011,Vernon School District,Skinner Road School,149,157,306,2013-14
1465111,1460011,Vernon School District,Vernon Center Middle School,325,337,662,2013-14
1470111,1470011,Voluntown School District,Voluntown Elementary School,160,143,303,2013-14
1480211,1480011,Wallingford School District,Highland School,125,140,265,2013-14
1489011,1480011,Wallingford School District,A.R.T.S. Academy,*,*,13,2013-14
1481011,1480011,Wallingford School District,Cook Hill School,180,163,343,2013-14
1485211,1480011,Wallingford School District,Dag Hammarskjold Middle School,357,343,700,2013-14
1480911,1480011,Wallingford School District,Evarts C. Stevens School,159,200,359,2013-14
1489211,1480011,Wallingford School District,Harvest Park,0,7,7,2013-14
1485311,1480011,Wallingford School District,James H. Moran Middle School,338,343,681,2013-14
1486111,1480011,Wallingford School District,Lyman Hall High School,614,484,1098,2013-14
1486211,1480011,Wallingford School District,Mark T. Sheehan High School,458,434,892,2013-14
1480111,1480011,Wallingford School District,Moses Y. Beach School,160,167,327,2013-14
1489111,1480011,Wallingford School District,Multi-Vocational Life Skills Program,*,*,7,2013-14
1480311,1480011,Wallingford School District,Parker Farms School,136,153,289,2013-14
1481211,1480011,Wallingford School District,Pond Hill School,186,188,374,2013-14
1480411,1480011,Wallingford School District,Rock Hill School,166,177,343,2013-14
1480811,1480011,Wallingford School District,Yalesville School,188,188,376,2013-14
1515211,1510011,Waterbury School District,West Side Middle School,472,516,988,2013-14
1512311,1510011,Waterbury School District,Washington School,181,156,337,2013-14
1512111,1510011,Waterbury School District,B. W. Tinker School,260,312,572,2013-14
1510511,1510011,Waterbury School District,Bucks Hill School,275,272,547,2013-14
1510611,1510011,Waterbury School District,Bunker Hill School,242,272,514,2013-14
1512711,1510011,Waterbury School District,Carrington School,235,211,446,2013-14
1516211,1510011,Waterbury School District,Crosby High School,659,730,1389,2013-14
1510911,1510011,Waterbury School District,Driggs School,262,285,547,2013-14
1511611,1510011,Waterbury School District,Duggan School,230,234,464,2013-14
1519111,1510011,Waterbury School District,Enlightenment School,78,113,191,2013-14
1511411,1510011,Waterbury School District,F. J. Kingsbury School,267,248,515,2013-14
1512611,1510011,Waterbury School District,Gilmartin School,250,268,518,2013-14
1510711,1510011,Waterbury School District,H. S. Chase School,363,421,784,2013-14
1511311,1510011,Waterbury School District,Hopeville School,251,234,485,2013-14
1516411,1510011,Waterbury School District,John F. Kennedy High School,600,686,1286,2013-14
1513111,1510011,Waterbury School District,Maloney Interdistrict Magnet School,266,336,602,2013-14
1511111,1510011,Waterbury School District,Margaret M. Generali Elementary School,276,325,601,2013-14
1515111,1510011,Waterbury School District,Michael F. Wallace Middle School,585,586,1171,2013-14
1515311,1510011,Waterbury School District,North End Middle School,505,545,1050,2013-14
1513411,1510011,Waterbury School District,Reed School,185,193,378,2013-14
1512811,1510011,Waterbury School District,Regan School,129,132,261,2013-14
1513311,1510011,Waterbury School District,Rotella Interdistrict Magnet School,315,299,614,2013-14
1518011,1510011,Waterbury School District,Special Education Preschool,85,118,203,2013-14
1512011,1510011,Waterbury School District,Sprague School,233,239,472,2013-14
1519011,1510011,Waterbury School District,State Street School,19,60,79,2013-14
1512211,1510011,Waterbury School District,Walsh School,242,217,459,2013-14
1516011,1510011,Waterbury School District,Waterbury Arts Magnet School (High),308,181,489,2013-14
1515011,1510011,Waterbury School District,Waterbury Arts Magnet School (Middle),201,130,331,2013-14
1516711,1510011,Waterbury School District,Waterbury Career Academy,139,106,245,2013-14
1510811,1510011,Waterbury School District,Wendell L. Cross School,178,189,367,2013-14
1516311,1510011,Waterbury School District,Wilby High School,599,693,1292,2013-14
1513211,1510011,Waterbury School District,Woodrow Wilson School,197,220,417,2013-14
1525111,1520011,Waterford School District,Clark Lane Middle School,319,345,664,2013-14
1520211,1520011,Waterford School District,Great Neck Elementary School,182,157,339,2013-14
1520611,1520011,Waterford School District,Oswegatchie Elementary School,184,190,374,2013-14
1520711,1520011,Waterford School District,Quaker Hill Elementary School,165,197,362,2013-14
1526111,1520011,Waterford School District,Waterford High School,391,416,807,2013-14
1530311,1530011,Watertown School District,Fletcher W. Judson School,119,167,286,2013-14
1530211,1530011,Watertown School District,John Trumbull Primary School,317,360,677,2013-14
1530411,1530011,Watertown School District,Polk School,167,171,338,2013-14
1535111,1530011,Watertown School District,Swift Middle School,364,370,734,2013-14
1536111,1530011,Watertown School District,Watertown High School,444,438,882,2013-14
1551711,1550011,West Hartford School District,Smith School,174,194,368,2013-14
1559111,1550011,West Hartford School District,Achieve,*,*,8,2013-14
1551611,1550011,West Hartford School District,Aiken School,216,252,468,2013-14
1550211,1550011,West Hartford School District,Braeburn School,178,186,364,2013-14
1555311,1550011,West Hartford School District,Bristow Middle School,202,216,418,2013-14
1550411,1550011,West Hartford School District,Bugbee School,238,229,467,2013-14
1550511,1550011,West Hartford School District,Charter Oak International Academy,165,150,315,2013-14
1556111,1550011,West Hartford School District,Conard High School,741,761,1502,2013-14
1550611,1550011,West Hartford School District,Duffy School,268,264,532,2013-14
1556211,1550011,West Hartford School District,Hall High School,721,755,1476,2013-14
1555111,1550011,West Hartford School District,King Philip Middle School,446,460,906,2013-14
1550911,1550011,West Hartford School District,Morley School,171,159,330,2013-14
1551011,1550011,West Hartford School District,Norfeldt School,158,213,371,2013-14
1555211,1550011,West Hartford School District,Sedgwick Middle School,387,452,839,2013-14
1559211,1550011,West Hartford School District,Strive-West Hartford,8,20,28,2013-14
1559011,1550011,West Hartford School District,WAAVE (W Hartford Applied Academic/Voc'l Experience),*,*,8,2013-14
1551211,1550011,West Hartford School District,Webster Hill School,244,211,455,2013-14
1551311,1550011,West Hartford School District,Whiting Lane School,254,266,520,2013-14
1551511,1550011,West Hartford School District,Wolcott School,244,252,496,2013-14
1561211,1560011,West Haven School District,Washington School,230,252,482,2013-14
1560811,1560011,West Haven School District,Alma E. Pagels School,146,219,365,2013-14
1565311,1560011,West Haven School District,Carrigan 5/6 Intermediate School,420,442,862,2013-14
1560611,1560011,West Haven School District,Edith E. Mackrille School,177,179,356,2013-14
1560311,1560011,West Haven School District,Forest School,237,229,466,2013-14
1565111,1560011,West Haven School District,Harry M. Bailey Middle School,416,450,866,2013-14
1560111,1560011,West Haven School District,Life Skills,*,*,6,2013-14
1561411,1560011,West Haven School District,Savin Rock Community School,239,260,499,2013-14
1560411,1560011,West Haven School District,Seth G. Haley School,233,251,484,2013-14
1566111,1560011,West Haven School District,West Haven High School,800,765,1565,2013-14
1540211,1540011,Westbrook School District,Daisy Ingraham School,131,162,293,2013-14
1546111,1540011,Westbrook School District,Westbrook High School,130,147,277,2013-14
1545111,1540011,Westbrook School District,Westbrook Middle School,134,128,262,2013-14
1570111,1570011,Weston School District,Hurlbutt Elementary School,201,266,467,2013-14
1576111,1570011,Weston School District,Weston High School,364,411,775,2013-14
1570211,1570011,Weston School District,Weston Intermediate School,266,285,551,2013-14
1575111,1570011,Weston School District,Weston Middle School,299,318,617,2013-14
1585111,1580011,Westport School District,Bedford Middle School,395,463,858,2013-14
1580311,1580011,Westport School District,Coleytown Elementary School,228,223,451,2013-14
1585311,1580011,Westport School District,Coleytown Middle School,269,264,533,2013-14
1580411,1580011,Westport School District,Green's Farms School,229,217,446,2013-14
1580511,1580011,Westport School District,King's Highway Elementary School,243,255,498,2013-14
1580711,1580011,Westport School District,Long Lots School,275,303,578,2013-14
1580811,1580011,Westport School District,Saugatuck Elementary School,232,291,523,2013-14
1586111,1580011,Westport School District,Staples High School,917,917,1834,2013-14
1588011,1580011,Westport School District,Stepping Stones Preschool,13,28,41,2013-14
1590811,1590011,Wethersfield School District,Alfred W. Hanmer School,175,184,359,2013-14
1591011,1590011,Wethersfield School District,Charles Wright School,159,148,307,2013-14
1590211,1590011,Wethersfield School District,Emerson-Williams School,229,210,439,2013-14
1591111,1590011,Wethersfield School District,Highcrest School,225,203,428,2013-14
1591211,1590011,Wethersfield School District,Samuel B. Webb Elementary School,186,196,382,2013-14
1595211,1590011,Wethersfield School District,Silas Deane Middle School,310,289,599,2013-14
1596111,1590011,Wethersfield School District,Wethersfield High School,562,625,1187,2013-14
1600111,1600011,Willington School District,Center School,89,104,193,2013-14
1605111,1600011,Willington School District,Hall Memorial School,126,138,264,2013-14
1615211,1610011,Wilton School District,Middlebrook School,538,519,1057,2013-14
1610711,1610011,Wilton School District,Cider Mill School,497,521,1018,2013-14
1610511,1610011,Wilton School District,Miller-Driscoll School,434,451,885,2013-14
1616111,1610011,Wilton School District,Wilton High School,649,669,1318,2013-14
1620411,1620011,Winchester School District,Batcheller Early Education Center,97,123,220,2013-14
1620211,1620011,Winchester School District,Mary P. Hinsdale School,111,121,232,2013-14
1625111,1620011,Winchester School District,Pearson Middle School,76,89,165,2013-14
1620111,1620011,Winchester School District,WISE Academy,*,*,9,2013-14
1630411,1630011,Windham School District,Charles H. Barrows STEM Academy,148,152,300,2013-14
1638011,1630011,Windham School District,Early Headstart,12,10,22,2013-14
1630111,1630011,Windham School District,Natchaug School,163,181,344,2013-14
1630311,1630011,Windham School District,North Windham School,232,234,466,2013-14
1630611,1630011,Windham School District,W. B. Sweeney School,143,150,293,2013-14
1630511,1630011,Windham School District,Windham Center School,146,157,303,2013-14
1638311,1630011,Windham School District,Windham Early Childhood Prospect Street,98,131,229,2013-14
1636111,1630011,Windham School District,Windham High School,284,340,624,2013-14
1635111,1630011,Windham School District,Windham Middle School,309,356,665,2013-14
1650111,1650011,Windsor Locks School District,North Street School,211,198,409,2013-14
1650411,1650011,Windsor Locks School District,South Elementary School,179,200,379,2013-14
1656111,1650011,Windsor Locks School District,Windsor Locks High School,229,294,523,2013-14
1655111,1650011,Windsor Locks School District,Windsor Locks Middle School,175,180,355,2013-14
1640111,1640011,Windsor School District,Clover Street School,128,130,258,2013-14
1640811,1640011,Windsor School District,John F. Kennedy School,215,211,426,2013-14
1640911,1640011,Windsor School District,Oliver Ellsworth School,203,248,451,2013-14
1640511,1640011,Windsor School District,Poquonock Elementary School,129,120,249,2013-14
1645311,1640011,Windsor School District,Sage Park Middle School,367,358,725,2013-14
1646111,1640011,Windsor School District,Windsor High School,531,609,1140,2013-14
1660611,1660011,Wolcott School District,Alcott School,122,158,280,2013-14
1660211,1660011,Wolcott School District,Frisbie School,166,176,342,2013-14
1665111,1660011,Wolcott School District,Tyrrell Middle School,315,341,656,2013-14
1660511,1660011,Wolcott School District,Wakelee School,184,175,359,2013-14
1666111,1660011,Wolcott School District,Wolcott High School,422,424,846,2013-14
1670311,1670011,Woodbridge School District,Beecher Road School,383,385,768,2013-14
9036122,9030022,Woodstock Academy District,Woodstock Academy,519,514,1033,2013-14
1690211,1690011,Woodstock School District,Woodstock Elementary School,235,238,473,2013-14
1695111,1690011,Woodstock School District,Woodstock Middle School,222,204,426,2013-14
2880113,2880013,Achievement First Hartford Academy Inc. District,Achievement First Hartford Academy Inc.,466,488,954,2014-15
2795113,2790013,Amistad Academy District,Amistad Academy,499,485,984,2014-15
0010111,0010011,Andover School District,Andover Elementary School,129,146,275,2014-15
0026111,0020011,Ansonia School District,Ansonia High School,276,308,584,2014-15
0025111,0020011,Ansonia School District,Ansonia Middle School,240,258,498,2014-15
0020311,0020011,Ansonia School District,Mead School,286,311,597,2014-15
0020111,0020011,Ansonia School District,P.A.C.E. (Positive And Creative Education),16,24,40,2014-15
0020811,0020011,Ansonia School District,Prendergast School,318,362,680,2014-15
2449614,2440014,Area Cooperative Educational Services,Center for Autism Spectrum and Development Disorders,8,31,39,2014-15
2449414,2440014,Area Cooperative Educational Services,Mill Road School,25,135,160,2014-15
2445114,2440014,Area Cooperative Educational Services,Thomas Edison Magnet Middle School,350,363,713,2014-15
2449514,2440014,Area Cooperative Educational Services,Village School,45,106,151,2014-15
2449214,2440014,Area Cooperative Educational Services,Whitney High School East,36,77,113,2014-15
2449114,2440014,Area Cooperative Educational Services,Whitney High School North,27,63,90,2014-15
2449314,2440014,Area Cooperative Educational Services,Whitney High School West,8,34,42,2014-15
2440314,2440014,Area Cooperative Educational Services,Wintergreen Interdistrict  Magnet School,309,322,631,2014-15
0030111,0030011,Ashford School District,Ashford School,204,211,415,2014-15
0046111,0040011,Avon School District,Avon High School,528,523,1051,2014-15
0045111,0040011,Avon School District,Avon Middle School,289,259,548,2014-15
0040111,0040011,Avon School District,Avon Public Schools Pre-K,26,22,48,2014-15
0040411,0040011,Avon School District,Pine Grove School,308,268,576,2014-15
0040311,0040011,Avon School District,Roaring Brook School,264,282,546,2014-15
0040511,0040011,Avon School District,Thompson Brook School,243,309,552,2014-15
0050111,0050011,Barkhamsted School District,Barkhamsted Elementary School,135,160,295,2014-15
0058011,0050011,Barkhamsted School District,Shared Services Integrated Preschool,10,12,22,2014-15
0076111,0070011,Berlin School District,Berlin High School,439,479,918,2014-15
0075111,0070011,Berlin School District,Catherine M. McGee Middle School,308,394,702,2014-15
0070411,0070011,Berlin School District,Emma Hart Willard School,232,272,504,2014-15
0070511,0070011,Berlin School District,Mary E. Griswold School,254,293,547,2014-15
0070111,0070011,Berlin School District,Richard D. Hubbard School,112,113,225,2014-15
0080111,0080011,Bethany School District,Bethany Community School,187,220,407,2014-15
0090411,0090011,Bethel School District,Anna H. Rockwell School,209,204,413,2014-15
0096111,0090011,Bethel School District,Bethel High School,432,457,889,2014-15
0095111,0090011,Bethel School District,Bethel Middle School,320,375,695,2014-15
0090111,0090011,Bethel School District,Frank A. Berry School,247,299,546,2014-15
0090511,0090011,Bethel School District,Ralph M. T. Johnson School,187,199,386,2014-15
0116111,0110011,Bloomfield School District,Bloomfield High School,246,292,538,2014-15
0110711,0110011,Bloomfield School District,Carmen Arace Intermediate School,94,114,208,2014-15
0115211,0110011,Bloomfield School District,Carmen Arace Middle School,90,124,214,2014-15
0116311,0110011,Bloomfield School District,Global Experience Magnet School,137,83,220,2014-15
0110611,0110011,Bloomfield School District,Laurel School,181,164,345,2014-15
0116411,0110011,Bloomfield School District,Learning Academy at Bloomfield,6,7,13,2014-15
0110511,0110011,Bloomfield School District,Metacomet School,118,130,248,2014-15
0110811,0110011,Bloomfield School District,Wintonbury Early Childhood Magnet School,154,167,321,2014-15
0120111,0120011,Bolton School District,Bolton Center School,258,262,520,2014-15
0126111,0120011,Bolton School District,Bolton High School,157,161,318,2014-15
2950113,2950013,Booker T. Washington Academy District,Booker T. Washington Academy,38,53,91,2014-15
0130111,0130011,Bozrah School District,Fields Memorial School,103,106,209,2014-15
0146111,0140011,Branford School District,Branford High School,475,486,961,2014-15
0140211,0140011,Branford School District,Branford High School Horizons Program,*,*,9,2014-15
0145111,0140011,Branford School District,Francis Walsh Intermediate School,462,454,916,2014-15
0148011,0140011,Branford School District,Indian Neck School,11,28,39,2014-15
0141611,0140011,Branford School District,John B. Sliney School,169,186,355,2014-15
0141511,0140011,Branford School District,Mary R. Tisko School,186,202,388,2014-15
0141411,0140011,Branford School District,Mary T. Murphy School,166,247,413,2014-15
2900113,2900013,Brass City Charter School District,Brass City Charter School,91,59,150,2014-15
2850113,2850013,Bridgeport Achievement First District,Achievement First Bridgeport Academy,484,493,977,2014-15
0150811,0150011,Bridgeport School District,"Aerospace/Hydrospace, Engineering and Physical Sciences HS at the Fairchild-Wheeler Magnet Campus",120,236,356,2014-15
0150111,0150011,Bridgeport School District,Barnum School,286,349,635,2014-15
0156111,0150011,Bridgeport School District,Bassick High School,441,567,1008,2014-15
0150211,0150011,Bridgeport School District,Beardsley School,180,190,370,2014-15
0150611,0150011,Bridgeport School District,"Biotechnology, Research and Zoological Studies HS at the Fairchild-Wheeler Magnet Campus",240,108,348,2014-15
0150311,0150011,Bridgeport School District,Black Rock School,189,224,413,2014-15
0154011,0150011,Bridgeport School District,Blackham School,513,601,1114,2014-15
0159011,0150011,Bridgeport School District,Bridgeport Learning Center,13,52,65,2014-15
0151611,0150011,Bridgeport School District,Bridgeport Military Academy,93,140,233,2014-15
0150411,0150011,Bridgeport School District,Bryant School,186,220,406,2014-15
0156211,0150011,Bridgeport School District,Central High School,849,824,1673,2014-15
0151411,0150011,Bridgeport School District,Cesar Batalla School,541,663,1204,2014-15
0152111,0150011,Bridgeport School District,Classical Studies Academy,189,182,371,2014-15
0150511,0150011,Bridgeport School District,Columbus School,421,440,861,2014-15
0153911,0150011,Bridgeport School District,Cross School,180,206,386,2014-15
0154211,0150011,Bridgeport School District,Curiale School,348,421,769,2014-15
0154111,0150011,Bridgeport School District,Dunbar School,191,186,377,2014-15
0150711,0150011,Bridgeport School District,Edison School,123,151,274,2014-15
0153211,0150011,Bridgeport School District,Geraldine Johnson School,393,431,824,2014-15
0151111,0150011,Bridgeport School District,Hall School,126,136,262,2014-15
0151211,0150011,Bridgeport School District,Hallen School,144,158,302,2014-15
0156311,0150011,Bridgeport School District,Harding High School,535,599,1134,2014-15
0154511,0150011,Bridgeport School District,High Horizons Magnet School,222,192,414,2014-15
0151311,0150011,Bridgeport School District,Hooker School,182,189,371,2014-15
0151511,0150011,Bridgeport School District,Information Technology and Software Engineering High School at the Fairchild-Wheeler Magnet Campus,130,235,365,2014-15
0153711,0150011,Bridgeport School District,Interdistrict Discovery Magnet School,253,265,518,2014-15
0152211,0150011,Bridgeport School District,Jettie S. Tisdale School,326,353,679,2014-15
0151011,0150011,Bridgeport School District,Luis Munoz Marin School,447,473,920,2014-15
0152011,0150011,Bridgeport School District,Madison School,237,296,533,2014-15
0154611,0150011,Bridgeport School District,Multicultural Magnet School,263,194,457,2014-15
0151711,0150011,Bridgeport School District,Park City Magnet School,251,214,465,2014-15
0152511,0150011,Bridgeport School District,Read School,424,460,884,2014-15
0152611,0150011,Bridgeport School District,Roosevelt School,275,287,562,2014-15
0154411,0150011,Bridgeport School District,Skane Center,138,249,387,2014-15
0153011,0150011,Bridgeport School District,Waltersville School,247,244,491,2014-15
0153611,0150011,Bridgeport School District,Winthrop School,303,349,652,2014-15
0179011,0170011,Bristol School District,Alternative Special Education Program (ASEP),*,*,17,2014-15
0176111,0170011,Bristol School District,Bristol Central High School,567,613,1180,2014-15
0170411,0170011,Bristol School District,Bristol Early Childhood Center-BECC,34,40,74,2014-15
0176211,0170011,Bristol School District,Bristol Eastern High School,614,633,1247,2014-15
0173311,0170011,Bristol School District,Bristol Preparatory Academy,19,25,44,2014-15
0175111,0170011,Bristol School District,Chippens Hill Middle School,351,409,760,2014-15
0171011,0170011,Bristol School District,Chippens Hill Middle School Functional Program,*,*,8,2014-15
0173411,0170011,Bristol School District,Chms Goal,*,*,7,2014-15
0179211,0170011,Bristol School District,Community/Vocational Program,*,*,11,2014-15
0170311,0170011,Bristol School District,Edgewood School,168,172,340,2014-15
0171411,0170011,Bristol School District,Ellen P. Hubbell School,207,215,422,2014-15
0170911,0170011,Bristol School District,Greene-Hills GOAL,0,*,*,2014-15
0170511,0170011,Bristol School District,Greene-Hills School,432,460,892,2014-15
0172111,0170011,Bristol School District,Hubbell/Extended Resource,*,*,*,2014-15
0172611,0170011,Bristol School District,Ivy Drive GOAL,*,*,*,2014-15
0172311,0170011,Bristol School District,Ivy Drive Medically Fragile,*,*,6,2014-15
0171911,0170011,Bristol School District,Ivy Drive School,193,203,396,2014-15
0171711,0170011,Bristol School District,Mountain View School,201,181,382,2014-15
0172511,0170011,Bristol School District,Mt. View GOAL,*,*,*,2014-15
0172711,0170011,Bristol School District,Northeast MS/Extended Resource,0,*,*,2014-15
0172811,0170011,Bristol School District,Northeast MS/GOAL,*,*,*,2014-15
0175211,0170011,Bristol School District,Northeast Middle School,219,211,430,2014-15
0172911,0170011,Bristol School District,PreK Autism,0,*,*,2014-15
0173011,0170011,Bristol School District,South Side Extended Resource,*,*,*,2014-15
0173111,0170011,Bristol School District,South Side GOAL,0,6,6,2014-15
0171111,0170011,Bristol School District,South Side School,257,272,529,2014-15
0173211,0170011,Bristol School District,Stafford Autism,*,*,11,2014-15
0171211,0170011,Bristol School District,Stafford School,223,220,443,2014-15
0172011,0170011,Bristol School District,West Bristol School,446,473,919,2014-15
0186111,0180011,Brookfield School District,Brookfield High School,467,428,895,2014-15
0180311,0180011,Brookfield School District,Center Elementary School,165,169,334,2014-15
0180411,0180011,Brookfield School District,Huckleberry Hill Elementary School,291,308,599,2014-15
0185311,0180011,Brookfield School District,Whisconier Middle School,430,452,882,2014-15
0190111,0190011,Brooklyn School District,Brooklyn Elementary School,261,275,536,2014-15
0195111,0190011,Brooklyn School District,Brooklyn Middle School,185,188,373,2014-15
0210111,0210011,Canaan School District,Lee H. Kellogg School,41,37,78,2014-15
0220211,0220011,Canterbury School District,Canterbury Elementary School,120,123,243,2014-15
0225111,0220011,Canterbury School District,Dr. Helen Baldwin Middle School,99,129,228,2014-15
0230411,0230011,Canton School District,Canton Academy,*,*,*,2014-15
0236111,0230011,Canton School District,Canton High School,231,254,485,2014-15
0230311,0230011,Canton School District,Canton Intermediate School,202,208,410,2014-15
0235111,0230011,Canton School District,Canton Middle School,143,129,272,2014-15
0230211,0230011,Canton School District,Cherry Brook Primary School,230,219,449,2014-15
2415114,2410014,Capitol Region Education Council,Academy of Aerospace and Engineering,157,479,636,2014-15
2410714,2410014,Capitol Region Education Council,Academy of Aerospace and Engineering Elementary,122,175,297,2014-15
2416514,2410014,Capitol Region Education Council,Academy of Science and Innovation,402,127,529,2014-15
2410614,2410014,Capitol Region Education Council,Ana Grace Academy of the Arts Elementary School,167,146,313,2014-15
2418114,2410014,Capitol Region Education Council,Discovery Academy,151,205,356,2014-15
2419214,2410014,Capitol Region Education Council,Farmington Valley Regional Diagnostic Center,9,11,20,2014-15
2410114,2410014,Capitol Region Education Council,Glastonbury/East Hartford Magnet School,196,239,435,2014-15
2416414,2410014,Capitol Region Education Council,Greater Hartford Academy of  the Arts High School - Full Time,341,116,457,2014-15
2415314,2410014,Capitol Region Education Council,Greater Hartford Academy of the Arts Magnet Middle,218,110,328,2014-15
2419414,2410014,Capitol Region Education Council,Integrated Program Models,*,*,*,2014-15
2410414,2410014,Capitol Region Education Council,International Magnet School for Global Citizenship,238,227,465,2014-15
2419014,2410014,Capitol Region Education Council,John J. Allison Polaris Center,22,35,57,2014-15
2419614,2410014,Capitol Region Education Council,Lincoln Academy Regional Interdistrict Collaborative,6,9,15,2014-15
2416114,2410014,Capitol Region Education Council,Metropolitan Learning Center for Global and International Studies,401,335,736,2014-15
2413114,2410014,Capitol Region Education Council,Montessori Magnet School,183,174,357,2014-15
2410514,2410014,Capitol Region Education Council,Museum Academy,239,220,459,2014-15
2415214,2410014,Capitol Region Education Council,Public Safety Academy,175,344,519,2014-15
2410314,2410014,Capitol Region Education Council,Reggio Magnet School of the Arts,229,239,468,2014-15
2419514,2410014,Capitol Region Education Council,River Street Early Learning Center (Site 2),16,48,64,2014-15
2419314,2410014,Capitol Region Education Council,River Street School,22,129,151,2014-15
2419114,2410014,Capitol Region Education Council,Soundbridge,24,22,46,2014-15
2411114,2410014,Capitol Region Education Council,Soundbridge @ Academy of Aerospace & Engineering Elementary,*,*,8,2014-15
2411214,2410014,Capitol Region Education Council,Soundbridge @ Museum Academy,*,*,9,2014-15
2410814,2410014,Capitol Region Education Council,Soundbridge @ Samuel B Webb Elementary School,*,0,*,2014-15
2410914,2410014,Capitol Region Education Council,Soundbridge @ Silas Deane Middle School,0,*,*,2014-15
2411014,2410014,Capitol Region Education Council,Soundbridge @ Wethersfield High School,*,*,9,2014-15
2419714,2410014,Capitol Region Education Council,Strive (Southern Transition Real-World and Independent Vocational Education Program,*,*,12,2014-15
2416714,2410014,Capitol Region Education Council,Two Rivers Magnet High School,143,160,303,2014-15
2415014,2410014,Capitol Region Education Council,Two Rivers Magnet Middle School,263,401,664,2014-15
2410214,2410014,Capitol Region Education Council,University of Hartford Magnet School,229,217,446,2014-15
0240211,0240011,Chaplin School District,Chaplin Elementary School,78,100,178,2014-15
0250111,0250011,Cheshire School District,Chapman School,180,170,350,2014-15
0256111,0250011,Cheshire School District,Cheshire High School,701,811,1512,2014-15
0250311,0250011,Cheshire School District,Cheshire Quinnipiac University Transition Collaborative,*,*,8,2014-15
0250211,0250011,Cheshire School District,Darcey School,69,101,170,2014-15
0255111,0250011,Cheshire School District,Dodd Middle School,387,368,755,2014-15
0250611,0250011,Cheshire School District,Doolittle School,266,236,502,2014-15
0250411,0250011,Cheshire School District,Highland School,372,396,768,2014-15
0250911,0250011,Cheshire School District,Humiston Alternative School,9,10,19,2014-15
0250511,0250011,Cheshire School District,Norton School,230,217,447,2014-15
0260111,0260011,Chester School District,Chester Elementary School,129,90,219,2014-15
0270111,0270011,Clinton School District,Abraham Pierson School,139,176,315,2014-15
0275111,0270011,Clinton School District,Jared Eliot School,224,237,461,2014-15
0270311,0270011,Clinton School District,Lewin G. Joel Jr. School,276,280,556,2014-15
0276111,0270011,Clinton School District,The Morgan School,281,269,550,2014-15
0286111,0280011,Colchester School District,Bacon Academy,467,419,886,2014-15
0280411,0280011,Colchester School District,Colchester Elementary School,262,280,542,2014-15
0280211,0280011,Colchester School District,Jack Jackter Intermediate School,278,307,585,2014-15
0285111,0280011,Colchester School District,William J. Johnston Middle School,305,321,626,2014-15
0290111,0290011,Colebrook School District,Colebrook Consolidated School,39,52,91,2014-15
0300111,0300011,Columbia School District,Horace W. Porter School,224,229,453,2014-15
2686113,2680013,Common Ground High School District,Common Ground High School,80,100,180,2014-15
9001516,9000016,Connecticut Technical High School System,A. I. Prince Technical High School,429,378,807,2014-15
9001116,9000016,Connecticut Technical High School System,Bullard-Havens Technical High School,435,366,801,2014-15
9001916,9000016,Connecticut Technical High School System,E. C. Goodwin Technical High School,263,365,628,2014-15
9001416,9000016,Connecticut Technical High School System,Eli Whitney Technical High School,253,313,566,2014-15
9002716,9000016,Connecticut Technical High School System,Ella T. Grasso Southeastern Technical High School,207,306,513,2014-15
9002516,9000016,Connecticut Technical High School System,Emmett O'Brien Technical High School,208,360,568,2014-15
9001716,9000016,Connecticut Technical High School System,H. C. Wilcox Technical High School,354,431,785,2014-15
9001316,9000016,Connecticut Technical High School System,H. H. Ellis Technical High School,177,442,619,2014-15
9001216,9000016,Connecticut Technical High School System,Henry Abbott Technical High School,227,422,649,2014-15
9001616,9000016,Connecticut Technical High School System,Howell Cheney Technical High School,149,505,654,2014-15
9002116,9000016,Connecticut Technical High School System,J. M. Wright Technical High School,57,88,145,2014-15
9002016,9000016,Connecticut Technical High School System,Norwich Technical High School,251,422,673,2014-15
9002216,9000016,Connecticut Technical High School System,Oliver Wolcott Technical High School,257,403,660,2014-15
9002616,9000016,Connecticut Technical High School System,Platt Technical High School,326,500,826,2014-15
9001816,9000016,Connecticut Technical High School System,Vinal Technical High School,161,469,630,2014-15
9002316,9000016,Connecticut Technical High School System,W. F. Kaynor Technical High School,345,396,741,2014-15
9002416,9000016,Connecticut Technical High School System,Windham Technical High School,174,351,525,2014-15
2439214,2430014,Cooperative Educational Services,Developmental Learning Center (DLC),25,65,90,2014-15
2439114,2430014,Cooperative Educational Services,Preschool-Primary Learning Center (PLC),14,36,50,2014-15
2439314,2430014,Cooperative Educational Services,RISE Transitional Program,*,*,11,2014-15
2438014,2430014,Cooperative Educational Services,School Readiness,45,40,85,2014-15
2430114,2430014,Cooperative Educational Services,Six-Six Magnet School,242,217,459,2014-15
2439414,2430014,Cooperative Educational Services,Therapeutic Day Program,23,131,154,2014-15
0310111,0310011,Cornwall School District,Cornwall Consolidated School,35,56,91,2014-15
0325111,0320011,Coventry School District,Capt. Nathan Hale School,203,182,385,2014-15
0320111,0320011,Coventry School District,Coventry Academy,*,*,10,2014-15
0328011,0320011,Coventry School District,Coventry Early Intervention Services,8,19,27,2014-15
0320211,0320011,Coventry School District,Coventry Grammar School,169,194,363,2014-15
0326111,0320011,Coventry School District,Coventry High School,246,244,490,2014-15
0320411,0320011,Coventry School District,George Hersey Robertson School,192,176,368,2014-15
0336111,0330011,Cromwell School District,Cromwell High School,276,290,566,2014-15
0335111,0330011,Cromwell School District,Cromwell Middle School,217,238,455,2014-15
0330211,0330011,Cromwell School District,Edna C. Stevens School,225,241,466,2014-15
0330311,0330011,Cromwell School District,Woodside Intermediate School,222,259,481,2014-15
0346211,0340011,Danbury School District,Alternative Center For Excellence,42,56,98,2014-15
0345111,0340011,Danbury School District,Broadview Middle School,558,525,1083,2014-15
0340111,0340011,Danbury School District,DPS Early Childhood Center,53,77,130,2014-15
0346111,0340011,Danbury School District,Danbury High School,1409,1476,2885,2014-15
0341411,0340011,Danbury School District,Ellsworth Avenue School,196,233,429,2014-15
0341111,0340011,Danbury School District,Great Plain School,173,182,355,2014-15
0340211,0340011,Danbury School District,Hayestown Avenue School,209,249,458,2014-15
0341711,0340011,Danbury School District,King Street Intermediate School,181,185,366,2014-15
0341311,0340011,Danbury School District,King Street Primary School,192,198,390,2014-15
0340511,0340011,Danbury School District,Mill Ridge Primary School,169,165,334,2014-15
0340611,0340011,Danbury School District,Morris Street School,184,187,371,2014-15
0340811,0340011,Danbury School District,Park Avenue School,274,289,563,2014-15
0341511,0340011,Danbury School District,Pembroke School,175,200,375,2014-15
0345211,0340011,Danbury School District,Rogers Park Middle School,472,460,932,2014-15
0341211,0340011,Danbury School District,Shelter Rock School,235,262,497,2014-15
0341011,0340011,Danbury School District,South Street School,184,185,369,2014-15
0341611,0340011,Danbury School District,Stadley Rough School,231,241,472,2014-15
0341911,0340011,Danbury School District,Western CT Academy of International Studies Elementary Magnet School,234,179,413,2014-15
0340311,0340011,Danbury School District,Westside Middle School Academy,177,223,400,2014-15
0356111,0350011,Darien School District,Darien High School,673,692,1365,2014-15
0350211,0350011,Darien School District,Hindley Elementary School,273,283,556,2014-15
0350711,0350011,Darien School District,Holmes Elementary School,250,223,473,2014-15
0355111,0350011,Darien School District,Middlesex Middle School,530,595,1125,2014-15
0351311,0350011,Darien School District,Ox Ridge Elementary School,204,245,449,2014-15
0350511,0350011,Darien School District,Royle Elementary School,200,242,442,2014-15
0350611,0350011,Darien School District,Tokeneke Elementary School,253,240,493,2014-15
0360111,0360011,Deep River School District,Deep River Elementary School,155,157,312,2014-15
3370215,3370015,Department of Mental Health and Addiction Services,Connecticut Valley Hospital,*,*,6,2014-15
3370515,3370015,Department of Mental Health and Addiction Services,Greater Bridgeport Community Mental Health Center,0,*,*,2014-15
0370611,0370011,Derby School District,Bradley School,176,189,365,2014-15
0376111,0370011,Derby School District,Derby High School,176,196,372,2014-15
0375011,0370011,Derby School District,Derby Middle School,169,170,339,2014-15
0370411,0370011,Derby School District,Irving School,179,191,370,2014-15
0400111,0400011,East Granby School District,Allgrove School,115,107,222,2014-15
0406111,0400011,East Granby School District,East Granby High School,127,130,257,2014-15
0405111,0400011,East Granby School District,East Granby Middle School,114,97,211,2014-15
0400211,0400011,East Granby School District,R. Dudley Seymour School,77,108,185,2014-15
0410111,0410011,East Haddam School District,East Haddam Elementary School,156,163,319,2014-15
0416111,0410011,East Haddam School District,Nathan Hale-Ray High School,185,166,351,2014-15
0415111,0410011,East Haddam School District,Nathan Hale-Ray Middle School,213,242,455,2014-15
0420311,0420011,East Hampton School District,Center School,132,151,283,2014-15
0426111,0420011,East Hampton School District,East Hampton High School,273,229,502,2014-15
0425111,0420011,East Hampton School District,East Hampton Middle School,204,228,432,2014-15
0420111,0420011,East Hampton School District,Memorial School,308,297,605,2014-15
0429011,0420011,East Hampton School District,The Learning Center at East Hampton,*,*,8,2014-15
0430911,0430011,East Hartford School District,Anna E. Norris School,131,153,284,2014-15
0436311,0430011,East Hartford School District,Connecticut IB Academy,132,71,203,2014-15
0430611,0430011,East Hartford School District,Dr. Franklin H. Mayberry School,180,184,364,2014-15
0432211,0430011,East Hartford School District,Dr. John A. Langford School,159,216,375,2014-15
0431011,0430011,East Hartford School District,Dr. Thomas S. O'Connell School,272,285,557,2014-15
0436211,0430011,East Hartford School District,East Hartford High School,851,823,1674,2014-15
0435111,0430011,East Hartford School District,East Hartford Middle School,541,617,1158,2014-15
0432011,0430011,East Hartford School District,Governor William Pitkin School,169,173,342,2014-15
0430511,0430011,East Hartford School District,Hockanum School,170,167,337,2014-15
0430411,0430011,East Hartford School District,Joseph O. Goodwin School,142,156,298,2014-15
0431811,0430011,East Hartford School District,Robert J. O'Brien School,239,255,494,2014-15
0431211,0430011,East Hartford School District,Silver Lane School,150,134,284,2014-15
0436411,0430011,East Hartford School District,Stevens Alternate High School,44,75,119,2014-15
0432411,0430011,East Hartford School District,Sunset Ridge Middle School,93,53,146,2014-15
0438011,0430011,East Hartford School District,Willowbrook Early Childhood,108,121,229,2014-15
0439011,0430011,East Hartford School District,Woodland School,26,144,170,2014-15
0441711,0440011,East Haven School District,Carbone School/East Haven Academy,135,130,265,2014-15
0441411,0440011,East Haven School District,D. C. Moore School,106,102,208,2014-15
0440111,0440011,East Haven School District,Deer Run School,154,158,312,2014-15
0441311,0440011,East Haven School District,Dominick H. Ferrara School,98,80,178,2014-15
0446111,0440011,East Haven School District,East Haven High School,435,445,880,2014-15
0441011,0440011,East Haven School District,Grove J. Tuttle School,105,73,178,2014-15
0445111,0440011,East Haven School District,Joseph Melillo Middle School,257,325,582,2014-15
0440711,0440011,East Haven School District,Momauguin School,74,73,147,2014-15
0441811,0440011,East Haven School District,Overbrook Elementary School,76,107,183,2014-15
0450511,0450011,East Lyme School District,Abilities in Motion (AIM) Program,*,*,16,2014-15
0450611,0450011,East Lyme School District,Coastal Connections,8,8,16,2014-15
0456111,0450011,East Lyme School District,East Lyme High School,523,530,1053,2014-15
0455111,0450011,East Lyme School District,East Lyme Middle School,414,447,861,2014-15
0450111,0450011,East Lyme School District,Flanders School,159,189,348,2014-15
0458011,0450011,East Lyme School District,Integrated Preschool,23,23,46,2014-15
0450411,0450011,East Lyme School District,Lillie B. Haynes School,161,153,314,2014-15
0450211,0450011,East Lyme School District,Niantic Center School,93,86,179,2014-15
0470111,0470011,East Windsor School District,Broad Brook Elementary School,236,244,480,2014-15
0476111,0470011,East Windsor School District,East Windsor High School,156,176,332,2014-15
0475411,0470011,East Windsor School District,East Windsor Middle School,143,170,313,2014-15
2536014,2530014,Eastern Connecticut Regional Educational Service Center (EASTCONN),Arts at the Capitol Theater Magnet School (ACT),108,33,141,2014-15
2539014,2530014,Eastern Connecticut Regional Educational Service Center (EASTCONN),EastConn Special Education,26,84,110,2014-15
2536114,2530014,Eastern Connecticut Regional Educational Service Center (EASTCONN),Quinebaug Middle College,94,66,160,2014-15
0390111,0390011,Eastford School District,Eastford Elementary School,66,73,139,2014-15
0465111,0460011,Easton School District,Helen Keller Middle School,135,188,323,2014-15
0460111,0460011,Easton School District,Samuel Staples Elementary School,305,307,612,2014-15
2428014,2420014,EdAdvance,EdAdvance Headstart,122,98,220,2014-15
2429014,2420014,EdAdvance,The ACCESS School at The Danuta M. Thibodeau Education Center,13,17,30,2014-15
0480111,0480011,Ellington School District,Center School,185,191,376,2014-15
0480211,0480011,Ellington School District,Crystal Lake School,90,108,198,2014-15
0486111,0480011,Ellington School District,Ellington High School,393,380,773,2014-15
0485111,0480011,Ellington School District,Ellington Middle School,212,222,434,2014-15
0480711,0480011,Ellington School District,Windermere Intermediate School,216,219,435,2014-15
0480611,0480011,Ellington School District,Windermere School,219,220,439,2014-15
2890113,2890013,Elm City College Preparatory School District,Elm City College Preparatory School,346,289,635,2014-15
2910113,2910013,Elm City Montessori School District,Elm City Montessori School,29,41,70,2014-15
0490511,0490011,Enfield School District,Edgar H. Parkman - Autism Spectrum Disorder (ASD),*,*,6,2014-15
0491311,0490011,Enfield School District,Edgar H. Parkman School,167,159,326,2014-15
0491611,0490011,Enfield School District,Eli Whitney School,188,189,377,2014-15
0496111,0490011,Enfield School District,Enfield High School,361,348,709,2014-15
0490311,0490011,Enfield School District,Enfield Street - Autism Spectrum Disorder (ASD),*,*,6,2014-15
0490211,0490011,Enfield School District,Enfield Street School,138,148,286,2014-15
0499011,0490011,Enfield School District,Enfield Transitional Learning Academy,*,*,10,2014-15
0496211,0490011,Enfield School District,Enrico Fermi High School,437,450,887,2014-15
0490411,0490011,Enfield School District,Hazardville Memorial School,168,192,360,2014-15
0498011,0490011,Enfield School District,Head Start Program,57,47,104,2014-15
0490611,0490011,Enfield School District,Henry Barnard - Educational Counseling Program (ECP),0,*,*,2014-15
0491811,0490011,Enfield School District,Henry Barnard School,160,196,356,2014-15
0495211,0490011,Enfield School District,John F. Kennedy Middle School,530,569,1099,2014-15
0490811,0490011,Enfield School District,Nathan Hale - Primary Adaptive Learning (PAL),6,0,6,2014-15
0491111,0490011,Enfield School District,Nathan Hale School,115,108,223,2014-15
0490711,0490011,Enfield School District,Prudence Crandall - Educational Counseling Program (ECP),*,*,6,2014-15
0491511,0490011,Enfield School District,Prudence Crandall School,196,193,389,2014-15
0500111,0500011,Essex School District,Essex Elementary School,213,238,451,2014-15
2726113,2720013,Explorations District,Explorations,52,36,88,2014-15
0510211,0510011,Fairfield School District,Burr Elementary School,202,226,428,2014-15
0510111,0510011,Fairfield School District,Dwight Elementary School,150,169,319,2014-15
0518011,0510011,Fairfield School District,Early Childhood Center,33,78,111,2014-15
0516011,0510011,Fairfield School District,Fairfield Ludlowe High School,824,717,1541,2014-15
0516211,0510011,Fairfield School District,Fairfield Warde High School,717,725,1442,2014-15
0515211,0510011,Fairfield School District,Fairfield Woods Middle School,437,478,915,2014-15
0510411,0510011,Fairfield School District,Holland Hill School,208,199,407,2014-15
0511711,0510011,Fairfield School District,Jennings School,126,198,324,2014-15
0510611,0510011,Fairfield School District,McKinley School,233,209,442,2014-15
0510711,0510011,Fairfield School District,Mill Hill School,204,209,413,2014-15
0511611,0510011,Fairfield School District,North Stratfield School,211,230,441,2014-15
0511811,0510011,Fairfield School District,Osborn Hill School,254,249,503,2014-15
0511211,0510011,Fairfield School District,Riverfield School,194,204,398,2014-15
0515311,0510011,Fairfield School District,Roger Ludlowe Middle School,397,408,805,2014-15
0511311,0510011,Fairfield School District,Sherman School,247,228,475,2014-15
0511411,0510011,Fairfield School District,Stratfield School,211,249,460,2014-15
0515111,0510011,Fairfield School District,Tomlinson Middle School,362,358,720,2014-15
0510311,0510011,Fairfield School District,Walter Fitzgerald Campus,14,19,33,2014-15
0520411,0520011,Farmington School District,East Farms School,218,227,445,2014-15
0520611,0520011,Farmington School District,Farmington Alternative High School,*,*,13,2014-15
0528011,0520011,Farmington School District,Farmington Collaborative PK,33,45,78,2014-15
0526111,0520011,Farmington School District,Farmington High School,587,677,1264,2014-15
0525111,0520011,Farmington School District,Irving A. Robbins Middle School,271,299,570,2014-15
0520211,0520011,Farmington School District,Noah Wallace School,168,166,334,2014-15
0520111,0520011,Farmington School District,Union School,149,156,305,2014-15
0520311,0520011,Farmington School District,West District School,149,166,315,2014-15
0520511,0520011,Farmington School District,West Woods Upper Elementary School,347,326,673,2014-15
0530111,0530011,Franklin School District,Franklin Elementary School,78,89,167,2014-15
0541311,0540011,Glastonbury School District,Alternate Program,*,*,*,2014-15
0540211,0540011,Glastonbury School District,Buttonball Lane School,229,221,450,2014-15
0540311,0540011,Glastonbury School District,Eastbury School,134,126,260,2014-15
0540811,0540011,Glastonbury School District,Gideon Welles School,276,243,519,2014-15
0546111,0540011,Glastonbury School District,Glastonbury High School,1070,968,2038,2014-15
0540411,0540011,Glastonbury School District,Hebron Avenue School,190,207,397,2014-15
0540611,0540011,Glastonbury School District,Hopewell School,193,218,411,2014-15
0540111,0540011,Glastonbury School District,Links Academy,6,10,16,2014-15
0541411,0540011,Glastonbury School District,Links Transition,11,6,17,2014-15
0540711,0540011,Glastonbury School District,Naubuc School,207,180,387,2014-15
0540911,0540011,Glastonbury School District,Nayaug Elementary School,278,272,550,2014-15
0540511,0540011,Glastonbury School District,PreK-Eastbury,9,9,18,2014-15
0541011,0540011,Glastonbury School District,PreK-Nayaug,9,11,20,2014-15
0541111,0540011,Glastonbury School District,Pride-Hebron Avenue,*,*,*,2014-15
0541211,0540011,Glastonbury School District,Pride-Nayaug,*,*,8,2014-15
0545211,0540011,Glastonbury School District,Smith Middle School,501,530,1031,2014-15
0560111,0560011,Granby School District,Frank M. Kearns Primary School,189,189,378,2014-15
0566111,0560011,Granby School District,Granby Memorial High School,322,361,683,2014-15
0565111,0560011,Granby School District,Granby Memorial Middle School,162,168,330,2014-15
0560411,0560011,Granby School District,Kelly Lane Primary School,140,140,280,2014-15
0560311,0560011,Granby School District,Wells Road Intermediate School,140,143,283,2014-15
2940113,2940013,Great Oaks Charter School District,Great Oaks Charter School,67,60,127,2014-15
0575111,0570011,Greenwich School District,Central Middle School,269,309,578,2014-15
0571211,0570011,Greenwich School District,Community Connections,*,*,10,2014-15
0570211,0570011,Greenwich School District,Cos Cob School,204,234,438,2014-15
0575211,0570011,Greenwich School District,Eastern Middle School,393,418,811,2014-15
0570411,0570011,Greenwich School District,Glenville School,219,205,424,2014-15
0571411,0570011,Greenwich School District,Greenwich Alternative High School,23,23,46,2014-15
0576111,0570011,Greenwich School District,Greenwich High School,1263,1238,2501,2014-15
0570511,0570011,Greenwich School District,Hamilton Avenue School,200,191,391,2014-15
0571311,0570011,Greenwich School District,International School At Dundee,191,179,370,2014-15
0570311,0570011,Greenwich School District,Julian Curtiss School,174,195,369,2014-15
0570611,0570011,Greenwich School District,New Lebanon School,122,142,264,2014-15
0570711,0570011,Greenwich School District,North Mianus School,239,248,487,2014-15
0570811,0570011,Greenwich School District,North Street School,176,208,384,2014-15
0570911,0570011,Greenwich School District,Old Greenwich School,214,218,432,2014-15
0571111,0570011,Greenwich School District,Parkway School,121,137,258,2014-15
0571011,0570011,Greenwich School District,Riverside School,228,269,497,2014-15
0575311,0570011,Greenwich School District,Western Middle School,259,273,532,2014-15
0580111,0580011,Griswold School District,Griswold Alternative School,*,*,15,2014-15
0580311,0580011,Griswold School District,Griswold Elementary School,352,404,756,2014-15
0586211,0580011,Griswold School District,Griswold High School,303,268,571,2014-15
0585111,0580011,Griswold School District,Griswold Middle School,272,275,547,2014-15
0595311,0590011,Groton School District,Carl C. Cutler Middle School,236,225,461,2014-15
0592011,0590011,Groton School District,Catherine Kolnaski Magnet School,175,225,400,2014-15
0591811,0590011,Groton School District,Charles Barnum School,172,186,358,2014-15
0590311,0590011,Groton School District,Claude Chester School,183,173,356,2014-15
0591711,0590011,Groton School District,Mary Morrisson School,195,201,396,2014-15
0591911,0590011,Groton School District,Northeast Academy Elementary School,191,208,399,2014-15
0591211,0590011,Groton School District,Pleasant Valley School,138,149,287,2014-15
0596111,0590011,Groton School District,Robert E. Fitch High School,526,563,1089,2014-15
0590111,0590011,Groton School District,S. B. Butler School,134,175,309,2014-15
0595211,0590011,Groton School District,West Side Middle School,243,230,473,2014-15
0600711,0600011,Guilford School District,A. Baldwin Middle School,258,276,534,2014-15
0600611,0600011,Guilford School District,A. W. Cox School,153,169,322,2014-15
0600411,0600011,Guilford School District,Calvin Leete School,103,159,262,2014-15
0605111,0600011,Guilford School District,E. C. Adams Middle School,287,272,559,2014-15
0606111,0600011,Guilford School District,Guilford High School,535,541,1076,2014-15
0600211,0600011,Guilford School District,Guilford Lakes School,153,176,329,2014-15
0600311,0600011,Guilford School District,Melissa Jones School,156,162,318,2014-15
0628011,0620011,Hamden School District,Alice Peck Learning Center,51,99,150,2014-15
0621211,0620011,Hamden School District,Bear Path School,230,218,448,2014-15
0620211,0620011,Hamden School District,Church Street School,158,169,327,2014-15
0620311,0620011,Hamden School District,Dunbar Hill School,143,153,296,2014-15
0620511,0620011,Hamden School District,Hamden Collaborative Learning Center,23,49,72,2014-15
0626111,0620011,Hamden School District,Hamden High School,807,889,1696,2014-15
0625211,0620011,Hamden School District,Hamden Middle School,399,404,803,2014-15
0620411,0620011,Hamden School District,Helen Street School,145,186,331,2014-15
0621111,0620011,Hamden School District,Ridge Hill School,153,169,322,2014-15
0620111,0620011,Hamden School District,Shepherd Glen School,143,177,320,2014-15
0621011,0620011,Hamden School District,Spring Glen School,218,216,434,2014-15
0621411,0620011,Hamden School District,West Woods School,214,216,430,2014-15
0630111,0630011,Hampton School District,Hampton Elementary School,40,65,105,2014-15
0640711,0640011,Hartford School District,Asian Studies Academy at Bellizzi School,320,342,662,2014-15
0644511,0640011,Hartford School District,Autism Program - Clark School,*,*,18,2014-15
0644211,0640011,Hartford School District,Autism Program - Fred D. Wish Museum School,*,*,24,2014-15
0644311,0640011,Hartford School District,Autism Program - Hooker School,*,*,7,2014-15
0645711,0640011,Hartford School District,Autism Program - Naylor School,8,15,23,2014-15
0644411,0640011,Hartford School District,Autism Program - Rawson School,*,*,12,2014-15
0640411,0640011,Hartford School District,Batchelder School,220,246,466,2014-15
0642811,0640011,Hartford School District,Betances Early Reading Lab Magnet School,145,143,288,2014-15
0643811,0640011,Hartford School District,Betances STEM Magnet School,98,155,253,2014-15
0643511,0640011,Hartford School District,Breakthrough II Magnet School,153,165,318,2014-15
0643311,0640011,Hartford School District,Breakthrough Magnet School,197,160,357,2014-15
0647111,0640011,Hartford School District,Bulkeley High School,177,196,373,2014-15
0646111,0640011,Hartford School District,Bulkeley High School Lower School,215,274,489,2014-15
0640611,0640011,Hartford School District,Burns Latino Studies Academy,264,317,581,2014-15
0642311,0640011,Hartford School District,Burr School,314,370,684,2014-15
0643911,0640011,Hartford School District,Capital Community College Magnet Academy,34,13,47,2014-15
0646911,0640011,Hartford School District,Capital Preparatory Magnet School,324,348,672,2014-15
0642411,0640011,Hartford School District,Clark School,178,157,335,2014-15
0646411,0640011,Hartford School District,Classical Magnet School,387,315,702,2014-15
0646011,0640011,Hartford School District,Culinary Arts Academy at Weaver High School,125,150,275,2014-15
0645811,0640011,Hartford School District,EDP - Betances School,0,8,8,2014-15
0648311,0640011,Hartford School District,EDP - Bulkeley High School,0,*,*,2014-15
0648211,0640011,Hartford School District,EDP - HPHS Engineering and Green Technology Academy,*,*,19,2014-15
0645911,0640011,Hartford School District,EDP - M.D. Fox School,*,*,28,2014-15
0648111,0640011,Hartford School District,EDP - McDonough Middle School,*,*,*,2014-15
0644111,0640011,Hartford School District,Early Childhood Development Center (ECDC),0,*,*,2014-15
0640911,0640011,Hartford School District,Environmental Sciences Magnet at Hooker School,270,337,607,2014-15
0643211,0640011,Hartford School District,Expeditionary Learning Academy at Moylan School,285,292,577,2014-15
0643611,0640011,Hartford School District,Global Communications Academy,322,299,621,2014-15
0647911,0640011,Hartford School District,Great Path Academy at MCC,156,100,256,2014-15
0647211,0640011,Hartford School District,HPHS Engineering and Green Technology Academy,79,293,372,2014-15
0647411,0640011,Hartford School District,HPHS Law and Government Academy,178,211,389,2014-15
0647511,0640011,Hartford School District,HPHS Nursing and Health Sciences Academy,268,125,393,2014-15
0645411,0640011,Hartford School District,Hartford Magnet Trinity College Academy,551,450,1001,2014-15
0641311,0640011,Hartford School District,Hartford PreKindergarten Magnet School,74,70,144,2014-15
0647611,0640011,Hartford School District,"High School, Inc.",121,135,256,2014-15
0648411,0640011,Hartford School District,High Step Transition,*,*,10,2014-15
0647711,0640011,Hartford School District,Journalism and Media Academy Magnet School,104,86,190,2014-15
0641011,0640011,Hartford School District,Kennelly School,297,324,621,2014-15
0641111,0640011,Hartford School District,Kinsella Magnet School of Performing Arts,558,326,884,2014-15
0640811,0640011,Hartford School District,M. D. Fox School,310,292,602,2014-15
0641611,0640011,Hartford School District,"M. L. King, Jr. School",140,189,329,2014-15
0644811,0640011,Hartford School District,MDP - Batchelder School,*,*,12,2014-15
0645011,0640011,Hartford School District,MDP - Bulkeley High School,8,13,21,2014-15
0644911,0640011,Hartford School District,MDP - HPHS Law and Government Academy,10,13,23,2014-15
0648511,0640011,Hartford School District,MDP - Moylan School,0,*,*,2014-15
0641211,0640011,Hartford School District,McDonough Middle School,119,133,252,2014-15
0641911,0640011,Hartford School District,Milner School,182,148,330,2014-15
0643711,0640011,Hartford School District,Montessori Magnet at Fisher School,166,157,323,2014-15
0640511,0640011,Hartford School District,Montessori Magnet at Moylan School,119,93,212,2014-15
0641411,0640011,Hartford School District,Naylor/CCSU Leadership Academy,334,348,682,2014-15
0642711,0640011,Hartford School District,New Visions Program,13,38,51,2014-15
0647811,0640011,Hartford School District,OPPortunity High School,72,55,127,2014-15
0641511,0640011,Hartford School District,Parkville Community School,257,275,532,2014-15
0646611,0640011,Hartford School District,Pathways Academy of Technology and Design,114,261,375,2014-15
0641711,0640011,Hartford School District,Rawson School,215,269,484,2014-15
0644011,0640011,Hartford School District,Renzulli Gifted and Talented Academy,47,36,83,2014-15
0640111,0640011,Hartford School District,SAND School,193,209,402,2014-15
0642511,0640011,Hartford School District,STEM Magnet at Fisher School,144,216,360,2014-15
0643011,0640011,Hartford School District,Sanchez School,256,229,485,2014-15
0642611,0640011,Hartford School District,Simpson-Waverly School,156,139,295,2014-15
0646511,0640011,Hartford School District,Sports and Medical Sciences Academy,312,390,702,2014-15
0646711,0640011,Hartford School District,University High School of Science and Engineering,137,286,423,2014-15
0642011,0640011,Hartford School District,Webster Micro Society Magnet School,339,339,678,2014-15
0642111,0640011,Hartford School District,West Middle School,172,208,380,2014-15
0642211,0640011,Hartford School District,Wish Museum School,152,151,303,2014-15
0650111,0650011,Hartland School District,Hartland School,95,106,201,2014-15
0670211,0670011,Hebron School District,Gilead Hill School,134,160,294,2014-15
0670111,0670011,Hebron School District,Hebron Elementary School,239,252,491,2014-15
2860113,2860013,Highville Charter School District,Highville Charter School,208,195,403,2014-15
2640113,2640013,Integrated Day Charter School District,Integrated Day Charter School,163,168,331,2014-15
2655113,2650013,Interdistrict School for Arts and Comm District,Interdistrict School For Arts And Communication,129,133,262,2014-15
2610113,2610013,Jumoke Academy District,Jumoke Academy,388,328,716,2014-15
0680111,0680011,Kent School District,Kent Center School,114,140,254,2014-15
0680211,0680011,Kent School District,LEAPSS,*,*,*,2014-15
0698011,0690011,Killingly School District,Goodyear Early Childhood Center,47,64,111,2014-15
0690611,0690011,Killingly School District,Killingly Alternative Learning Program,10,11,21,2014-15
0690111,0690011,Killingly School District,Killingly Central School,183,199,382,2014-15
0696111,0690011,Killingly School District,Killingly High School,405,387,792,2014-15
0695211,0690011,Killingly School District,Killingly Intermediate School,354,361,715,2014-15
0690311,0690011,Killingly School District,Killingly Memorial School,241,242,483,2014-15
2456014,2450014,Learn,Connecticut River Academy,231,176,407,2014-15
2455014,2450014,Learn,Dual Language & Arts Magnet Middle School,77,61,138,2014-15
2451214,2450014,Learn,Learn ABA Program at Center School,*,*,*,2014-15
2451114,2450014,Learn,Learn Haynes Elementary Intensive Program,*,*,10,2014-15
2450614,2450014,Learn,Learn High School ABA,0,*,*,2014-15
2450914,2450014,Learn,Learn Kelly Middle School Intensive Program,*,*,*,2014-15
2450714,2450014,Learn,Learn Ledyard RICHES Program,*,*,*,2014-15
2450514,2450014,Learn,Learn Pathways Program,*,*,*,2014-15
2450814,2450014,Learn,Learn SAILS Middle School Program,0,6,6,2014-15
2451014,2450014,Learn,Learn SAILS Program at Salem,0,6,6,2014-15
2450414,2450014,Learn,Learn STS 18-21 Year Old Program,0,*,*,2014-15
2456114,2450014,Learn,Marine Science Magnet High School of Southeastern Connecticut,139,133,272,2014-15
2450114,2450014,Learn,Regional Multicultural Magnet School,273,260,533,2014-15
2450314,2450014,Learn,Riverside Magnet School at Goodwin College,155,152,307,2014-15
2450214,2450014,Learn,The Friendship School,239,273,512,2014-15
2456214,2450014,Learn,Three Rivers Middle College Magnet School,34,27,61,2014-15
0710111,0710011,Lebanon School District,Lebanon Elementary School,173,205,378,2014-15
0715111,0710011,Lebanon School District,Lebanon Middle School,160,176,336,2014-15
0716211,0710011,Lebanon School District,Lyman Memorial High School,214,167,381,2014-15
0720211,0720011,Ledyard School District,Gales Ferry School,95,98,193,2014-15
0720411,0720011,Ledyard School District,Gallup Hill School,183,179,362,2014-15
0720311,0720011,Ledyard School District,Juliet W. Long School,143,151,294,2014-15
0720111,0720011,Ledyard School District,Ledyard Center School,193,222,415,2014-15
0726111,0720011,Ledyard School District,Ledyard High School,471,425,896,2014-15
0725111,0720011,Ledyard School District,Ledyard Middle School,163,187,350,2014-15
0730111,0730011,Lisbon School District,Lisbon Central School,190,208,398,2014-15
0740211,0740011,Litchfield School District,Center School,130,142,272,2014-15
0746111,0740011,Litchfield School District,Litchfield High School,225,252,477,2014-15
0740311,0740011,Litchfield School District,Litchfield Intermediate School,111,118,229,2014-15
0766111,0760011,Madison School District,Daniel Hand High School,596,633,1229,2014-15
0760611,0760011,Madison School District,Dr. Robert H. Brown Middle School,201,287,488,2014-15
0760211,0760011,Madison School District,Island Avenue Elementary School,134,139,273,2014-15
0760111,0760011,Madison School District,J. Milton Jeffrey Elementary School,150,189,339,2014-15
0760311,0760011,Madison School District,Kathleen H. Ryerson Elementary School,118,119,237,2014-15
0769011,0760011,Madison School District,Town Campus Learning Center,16,27,43,2014-15
0765211,0760011,Madison School District,Walter C. Polson Upper Middle School,298,254,552,2014-15
0770211,0770011,Manchester School District,Bentley Alternative Education Program,21,30,51,2014-15
0770111,0770011,Manchester School District,Bowers School,199,218,417,2014-15
0770311,0770011,Manchester School District,Buckley School,152,197,349,2014-15
0771711,0770011,Manchester School District,Elisabeth M. Bennet Academy,202,202,404,2014-15
0770411,0770011,Manchester School District,Highland Park School,127,147,274,2014-15
0775311,0770011,Manchester School District,Illing Middle School,389,418,807,2014-15
0770611,0770011,Manchester School District,Keeney School,172,164,336,2014-15
0776111,0770011,Manchester School District,Manchester High School,786,740,1526,2014-15
0778011,0770011,Manchester School District,Manchester Preschool Center,79,86,165,2014-15
0779011,0770011,Manchester School District,Manchester Regional Academy,16,43,59,2014-15
0779111,0770011,Manchester School District,Manchester Transition Center,*,*,12,2014-15
0771611,0770011,Manchester School District,Martin School,144,121,265,2014-15
0770711,0770011,Manchester School District,New Horizons,8,21,29,2014-15
0771011,0770011,Manchester School District,Robertson School,213,194,407,2014-15
0771211,0770011,Manchester School District,Verplanck School,189,223,412,2014-15
0771311,0770011,Manchester School District,Waddell School,154,188,342,2014-15
0771411,0770011,Manchester School District,Washington School,182,191,373,2014-15
0780411,0780011,Mansfield School District,Annie E. Vinton School,126,134,260,2014-15
0780211,0780011,Mansfield School District,Dorothy C. Goodwin School,112,107,219,2014-15
0785111,0780011,Mansfield School District,Mansfield Middle School,236,283,519,2014-15
0780511,0780011,Mansfield School District,Southeast Elementary School,133,108,241,2014-15
0790111,0790011,Marlborough School District,Elmer Thienes-Mary Hall Elementary School,277,322,599,2014-15
0800711,0800011,Meriden School District,Nathan Hale School,309,337,646,2014-15
0800111,0800011,Meriden School District,Benjamin Franklin School,184,203,387,2014-15
0801111,0800011,Meriden School District,Casimir Pulaski School,270,287,557,2014-15
0800211,0800011,Meriden School District,Community Classroom Collaborative-Meriden School District,*,*,8,2014-15
0806111,0800011,Meriden School District,Francis T. Maloney High School,589,621,1210,2014-15
0800311,0800011,Meriden School District,Hanover School,292,336,628,2014-15
0800411,0800011,Meriden School District,Israel Putnam School,290,290,580,2014-15
0800511,0800011,Meriden School District,John Barry School,241,268,509,2014-15
0805211,0800011,Meriden School District,Lincoln Middle School,372,384,756,2014-15
0806211,0800011,Meriden School District,Orville H. Platt High School,512,585,1097,2014-15
0800811,0800011,Meriden School District,Roger Sherman School,238,260,498,2014-15
0801011,0800011,Meriden School District,Thomas Hooker School,233,233,466,2014-15
0805411,0800011,Meriden School District,Washington Middle School,329,367,696,2014-15
0830211,0830011,Middletown School District,Bielefield School,158,151,309,2014-15
0831611,0830011,Middletown School District,Evening Program - MHS,10,14,24,2014-15
0830511,0830011,Middletown School District,Farm Hill School,189,183,372,2014-15
0830611,0830011,Middletown School District,ICM - Farm Hill,0,*,*,2014-15
0830711,0830011,Middletown School District,ICM - Lawrence,0,*,*,2014-15
0831011,0830011,Middletown School District,ICM - Macdonough,0,10,10,2014-15
0830811,0830011,Middletown School District,ICM - Wesley,*,*,*,2014-15
0830411,0830011,Middletown School District,ICM- Woodrow Wilson Middle School,*,*,*,2014-15
0831511,0830011,Middletown School District,Keigwin Middle School,180,180,360,2014-15
0831311,0830011,Middletown School District,Lawrence School,135,146,281,2014-15
0831811,0830011,Middletown School District,MHS - Alternative Education Program 1,*,*,8,2014-15
0831911,0830011,Middletown School District,MHS - Alternative Education Program 2,*,*,11,2014-15
0830911,0830011,Middletown School District,MacDonough School,103,110,213,2014-15
0836211,0830011,Middletown School District,Middletown High School,608,589,1197,2014-15
0831211,0830011,Middletown School District,Moody School,119,142,261,2014-15
0830311,0830011,Middletown School District,OASIS,*,*,*,2014-15
0831111,0830011,Middletown School District,Snow School,178,227,405,2014-15
0830111,0830011,Middletown School District,Spencer School,140,159,299,2014-15
0839111,0830011,Middletown School District,Transition to Life Center,6,20,26,2014-15
0831711,0830011,Middletown School District,Virtual Learning Academy - MHS,*,*,9,2014-15
0831411,0830011,Middletown School District,Wesley School,134,143,277,2014-15
0835411,0830011,Middletown School District,Woodrow Wilson Middle School,333,312,645,2014-15
0840111,0840011,Milford School District,Calf Pen Meadow School,127,132,259,2014-15
0845111,0840011,Milford School District,East Shore Middle School,253,234,487,2014-15
0845211,0840011,Milford School District,Harborside Middle School,251,310,561,2014-15
0841911,0840011,Milford School District,J. F. Kennedy School,192,188,380,2014-15
0846211,0840011,Milford School District,Jonathan Law High School,469,456,925,2014-15
0846311,0840011,Milford School District,Joseph A. Foran High School,441,478,919,2014-15
0841611,0840011,Milford School District,Live Oaks School,147,152,299,2014-15
0841711,0840011,Milford School District,Mathewson School,179,190,369,2014-15
0840711,0840011,Milford School District,Meadowside School,175,218,393,2014-15
0840811,0840011,Milford School District,Orange Avenue School,185,255,440,2014-15
0841811,0840011,Milford School District,Orchard Hills School,163,162,325,2014-15
0841011,0840011,Milford School District,Pumpkin Delight School,178,196,374,2014-15
0840311,0840011,Milford School District,The Academy,21,32,53,2014-15
0845311,0840011,Milford School District,West Shore Middle School,221,245,466,2014-15
0850511,0850011,Monroe School District,Fawn Hollow Elementary School,239,273,512,2014-15
0855211,0850011,Monroe School District,Jockey Hollow School,372,386,758,2014-15
0850211,0850011,Monroe School District,Masuk Alternative Program,*,*,16,2014-15
0856111,0850011,Monroe School District,Masuk High School,560,603,1163,2014-15
0850111,0850011,Monroe School District,Monroe Elementary School,180,183,363,2014-15
0850411,0850011,Monroe School District,REAL,*,*,6,2014-15
0850311,0850011,Monroe School District,Stepney Elementary School,242,225,467,2014-15
0860711,0860011,Montville School District,Dr. Charles E. Murphy School,163,181,344,2014-15
0865111,0860011,Montville School District,Leonard J. Tyl Middle School,270,282,552,2014-15
0860111,0860011,Montville School District,Mohegan School,187,166,353,2014-15
0866111,0860011,Montville School District,Montville High School,352,348,700,2014-15
0860511,0860011,Montville School District,Oakdale School,143,166,309,2014-15
0869011,0860011,Montville School District,Palmer Academy,7,20,27,2014-15
0860311,0860011,Montville School District,Pre School Program,19,43,62,2014-15
0880811,0880011,Naugatuck School District,Andrew Avenue School,114,132,246,2014-15
0888211,0880011,Naugatuck School District,Central Avenue Preschool,*,*,24,2014-15
0885111,0880011,Naugatuck School District,City Hill Middle School,302,378,680,2014-15
0880211,0880011,Naugatuck School District,Cross Street Intermediate School,166,180,346,2014-15
0888111,0880011,Naugatuck School District,Head Start,64,57,121,2014-15
0880411,0880011,Naugatuck School District,Hillside Intermediate School,138,166,304,2014-15
0880511,0880011,Naugatuck School District,Hop Brook Elementary School,148,189,337,2014-15
0880311,0880011,Naugatuck School District,Maple Hill School,225,250,475,2014-15
0886111,0880011,Naugatuck School District,Naugatuck High School,605,654,1259,2014-15
0880611,0880011,Naugatuck School District,Salem School,114,135,249,2014-15
0880711,0880011,Naugatuck School District,Western School,128,137,265,2014-15
2800113,2800013,New Beginnings Inc Family Academy District,New Beginnings Inc Family Academy,234,239,473,2014-15
0899111,0890011,New Britain School District,Brook Side School,15,35,50,2014-15
0899411,0890011,New Britain School District,CLIMB,7,22,29,2014-15
0890311,0890011,New Britain School District,Chamberlain  Elementary School,252,276,528,2014-15
0891111,0890011,New Britain School District,Frank J. DiLoreto School,416,355,771,2014-15
0890511,0890011,New Britain School District,Gaffney School,235,334,569,2014-15
0890611,0890011,New Britain School District,Holmes School,253,253,506,2014-15
0895411,0890011,New Britain School District,House of Arts Letters and Science (HALS)  Academy,81,78,159,2014-15
0890711,0890011,New Britain School District,Jefferson School,221,221,442,2014-15
0890811,0890011,New Britain School District,Lincoln School,340,385,725,2014-15
0896111,0890011,New Britain School District,New Britain High School,1156,1301,2457,2014-15
0899011,0890011,New Britain School District,New Britain Transition Center,20,30,50,2014-15
0890911,0890011,New Britain School District,Northend School,129,145,274,2014-15
0895311,0890011,New Britain School District,Pulaski Middle School,342,427,769,2014-15
0895211,0890011,New Britain School District,Slade Middle School,349,427,776,2014-15
0891211,0890011,New Britain School District,Smalley Academy,315,387,702,2014-15
0891311,0890011,New Britain School District,Smith School,320,376,696,2014-15
0891511,0890011,New Britain School District,Vance School,265,248,513,2014-15
0900411,0900011,New Canaan School District,East School,257,309,566,2014-15
0906111,0900011,New Canaan School District,New Canaan High School,617,633,1250,2014-15
0905111,0900011,New Canaan School District,Saxe Middle School,638,653,1291,2014-15
0900211,0900011,New Canaan School District,South School,261,286,547,2014-15
0900311,0900011,New Canaan School District,West School,271,276,547,2014-15
0910311,0910011,New Fairfield School District,Alternative Learning Center,*,*,9,2014-15
0910111,0910011,New Fairfield School District,Consolidated School,252,292,544,2014-15
0910411,0910011,New Fairfield School District,Day Alternative Learning Program,7,7,14,2014-15
0910211,0910011,New Fairfield School District,Meeting House Hill School,257,269,526,2014-15
0916111,0910011,New Fairfield School District,New Fairfield High School,438,495,933,2014-15
0915211,0910011,New Fairfield School District,New Fairfield Middle School,298,331,629,2014-15
0920311,0920011,New Hartford School District,Ann Antolini School,161,149,310,2014-15
0920111,0920011,New Hartford School District,Bakerville Consolidated School,65,50,115,2014-15
0920411,0920011,New Hartford School District,Bridges II at Ann Antolini School,*,*,*,2014-15
0920211,0920011,New Hartford School District,New Hartford Elementary School,39,36,75,2014-15
0931211,0930011,New Haven School District,Edgewood School,212,227,439,2014-15
0931411,0930011,New Haven School District,Nathan Hale School,261,291,552,2014-15
0931511,0930011,New Haven School District,Augusta Lewis Troup School,251,239,490,2014-15
0930211,0930011,New Haven School District,Barnard Environmental Magnet School,273,287,560,2014-15
0930311,0930011,New Haven School District,Beecher School,237,265,502,2014-15
0931811,0930011,New Haven School District,Benjamin Jepson Magnet School,246,271,517,2014-15
0935511,0930011,New Haven School District,Betsy Ross Arts Magnet School,310,149,459,2014-15
0934311,0930011,New Haven School District,Bishop Woods Architecture and Design Magnet School,262,235,497,2014-15
0932411,0930011,New Haven School District,Blake Street Leadership Academy (STEP),*,*,20,2014-15
0932111,0930011,New Haven School District,Brennan Rogers School,236,272,508,2014-15
0934811,0930011,New Haven School District,"Celentano BioTech, Health and Medical Magnet School",181,181,362,2014-15
0930611,0930011,New Haven School District,Clinton Avenue School,284,315,599,2014-15
0934111,0930011,New Haven School District,Columbus Family Academy,223,228,451,2014-15
0933111,0930011,New Haven School District,Conte/West Hills Magnet School,321,319,640,2014-15
0936411,0930011,New Haven School District,Cooperative High School,421,193,614,2014-15
0936811,0930011,New Haven School District,Cortlandt V.R. Creed Health and Sport Sciences High School,43,140,183,2014-15
0930911,0930011,New Haven School District,Davis 21st Century Magnet Elementary School,242,219,461,2014-15
0935611,0930011,New Haven School District,Domus Academy,*,*,36,2014-15
0938111,0930011,New Haven School District,Early Learning Center,78,64,142,2014-15
0934611,0930011,New Haven School District,East Rock Community Magnet School,256,252,508,2014-15
0931711,0930011,New Haven School District,Engineering - Science University Magnet School,172,399,571,2014-15
0931611,0930011,New Haven School District,Fair Haven School,393,393,786,2014-15
0938011,0930011,New Haven School District,Headstart,171,200,371,2014-15
0938311,0930011,New Haven School District,Helene Grant HeadStart,144,133,277,2014-15
0936611,0930011,New Haven School District,High School In The Community,177,105,282,2014-15
0930711,0930011,New Haven School District,Hill Central Music Academy,221,255,476,2014-15
0936311,0930011,New Haven School District,Hill Regional Career High School,384,291,675,2014-15
0936211,0930011,New Haven School District,James Hillhouse High School,487,552,1039,2014-15
0931311,0930011,New Haven School District,John C. Daniels,253,269,522,2014-15
0930811,0930011,New Haven School District,John S. Martinez Sea and Sky STEM School,239,269,508,2014-15
0933011,0930011,New Haven School District,King/Robinson Magnet School,277,287,564,2014-15
0932011,0930011,New Haven School District,Lincoln-Bassett School,181,191,372,2014-15
0931911,0930011,New Haven School District,Mauro-Sheridan Magnet School,244,299,543,2014-15
0936011,0930011,New Haven School District,Metropolitan Business Academy,187,204,391,2014-15
0937011,0930011,New Haven School District,New Haven Academy,147,117,264,2014-15
0932211,0930011,New Haven School District,New Horizons High School,23,41,64,2014-15
0939211,0930011,New Haven School District,Polly T. McCabe Center,15,0,15,2014-15
0933511,0930011,New Haven School District,Quinnipiac Real World Math STEM School,183,147,330,2014-15
0939111,0930011,New Haven School District,Riverside Education Academy,52,65,117,2014-15
0934211,0930011,New Haven School District,Roberto Clemente Leadership Academy for Global Awareness,261,274,535,2014-15
0931011,0930011,New Haven School District,Ross/Woodward School,366,309,675,2014-15
0936711,0930011,New Haven School District,Sound School,150,180,330,2014-15
0932811,0930011,New Haven School District,Strong 21st Century Communications Magnet and SCSU Lab School,201,228,429,2014-15
0932911,0930011,New Haven School District,Truman School,233,250,483,2014-15
0934911,0930011,New Haven School District,West Rock Authors Academy,128,144,272,2014-15
0933211,0930011,New Haven School District,Wexler/Grant Community School,185,217,402,2014-15
0936111,0930011,New Haven School District,Wilbur Cross High School,665,697,1362,2014-15
0933811,0930011,New Haven School District,Worthington Hooker School,225,216,441,2014-15
0950311,0950011,New London School District,Jennings School,291,246,537,2014-15
0955111,0950011,New London School District,Bennie Dover Jackson Middle School,308,316,624,2014-15
0950611,0950011,New London School District,Harbor,59,65,124,2014-15
0950911,0950011,New London School District,Nathan Hale Arts Magnet School,243,228,471,2014-15
0956111,0950011,New London School District,New London High School,382,504,886,2014-15
0950811,0950011,New London School District,Winthrop STEM Elementary Magnet School,245,311,556,2014-15
0960511,0960011,New Milford School District,Hill And Plain School,204,250,454,2014-15
0960711,0960011,New Milford School District,John Pettibone School,182,182,364,2014-15
0969011,0960011,New Milford School District,Litchfield Hills Transition Center,*,*,11,2014-15
0966111,0960011,New Milford School District,New Milford High School,688,710,1398,2014-15
0960811,0960011,New Milford School District,Northville Elementary School,194,220,414,2014-15
0960911,0960011,New Milford School District,Sarah Noble Intermediate School,487,537,1024,2014-15
0965211,0960011,New Milford School District,Schaghticoke Middle School,311,370,681,2014-15
0940611,0940011,Newington School District,Anna Reynolds School,221,238,459,2014-15
0940211,0940011,Newington School District,Elizabeth Green School,138,136,274,2014-15
0940811,0940011,Newington School District,John Paterson School,202,216,418,2014-15
0945311,0940011,Newington School District,John Wallace Middle School,323,364,687,2014-15
0945111,0940011,Newington School District,Martin Kellogg Middle School,300,315,615,2014-15
0946111,0940011,Newington School District,Newington High School,656,652,1308,2014-15
0940711,0940011,Newington School District,Ruth Chaffee School,178,166,344,2014-15
0970111,0970011,Newtown School District,Hawley Elementary School,164,157,321,2014-15
0970411,0970011,Newtown School District,Head O'Meadow Elementary School,154,160,314,2014-15
0970311,0970011,Newtown School District,Middle Gate Elementary School,197,194,391,2014-15
0976111,0970011,Newtown School District,Newtown High School,835,903,1738,2014-15
0975111,0970011,Newtown School District,Newtown Middle School,411,422,833,2014-15
0978011,0970011,Newtown School District,Newtown Preschool,21,37,58,2014-15
0970511,0970011,Newtown School District,Reed Intermediate School,338,393,731,2014-15
0979011,0970011,Newtown School District,STARR,*,*,*,2014-15
0970211,0970011,Newtown School District,Sandy Hook Elementary School,188,171,359,2014-15
0980111,0980011,Norfolk School District,Botelle Elementary School,57,58,115,2014-15
0990411,0990011,North Branford School District,Jerome Harrison School,172,234,406,2014-15
0996111,0990011,North Branford School District,North Branford High School,326,293,619,2014-15
0995111,0990011,North Branford School District,North Branford Intermediate School,255,252,507,2014-15
0999011,0990011,North Branford School District,School to Work Program,0,*,*,2014-15
0990611,0990011,North Branford School District,Totoket Valley Elementary School,209,221,430,2014-15
1000111,1000011,North Canaan School District,North Canaan Elementary School,138,142,280,2014-15
1010811,1010011,North Haven School District,Clintonville Elementary School,147,185,332,2014-15
1010711,1010011,North Haven School District,Green Acres Elementary School,198,186,384,2014-15
1010211,1010011,North Haven School District,Montowese Elementary School,159,155,314,2014-15
1016111,1010011,North Haven School District,North Haven High School,530,509,1039,2014-15
1015211,1010011,North Haven School District,North Haven Middle School,372,410,782,2014-15
1010111,1010011,North Haven School District,North Haven Transition Partnership,*,*,*,2014-15
1010311,1010011,North Haven School District,Ridge Road Elementary School,207,216,423,2014-15
1020111,1020011,North Stonington School District,North Stonington Elementary School,190,191,381,2014-15
1026111,1020011,North Stonington School District,Wheeler High School,96,100,196,2014-15
1025111,1020011,North Stonington School District,Wheeler Middle School,66,98,164,2014-15
1036211,1030011,Norwalk School District,Brien McMahon High School,873,802,1675,2014-15
1030211,1030011,Norwalk School District,Brookside Elementary School,248,274,522,2014-15
1030311,1030011,Norwalk School District,Columbus Magnet School,176,157,333,2014-15
1030411,1030011,Norwalk School District,Cranbury Elementary School,225,277,502,2014-15
1032011,1030011,Norwalk School District,Fox Run Elementary School,208,244,452,2014-15
1030711,1030011,Norwalk School District,Jefferson Magnet School,275,313,588,2014-15
1030811,1030011,Norwalk School District,Kendall Elementary School,283,283,566,2014-15
1032211,1030011,Norwalk School District,Marvin Elementary School,227,270,497,2014-15
1032111,1030011,Norwalk School District,Naramake Elementary School,229,231,460,2014-15
1035211,1030011,Norwalk School District,Nathan Hale Middle School,298,322,620,2014-15
1036111,1030011,Norwalk School District,Norwalk High School,760,815,1575,2014-15
1036311,1030011,Norwalk School District,Norwalk Pathways Academy at Briggs,26,30,56,2014-15
1035311,1030011,Norwalk School District,Ponus Ridge Middle School,312,333,645,2014-15
1035511,1030011,Norwalk School District,Roton Middle School,213,246,459,2014-15
1031311,1030011,Norwalk School District,Rowayton School,221,223,444,2014-15
1032311,1030011,Norwalk School District,Silvermine Elementary School,229,257,486,2014-15
1031411,1030011,Norwalk School District,Tracey School,184,205,389,2014-15
1035411,1030011,Norwalk School District,West Rocks Middle School,306,329,635,2014-15
1032411,1030011,Norwalk School District,Wolfpit School,144,181,325,2014-15
9016122,9010022,Norwich Free Academy District,Norwich Free Academy,1181,1136,2317,2014-15
1040111,1040011,Norwich School District,Bishop School Early Learning Center,101,122,223,2014-15
1040211,1040011,Norwich School District,Case Street Early Learning Center at DTZ,33,24,57,2014-15
1049011,1040011,Norwich School District,Hickory Street School,0,20,20,2014-15
1041411,1040011,Norwich School District,John B. Stanton Network School,189,179,368,2014-15
1045111,1040011,Norwich School District,Kelly Middle School,329,342,671,2014-15
1042011,1040011,Norwich School District,Moriarty Magnet School,203,187,390,2014-15
1040811,1040011,Norwich School District,Samuel Huntington School,171,202,373,2014-15
1045211,1040011,Norwich School District,Teachers' Memorial Middle School,240,251,491,2014-15
1041711,1040011,Norwich School District,Thomas W. Mahan School,145,138,283,2014-15
1041911,1040011,Norwich School District,Uncas Network School,119,131,250,2014-15
1041811,1040011,Norwich School District,Veterans' Memorial School,146,165,311,2014-15
1049211,1040011,Norwich School District,Virtual Learning Academy,*,*,12,2014-15
1041511,1040011,Norwich School District,Wequonnoc Magnet School,117,119,236,2014-15
2635113,2630013,Odyssey Community School District,Odyssey Community School,153,175,328,2014-15
1060211,1060011,Old Saybrook School District,Kathleen E. Goodwin School,211,206,417,2014-15
1065211,1060011,Old Saybrook School District,Old Saybrook Middle School,270,261,531,2014-15
1066111,1060011,Old Saybrook School District,Old Saybrook Senior High School,241,225,466,2014-15
1070211,1070011,Orange School District,Mary L. Tracy School,76,92,168,2014-15
1070511,1070011,Orange School District,Peck Place School,186,163,349,2014-15
1070311,1070011,Orange School District,Race Brook School,177,192,369,2014-15
1070411,1070011,Orange School District,Turkey Hill School,140,153,293,2014-15
1085111,1080011,Oxford School District,Great Oak School,257,260,517,2014-15
1080111,1080011,Oxford School District,Oxford Center School,252,228,480,2014-15
1086011,1080011,Oxford School District,Oxford High School,287,288,575,2014-15
1080311,1080011,Oxford School District,Quaker Farms School,191,205,396,2014-15
2835113,2830013,Park City Prep Charter School District,Park City Prep Charter School,179,181,360,2014-15
2930113,2930013,Path Academy District,Path Academy,60,72,132,2014-15
1098011,1090011,Plainfield School District,Early Childhood Center,11,8,19,2014-15
1090111,1090011,Plainfield School District,Moosup Elementary School,164,158,322,2014-15
1095111,1090011,Plainfield School District,Plainfield Central School,277,290,567,2014-15
1096111,1090011,Plainfield School District,Plainfield High School,336,347,683,2014-15
1090311,1090011,Plainfield School District,Plainfield Memorial School,167,169,336,2014-15
1090411,1090011,Plainfield School District,Shepard Hill Elementary School,200,210,410,2014-15
1100411,1100011,Plainville School District,Frank T. Wheeler School,150,158,308,2014-15
1100211,1100011,Plainville School District,Linden Street School,216,229,445,2014-15
1100511,1100011,Plainville School District,Louis Toffolon School,190,194,384,2014-15
1105211,1100011,Plainville School District,Middle School of Plainville,256,282,538,2014-15
1106111,1100011,Plainville School District,Plainville High School,337,378,715,2014-15
1115111,1110011,Plymouth School District,Eli Terry Jr. Middle School,172,184,356,2014-15
1110411,1110011,Plymouth School District,Harry S. Fisher Elementary School,180,187,367,2014-15
1117111,1110011,Plymouth School District,Plymouth Alternative High School,7,6,13,2014-15
1110211,1110011,Plymouth School District,Plymouth Center School,162,180,342,2014-15
1116111,1110011,Plymouth School District,Terryville High School,214,249,463,2014-15
1120111,1120011,Pomfret School District,Pomfret Community School,195,213,408,2014-15
1130511,1130011,Portland School District,Brownstone Intermediate School,103,111,214,2014-15
1130411,1130011,Portland School District,Gildersleeve School,93,100,193,2014-15
1136111,1130011,Portland School District,Portland High School,195,174,369,2014-15
1135111,1130011,Portland School District,Portland Middle School,121,118,239,2014-15
1130211,1130011,Portland School District,Valley View School,150,163,313,2014-15
1145111,1140011,Preston School District,Preston Plains School,88,69,157,2014-15
1140411,1140011,Preston School District,Preston Veterans' Memorial School,126,135,261,2014-15
1169011,1160011,Putnam School District,Helping Hands,0,*,*,2014-15
1160311,1160011,Putnam School District,Putnam Elementary School,321,347,668,2014-15
1166111,1160011,Putnam School District,Putnam High School,133,140,273,2014-15
1165111,1160011,Putnam School District,Putnam Middle School,157,138,295,2014-15
1175111,1170011,Redding School District,John Read Middle School,241,272,513,2014-15
1170111,1170011,Redding School District,Redding Elementary School,235,253,488,2014-15
2016112,2010012,Regional School District 01,Housatonic Valley Regional High School,210,194,404,2014-15
2045112,2040012,Regional School District 04,John Winthrop Middle School,164,168,332,2014-15
2046112,2040012,Regional School District 04,Valley Regional High School,324,311,635,2014-15
2055112,2050012,Regional School District 05,Amity Middle School: Bethany,193,193,386,2014-15
2055212,2050012,Regional School District 05,Amity Middle School: Orange,188,204,392,2014-15
2056112,2050012,Regional School District 05,Amity Regional High School,747,777,1524,2014-15
2068112,2060012,Regional School District 06,Early Childhood Learning Center,26,31,57,2014-15
2060112,2060012,Regional School District 06,Goshen Center School,89,61,150,2014-15
2060212,2060012,Regional School District 06,James Morris School,60,65,125,2014-15
2066112,2060012,Regional School District 06,Wamogo Regional High School,304,263,567,2014-15
2060312,2060012,Regional School District 06,Warren Elementary School,31,35,66,2014-15
2079112,2070012,Regional School District 07,AIM,*,*,10,2014-15
2079012,2070012,Regional School District 07,FLEX,0,8,8,2014-15
2079212,2070012,Regional School District 07,Links,*,*,13,2014-15
2076112,2070012,Regional School District 07,Northwestern Regional High School,366,327,693,2014-15
2075112,2070012,Regional School District 07,Northwestern Regional Middle School,165,167,332,2014-15
2079312,2070012,Regional School District 07,STEP,*,*,8,2014-15
2086112,2080012,Regional School District 08,RHAM High School,520,574,1094,2014-15
2085112,2080012,Regional School District 08,RHAM Middle School,270,285,555,2014-15
2096112,2090012,Regional School District 09,Joel Barlow High School,510,539,1049,2014-15
2105112,2100012,Regional School District 10,Har-Bur Middle School,397,412,809,2014-15
2100312,2100012,Regional School District 10,Harwinton Consolidated School,205,212,417,2014-15
2100212,2100012,Regional School District 10,Lake Garda Elementary School,217,251,468,2014-15
2106112,2100012,Regional School District 10,Lewis S. Mills High School,361,417,778,2014-15
2116112,2110012,Regional School District 11,Parish Hill High School,128,141,269,2014-15
2120212,2120012,Regional School District 12,Booth Free School,35,43,78,2014-15
2120312,2120012,Regional School District 12,Shepaug Valley School,228,233,461,2014-15
2120112,2120012,Regional School District 12,The Burnham School,31,24,55,2014-15
2120412,2120012,Regional School District 12,Washington Primary School,79,74,153,2014-15
2136112,2130012,Regional School District 13,Coginchaug Regional High School,273,283,556,2014-15
2130212,2130012,Regional School District 13,Francis E. Korn School,74,67,141,2014-15
2135112,2130012,Regional School District 13,Frank Ward Strong School,157,181,338,2014-15
2130112,2130012,Regional School District 13,Frederick Brewster School,109,128,237,2014-15
2130512,2130012,Regional School District 13,John Lyman School,142,97,239,2014-15
2130412,2130012,Regional School District 13,Middlefield Memorial School,129,164,293,2014-15
2130312,2130012,Regional School District 13,Middlesex Transition Academy,7,12,19,2014-15
2140112,2140012,Regional School District 14,Bethlehem Elementary School,148,116,264,2014-15
2148012,2140012,Regional School District 14,Integrated Star Preschool Program,19,32,51,2014-15
2140212,2140012,Regional School District 14,Mitchell Elementary School,167,192,359,2014-15
2140312,2140012,Regional School District 14,Nonnewaug Chiefs Alternative Program,*,0,*,2014-15
2146112,2140012,Regional School District 14,Nonnewaug High School,436,315,751,2014-15
2145112,2140012,Regional School District 14,Woodbury Middle School,176,188,364,2014-15
2150412,2150012,Regional School District 15,Gainfield Elementary School,183,195,378,2014-15
2150712,2150012,Regional School District 15,Long Meadow Elementary School,232,289,521,2014-15
2155212,2150012,Regional School District 15,Memorial Middle School,214,246,460,2014-15
2150612,2150012,Regional School District 15,Middlebury Elementary School,174,174,348,2014-15
2156212,2150012,Regional School District 15,Pomperaug Regional High School,588,616,1204,2014-15
2150512,2150012,Regional School District 15,Pomperaug School,196,195,391,2014-15
2155112,2150012,Regional School District 15,Rochambeau Middle School,266,279,545,2014-15
2160312,2160012,Regional School District 16,Algonquin School,220,195,415,2014-15
2160212,2160012,Regional School District 16,Community School,118,101,219,2014-15
2160112,2160012,Regional School District 16,Laurel Ledge School,188,232,420,2014-15
2165112,2160012,Regional School District 16,Long River Middle School,275,295,570,2014-15
2160412,2160012,Regional School District 16,WRHS Alternative Education Program,6,7,13,2014-15
2166012,2160012,Regional School District 16,Woodland Regional High School,361,319,680,2014-15
2170212,2170012,Regional School District 17,Burr District Elementary School,132,167,299,2014-15
2170112,2170012,Regional School District 17,Haddam Elementary School,107,128,235,2014-15
2176112,2170012,Regional School District 17,Haddam-Killingworth High School,329,286,615,2014-15
2175112,2170012,Regional School District 17,Haddam-Killingworth Middle School,348,414,762,2014-15
2170312,2170012,Regional School District 17,Killingworth Elementary School,126,138,264,2014-15
2180312,2180012,Regional School District 18,Center School,62,64,126,2014-15
2180112,2180012,Regional School District 18,Lyme Consolidated School,106,109,215,2014-15
2186112,2180012,Regional School District 18,Lyme-Old Lyme High School,205,232,437,2014-15
2185112,2180012,Regional School District 18,Lyme-Old Lyme Middle School,185,167,352,2014-15
2180212,2180012,Regional School District 18,Mile Creek School,108,113,221,2014-15
2196112,2190012,Regional School District 19,E. O. Smith High School,593,559,1152,2014-15
2190112,2190012,Regional School District 19,E.O. Smith High School at the Depot Campus,19,8,27,2014-15
2190212,2190012,Regional School District 19,PM Panthers,7,10,17,2014-15
1188011,1180011,Ridgefield School District,Alternative High School,6,8,14,2014-15
1180811,1180011,Ridgefield School District,Barlow Mountain Elementary School,175,186,361,2014-15
1180611,1180011,Ridgefield School District,Branchville Elementary School,184,195,379,2014-15
1185111,1180011,Ridgefield School District,East Ridge Middle School,373,387,760,2014-15
1180411,1180011,Ridgefield School District,Farmingville Elementary School,165,180,345,2014-15
1180311,1180011,Ridgefield School District,Ridgebury Elementary School,167,187,354,2014-15
1189011,1180011,Ridgefield School District,Ridgefield 18-21 Transition Program,*,*,*,2014-15
1186111,1180011,Ridgefield School District,Ridgefield High School,873,871,1744,2014-15
1180511,1180011,Ridgefield School District,Scotland Elementary School,187,181,368,2014-15
1185211,1180011,Ridgefield School District,Scotts Ridge Middle School,237,259,496,2014-15
1180211,1180011,Ridgefield School District,Veterans Park Elementary School,169,161,330,2014-15
1195111,1190011,Rocky Hill School District,Albert D. Griswold Middle School,319,306,625,2014-15
1190111,1190011,Rocky Hill School District,Alternative Learning Program,*,*,10,2014-15
1190411,1190011,Rocky Hill School District,Myrtle H. Stevens School,231,252,483,2014-15
1190311,1190011,Rocky Hill School District,Pathways,*,*,6,2014-15
1196111,1190011,Rocky Hill School District,Rocky Hill High School,354,343,697,2014-15
1190511,1190011,Rocky Hill School District,West Hill School,319,342,661,2014-15
1210111,1210011,Salem School District,Salem Elementary School,184,208,392,2014-15
1220211,1220011,Salisbury School District,SELC,*,*,*,2014-15
1220111,1220011,Salisbury School District,Salisbury Central School,132,137,269,2014-15
1230111,1230011,Scotland School District,Scotland Elementary School,71,58,129,2014-15
1240111,1240011,Seymour School District,Bungay School,251,251,502,2014-15
1240211,1240011,Seymour School District,Chatfield-LoPresti School,256,277,533,2014-15
1246111,1240011,Seymour School District,Seymour High School,309,339,648,2014-15
1245111,1240011,Seymour School District,Seymour Middle School,301,290,591,2014-15
1250111,1250011,Sharon School District,Sharon Center School,87,76,163,2014-15
1250211,1250011,Sharon School District,TOTAL,*,*,14,2014-15
1260911,1260011,Shelton School District,Mohegan School,146,147,293,2014-15
1261011,1260011,Shelton School District,Booth Hill School,150,173,323,2014-15
1260511,1260011,Shelton School District,Elizabeth Shelton School,230,241,471,2014-15
1265111,1260011,Shelton School District,Intermediate School,427,451,878,2014-15
1260811,1260011,Shelton School District,Long Hill School,203,229,432,2014-15
1261111,1260011,Shelton School District,Perry Hill Elementary School,361,388,749,2014-15
1266111,1260011,Shelton School District,Shelton High School,781,769,1550,2014-15
1260611,1260011,Shelton School District,Sunnyside School,115,114,229,2014-15
1270111,1270011,Sherman School District,Sherman School,179,167,346,2014-15
2700113,2700013,Side By Side Charter School District,Side By Side Charter School,117,118,235,2014-15
1280111,1280011,Simsbury School District,Central School,192,212,404,2014-15
1285111,1280011,Simsbury School District,Henry James Memorial School,343,396,739,2014-15
1280611,1280011,Simsbury School District,Latimer Lane School,207,197,404,2014-15
1286111,1280011,Simsbury School District,Simsbury High School,692,758,1450,2014-15
1280711,1280011,Simsbury School District,Squadron Line School,292,320,612,2014-15
1280311,1280011,Simsbury School District,Tariffville School,155,139,294,2014-15
1280411,1280011,Simsbury School District,Tootin' Hills School,184,188,372,2014-15
1295111,1290011,Somers School District,Mabelle B. Avery Middle School,188,183,371,2014-15
1290411,1290011,Somers School District,Somers Elementary School,304,324,628,2014-15
1296111,1290011,Somers School District,Somers High School,232,242,474,2014-15
1320211,1320011,South Windsor School District,Pleasant Valley School,178,168,346,2014-15
1320711,1320011,South Windsor School District,Eli Terry School,216,228,444,2014-15
1320611,1320011,South Windsor School District,Orchard Hill School,188,201,389,2014-15
1320111,1320011,South Windsor School District,Philip R. Smith School,163,181,344,2014-15
1329011,1320011,South Windsor School District,Project Worth Young Adult Academy,*,*,11,2014-15
1326211,1320011,South Windsor School District,South Windsor High School,687,677,1364,2014-15
1325111,1320011,South Windsor School District,Timothy Edwards School,453,526,979,2014-15
1320411,1320011,South Windsor School District,Wapping Elementary School,141,162,303,2014-15
1315311,1310011,Southington School District,John F. Kennedy Middle School,411,415,826,2014-15
1311711,1310011,Southington School District,Achieve,*,*,*,2014-15
1310111,1310011,Southington School District,Alta,16,22,38,2014-15
1311511,1310011,Southington School District,Derynoski Elementary School,306,305,611,2014-15
1310511,1310011,Southington School District,EASE,0,10,10,2014-15
1311311,1310011,Southington School District,Flanders Elementary School,131,162,293,2014-15
1310211,1310011,Southington School District,Hatton Elementary School,177,207,384,2014-15
1315111,1310011,Southington School District,Joseph A. Depaolo Middle School,359,368,727,2014-15
1310411,1310011,Southington School District,Language Based Classroom at Hatton School,*,*,7,2014-15
1311811,1310011,Southington School District,"Language Based Classroom, Multihandicapped",*,*,8,2014-15
1310611,1310011,Southington School District,Plantsville Elementary School,151,136,287,2014-15
1310311,1310011,Southington School District,Preschool/ABA-Hatton School,8,25,33,2014-15
1311911,1310011,Southington School District,Preschool/ABA-South End School,*,*,10,2014-15
1310711,1310011,Southington School District,South End Elementary School,128,128,256,2014-15
1316211,1310011,Southington School District,Southington High School,1008,1004,2012,2014-15
1310811,1310011,Southington School District,Strong Elementary School,159,150,309,2014-15
1310911,1310011,Southington School District,Thalberg Elementary School,205,222,427,2014-15
1311611,1310011,Southington School District,Therapeutic Educational Alternative Model (TEAM),*,*,*,2014-15
1311211,1310011,Southington School District,Therapeutic Educational Setting (TEP),*,*,6,2014-15
1311411,1310011,Southington School District,Urbin T. Kelley School,168,173,341,2014-15
1330111,1330011,Sprague School District,Sayles School,159,204,363,2014-15
1340611,1340011,Stafford School District,Stafford Elementary School,218,253,471,2014-15
1346111,1340011,Stafford School District,Stafford High School,235,179,414,2014-15
1345211,1340011,Stafford School District,Stafford Middle School,167,187,354,2014-15
1340211,1340011,Stafford School District,Stafford Tutoring Program,*,*,*,2014-15
1340311,1340011,Stafford School District,Staffordville School,80,82,162,2014-15
1340411,1340011,Stafford School District,West Stafford School,87,89,176,2014-15
2826013,2820013,Stamford Academy District,Stamford Academy,60,81,141,2014-15
1350411,1350011,Stamford School District,Alternate Routes To Success,45,51,96,2014-15
1350111,1350011,Stamford School District,Apples PreK,30,90,120,2014-15
1355611,1350011,Stamford School District,Cloonan School,287,329,616,2014-15
1352011,1350011,Stamford School District,Davenport Ridge School,319,307,626,2014-15
1355311,1350011,Stamford School District,Dolan School,254,278,532,2014-15
1352211,1350011,Stamford School District,Hart School,317,339,656,2014-15
1350211,1350011,Stamford School District,Individuals Achieving Independence,9,14,23,2014-15
1351211,1350011,Stamford School District,Julia A. Stark School,287,316,603,2014-15
1350511,1350011,Stamford School District,K. T. Murphy School,282,270,552,2014-15
1350611,1350011,Stamford School District,Newfield School,325,331,656,2014-15
1351811,1350011,Stamford School District,Northeast School,334,352,686,2014-15
1358011,1350011,Stamford School District,Preschool Team,9,26,35,2014-15
1355811,1350011,Stamford School District,Rippowam Middle School,401,350,751,2014-15
1350811,1350011,Stamford School District,Rogers International School,422,379,801,2014-15
1350911,1350011,Stamford School District,Roxbury School,293,322,615,2014-15
1355711,1350011,Stamford School District,Scofield Middle School,351,321,672,2014-15
1351111,1350011,Stamford School District,Springdale School,348,334,682,2014-15
1356111,1350011,Stamford School District,Stamford High School,850,940,1790,2014-15
1352111,1350011,Stamford School District,Stillmeadow School,306,366,672,2014-15
1356411,1350011,Stamford School District,The Academy of Information Technology,296,397,693,2014-15
1351911,1350011,Stamford School District,Toquam Magnet School,320,390,710,2014-15
1355511,1350011,Stamford School District,Turn of River School,317,293,610,2014-15
1356311,1350011,Stamford School District,Westhill High School,1075,1013,2088,2014-15
1351411,1350011,Stamford School District,Westover School,341,373,714,2014-15
1360311,1360011,Sterling School District,Sterling Community School,209,252,461,2014-15
1370811,1370011,Stonington School District,Community Classroom,*,*,*,2014-15
1370511,1370011,Stonington School District,Deans Mill School,199,215,414,2014-15
1375211,1370011,Stonington School District,Mystic Middle School,174,222,396,2014-15
1375111,1370011,Stonington School District,Pawcatuck Middle School,148,150,298,2014-15
1370111,1370011,Stonington School District,Stonington BOE Pre-School,10,9,19,2014-15
1370211,1370011,Stonington School District,Stonington HS PreK,12,7,19,2014-15
1376111,1370011,Stonington School District,Stonington High School,385,375,760,2014-15
1370411,1370011,Stonington School District,West Broad Street School,56,79,135,2014-15
1370611,1370011,Stonington School District,West Vine Street School,94,109,203,2014-15
1381311,1380011,Stratford School District,Eli Whitney School,246,270,516,2014-15
1380611,1380011,Stratford School District,ABA Second Hill Lane,*,*,*,2014-15
1380511,1380011,Stratford School District,ALPHA,20,25,45,2014-15
1386211,1380011,Stratford School District,Bunnell High School,556,504,1060,2014-15
1380311,1380011,Stratford School District,Chapel School,254,280,534,2014-15
1385211,1380011,Stratford School District,David Wooster Middle School,248,264,512,2014-15
1382111,1380011,Stratford School District,Franklin STEPS K-2,*,*,*,2014-15
1380411,1380011,Stratford School District,Franklin School,150,152,302,2014-15
1385311,1380011,Stratford School District,Harry B. Flood Middle School,272,294,566,2014-15
1382011,1380011,Stratford School District,High School STEPS 9-12,*,*,*,2014-15
1380711,1380011,Stratford School District,High School Sails,*,*,7,2014-15
1381611,1380011,Stratford School District,Honeyspot School,122,89,211,2014-15
1381111,1380011,Stratford School District,IPP Classroom - Johnson,*,*,8,2014-15
1381711,1380011,Stratford School District,Intensive Need Classroom,*,*,*,2014-15
1381211,1380011,Stratford School District,Johnson House STEPS 3-6,*,*,10,2014-15
1380811,1380011,Stratford School District,Lordship School,139,131,270,2014-15
1381911,1380011,Stratford School District,Middle School STEPS 7-8,0,*,*,2014-15
1381811,1380011,Stratford School District,Middle School Sails,0,*,*,2014-15
1380911,1380011,Stratford School District,Nichols School,228,224,452,2014-15
1381011,1380011,Stratford School District,Second Hill Lane School,337,355,692,2014-15
1381511,1380011,Stratford School District,Stratford Academy - Johnson House,219,211,430,2014-15
1386111,1380011,Stratford School District,Stratford High School,477,492,969,2014-15
1389011,1380011,Stratford School District,Strive-Stratford,*,*,17,2014-15
1381411,1380011,Stratford School District,Wilcoxson School,166,204,370,2014-15
1390411,1390011,Suffield School District,A. Ward Spaulding School,237,254,491,2014-15
1390311,1390011,Suffield School District,McAlister Intermediate School,268,233,501,2014-15
1396111,1390011,Suffield School District,Suffield High School,411,411,822,2014-15
1395111,1390011,Suffield School District,Suffield Middle School,294,280,574,2014-15
2696113,2690013,The Bridge Academy District,The Bridge Academy,142,133,275,2014-15
9026122,9020022,The Gilbert School District,The Gilbert School,224,328,552,2014-15
1400111,1400011,Thomaston School District,Black Rock School,142,123,265,2014-15
1400211,1400011,Thomaston School District,Thomaston Center School,127,119,246,2014-15
1406211,1400011,Thomaston School District,Thomaston High School,187,205,392,2014-15
1410111,1410011,Thompson School District,Mary R. Fisher Elementary School,185,230,415,2014-15
1415111,1410011,Thompson School District,Thompson Middle School,166,171,337,2014-15
1416111,1410011,Thompson School District,Tourtellotte Memorial High School,117,134,251,2014-15
1420111,1420011,Tolland School District,Birch Grove Primary School,275,285,560,2014-15
1420311,1420011,Tolland School District,TALC,7,6,13,2014-15
1426111,1420011,Tolland School District,Tolland High School,423,405,828,2014-15
1420211,1420011,Tolland School District,Tolland Intermediate School,270,307,577,2014-15
1425111,1420011,Tolland School District,Tolland Middle School,344,335,679,2014-15
1430111,1430011,Torrington School District,East School,166,195,361,2014-15
1430211,1430011,Torrington School District,Forbes School,167,206,373,2014-15
1431611,1430011,Torrington School District,Pre-K SpEd,*,*,20,2014-15
1430811,1430011,Torrington School District,Southwest School,154,175,329,2014-15
1430911,1430011,Torrington School District,Torringford School,296,319,615,2014-15
1431411,1430011,Torrington School District,Torrington Expulsion Program,*,*,12,2014-15
1436111,1430011,Torrington School District,Torrington High School,464,539,1003,2014-15
1435111,1430011,Torrington School District,Torrington Middle School,465,547,1012,2014-15
1431311,1430011,Torrington School District,Vogel-Wetmore School,239,239,478,2014-15
1431911,1430011,Torrington School District,Vogel-Wetmore/Outreach PreK,0,7,7,2014-15
2785113,2780013,Trailblazers Academy District,Trailblazers Academy,51,68,119,2014-15
1440111,1440011,Trumbull School District,Booth Hill School,238,244,482,2014-15
1440811,1440011,Trumbull School District,Daniels Farm School,238,234,472,2014-15
1441011,1440011,Trumbull School District,Frenchtown Elementary School,266,298,564,2014-15
1445211,1440011,Trumbull School District,Hillcrest Middle School,371,389,760,2014-15
1440411,1440011,Trumbull School District,Jane Ryan School,195,198,393,2014-15
1445111,1440011,Trumbull School District,Madison Middle School,375,405,780,2014-15
1440311,1440011,Trumbull School District,Middlebrook School,228,271,499,2014-15
1440511,1440011,Trumbull School District,REACH,*,*,11,2014-15
1440911,1440011,Trumbull School District,Tashua School,187,197,384,2014-15
1440211,1440011,Trumbull School District,Trumbull Alternative School,*,*,8,2014-15
1448011,1440011,Trumbull School District,Trumbull Early Childhood Education Center,99,125,224,2014-15
1446111,1440011,Trumbull School District,Trumbull High School,1140,983,2123,2014-15
3360115,3360015,Unified School District #1,Bridgeport Correctional Center,0,8,8,2014-15
3360215,3360015,Unified School District #1,Brooklyn Correctional Institution,0,*,*,2014-15
3360315,3360015,Unified School District #1,Cheshire Correctional Institution,0,18,18,2014-15
3362415,3360015,Unified School District #1,Corrigan/Radgowski Correctional Institution,0,13,13,2014-15
3360415,3360015,Unified School District #1,Enfield Correctional Institution,0,*,*,2014-15
3361915,3360015,Unified School District #1,Garner Correctional Institution,0,18,18,2014-15
3360615,3360015,Unified School District #1,Hartford Correctional Center,0,12,12,2014-15
3362215,3360015,Unified School District #1,MacDougall/Walker Correctional Institution,0,9,9,2014-15
3361115,3360015,Unified School District #1,Manson Youth Institution,0,270,270,2014-15
3360915,3360015,Unified School District #1,New Haven Correctional Center,0,7,7,2014-15
3362615,3360015,Unified School District #1,Northern Correctional Institution,0,11,11,2014-15
3361215,3360015,Unified School District #1,Osborn Correctional Institution,0,6,6,2014-15
3361315,3360015,Unified School District #1,Robinson Correctional Institution,0,7,7,2014-15
3361515,3360015,Unified School District #1,Willard/Cybulski Correctional Institution,0,*,*,2014-15
3362515,3360015,Unified School District #1,York Correctional Institution,22,0,22,2014-15
3470115,3470015,Unified School District #2,Children's Place School,0,28,28,2014-15
3470315,3470015,Unified School District #2,Riverview School,43,18,61,2014-15
3476715,3470015,Unified School District #2,Walter G. Cady School,*,*,101,2014-15
1450111,1450011,Union School District,Union Elementary School,41,39,80,2014-15
1460311,1460011,Vernon School District,Northeast School,160,159,319,2014-15
1461411,1460011,Vernon School District,Center Road School,255,239,494,2014-15
1460111,1460011,Vernon School District,Lake Street School,110,128,238,2014-15
1460511,1460011,Vernon School District,Loveland Hill School,*,*,10,2014-15
1460211,1460011,Vernon School District,Maple Street School,144,173,317,2014-15
1469011,1460011,Vernon School District,Next Step Program (AACBP),*,*,11,2014-15
1466111,1460011,Vernon School District,Rockville High School,451,421,872,2014-15
1461011,1460011,Vernon School District,Skinner Road School,165,181,346,2014-15
1465111,1460011,Vernon School District,Vernon Center Middle School,307,345,652,2014-15
1470111,1470011,Voluntown School District,Voluntown Elementary School,155,158,313,2014-15
1480211,1480011,Wallingford School District,Highland School,136,152,288,2014-15
1489011,1480011,Wallingford School District,A.R.T.S. Academy,*,*,15,2014-15
1481011,1480011,Wallingford School District,Cook Hill School,189,166,355,2014-15
1485211,1480011,Wallingford School District,Dag Hammarskjold Middle School,347,348,695,2014-15
1480511,1480011,Wallingford School District,Education Enhancement Program,10,11,21,2014-15
1480911,1480011,Wallingford School District,Evarts C. Stevens School,180,190,370,2014-15
1489211,1480011,Wallingford School District,Harvest Park,*,*,6,2014-15
1485311,1480011,Wallingford School District,James H. Moran Middle School,353,349,702,2014-15
1486111,1480011,Wallingford School District,Lyman Hall High School,611,479,1090,2014-15
1486211,1480011,Wallingford School District,Mark T. Sheehan High School,439,417,856,2014-15
1480111,1480011,Wallingford School District,Moses Y. Beach School,155,176,331,2014-15
1489111,1480011,Wallingford School District,Multi-Vocational Life Skills Program,*,*,9,2014-15
1480311,1480011,Wallingford School District,Parker Farms School,132,155,287,2014-15
1481211,1480011,Wallingford School District,Pond Hill School,164,206,370,2014-15
1480411,1480011,Wallingford School District,Rock Hill School,174,160,334,2014-15
1480811,1480011,Wallingford School District,Yalesville School,165,175,340,2014-15
1515211,1510011,Waterbury School District,West Side Middle School,471,550,1021,2014-15
1512311,1510011,Waterbury School District,Washington School,170,170,340,2014-15
1512111,1510011,Waterbury School District,B. W. Tinker School,270,302,572,2014-15
1510511,1510011,Waterbury School District,Bucks Hill School,276,285,561,2014-15
1510611,1510011,Waterbury School District,Bunker Hill School,245,266,511,2014-15
1512711,1510011,Waterbury School District,Carrington School,257,230,487,2014-15
1516211,1510011,Waterbury School District,Crosby High School,595,692,1287,2014-15
1510911,1510011,Waterbury School District,Driggs School,262,266,528,2014-15
1511611,1510011,Waterbury School District,Duggan School,240,224,464,2014-15
1519111,1510011,Waterbury School District,Enlightenment School,72,107,179,2014-15
1511411,1510011,Waterbury School District,F. J. Kingsbury School,257,256,513,2014-15
1512611,1510011,Waterbury School District,Gilmartin School,240,266,506,2014-15
1510711,1510011,Waterbury School District,H. S. Chase School,385,432,817,2014-15
1511311,1510011,Waterbury School District,Hopeville School,244,232,476,2014-15
1516411,1510011,Waterbury School District,John F. Kennedy High School,623,681,1304,2014-15
1513111,1510011,Waterbury School District,Maloney Interdistrict Magnet School,276,316,592,2014-15
1511111,1510011,Waterbury School District,Margaret M. Generali Elementary School,271,332,603,2014-15
1515111,1510011,Waterbury School District,Michael F. Wallace Middle School,568,591,1159,2014-15
1515311,1510011,Waterbury School District,North End Middle School,460,556,1016,2014-15
1513411,1510011,Waterbury School District,Reed School,206,223,429,2014-15
1512811,1510011,Waterbury School District,Regan School,139,140,279,2014-15
1513311,1510011,Waterbury School District,Rotella Interdistrict Magnet School,317,295,612,2014-15
1518011,1510011,Waterbury School District,Special Education Preschool,88,113,201,2014-15
1512011,1510011,Waterbury School District,Sprague School,233,228,461,2014-15
1519011,1510011,Waterbury School District,State Street School,17,59,76,2014-15
1512211,1510011,Waterbury School District,Walsh School,228,227,455,2014-15
1516011,1510011,Waterbury School District,Waterbury Arts Magnet School (High),323,167,490,2014-15
1515011,1510011,Waterbury School District,Waterbury Arts Magnet School (Middle),217,113,330,2014-15
1516711,1510011,Waterbury School District,Waterbury Career Academy,268,201,469,2014-15
1510811,1510011,Waterbury School District,Wendell L. Cross School,183,183,366,2014-15
1516311,1510011,Waterbury School District,Wilby High School,564,672,1236,2014-15
1513211,1510011,Waterbury School District,Woodrow Wilson School,197,249,446,2014-15
1525111,1520011,Waterford School District,Clark Lane Middle School,318,338,656,2014-15
1520211,1520011,Waterford School District,Great Neck Elementary School,183,157,340,2014-15
1520611,1520011,Waterford School District,Oswegatchie Elementary School,178,174,352,2014-15
1520711,1520011,Waterford School District,Quaker Hill Elementary School,152,196,348,2014-15
1526111,1520011,Waterford School District,Waterford High School,413,414,827,2014-15
1530311,1530011,Watertown School District,Fletcher W. Judson School,129,165,294,2014-15
1530211,1530011,Watertown School District,John Trumbull Primary School,289,359,648,2014-15
1530411,1530011,Watertown School District,Polk School,167,181,348,2014-15
1535111,1530011,Watertown School District,Swift Middle School,328,352,680,2014-15
1536111,1530011,Watertown School District,Watertown High School,427,434,861,2014-15
1551711,1550011,West Hartford School District,Smith School,162,199,361,2014-15
1559111,1550011,West Hartford School District,Achieve,*,*,9,2014-15
1557311,1550011,West Hartford School District,REACH,17,14,31,2014-15
1551611,1550011,West Hartford School District,Aiken School,204,226,430,2014-15
1559311,1550011,West Hartford School District,Braeburn Learning Center,0,*,*,2014-15
1550211,1550011,West Hartford School District,Braeburn School,174,195,369,2014-15
1555311,1550011,West Hartford School District,Bristow Middle School,200,221,421,2014-15
1550411,1550011,West Hartford School District,Bugbee School,236,219,455,2014-15
1550511,1550011,West Hartford School District,Charter Oak International Academy,172,144,316,2014-15
1556111,1550011,West Hartford School District,Conard High School,730,763,1493,2014-15
1550611,1550011,West Hartford School District,Duffy School,249,256,505,2014-15
1556211,1550011,West Hartford School District,Hall High School,728,709,1437,2014-15
1555111,1550011,West Hartford School District,King Philip Middle School,455,476,931,2014-15
1550911,1550011,West Hartford School District,Morley School,169,166,335,2014-15
1559411,1550011,West Hartford School District,Norfeldt Learning Center,*,*,*,2014-15
1551011,1550011,West Hartford School District,Norfeldt School,156,201,357,2014-15
1555211,1550011,West Hartford School District,Sedgwick Middle School,411,437,848,2014-15
1559211,1550011,West Hartford School District,Strive-West Hartford,7,26,33,2014-15
1559011,1550011,West Hartford School District,WAAVE (W Hartford Applied Academic/Voc'l Experience),*,*,10,2014-15
1551211,1550011,West Hartford School District,Webster Hill School,235,210,445,2014-15
1559511,1550011,West Hartford School District,Whiting Lane Learning Center,0,7,7,2014-15
1551311,1550011,West Hartford School District,Whiting Lane School,240,242,482,2014-15
1559611,1550011,West Hartford School District,Wolcott Learning Center,*,*,8,2014-15
1551511,1550011,West Hartford School District,Wolcott School,227,227,454,2014-15
1561211,1560011,West Haven School District,Washington School,214,266,480,2014-15
1560811,1560011,West Haven School District,Alma E. Pagels School,134,209,343,2014-15
1565311,1560011,West Haven School District,Carrigan 5/6 Intermediate School,411,449,860,2014-15
1560611,1560011,West Haven School District,Edith E. Mackrille School,155,171,326,2014-15
1560311,1560011,West Haven School District,Forest School,253,225,478,2014-15
1565111,1560011,West Haven School District,Harry M. Bailey Middle School,439,433,872,2014-15
1560111,1560011,West Haven School District,Life Skills,*,*,*,2014-15
1560211,1560011,West Haven School District,PACE,18,17,35,2014-15
1561411,1560011,West Haven School District,Savin Rock Community School,239,239,478,2014-15
1560411,1560011,West Haven School District,Seth G. Haley School,221,230,451,2014-15
1566111,1560011,West Haven School District,West Haven High School,771,756,1527,2014-15
1540211,1540011,Westbrook School District,Daisy Ingraham School,129,142,271,2014-15
1546111,1540011,Westbrook School District,Westbrook High School,142,152,294,2014-15
1545111,1540011,Westbrook School District,Westbrook Middle School,113,123,236,2014-15
1570111,1570011,Weston School District,Hurlbutt Elementary School,202,267,469,2014-15
1576111,1570011,Weston School District,Weston High School,366,415,781,2014-15
1570211,1570011,Weston School District,Weston Intermediate School,264,284,548,2014-15
1575111,1570011,Weston School District,Weston Middle School,288,315,603,2014-15
1585111,1580011,Westport School District,Bedford Middle School,412,441,853,2014-15
1580311,1580011,Westport School District,Coleytown Elementary School,199,211,410,2014-15
1585311,1580011,Westport School District,Coleytown Middle School,266,282,548,2014-15
1580411,1580011,Westport School District,Green's Farms School,231,224,455,2014-15
1580511,1580011,Westport School District,King's Highway Elementary School,257,241,498,2014-15
1580711,1580011,Westport School District,Long Lots School,274,286,560,2014-15
1580811,1580011,Westport School District,Saugatuck Elementary School,231,287,518,2014-15
1586111,1580011,Westport School District,Staples High School,932,922,1854,2014-15
1588011,1580011,Westport School District,Stepping Stones Preschool,23,31,54,2014-15
1590811,1590011,Wethersfield School District,Alfred W. Hanmer School,177,176,353,2014-15
1591011,1590011,Wethersfield School District,Charles Wright School,159,153,312,2014-15
1590211,1590011,Wethersfield School District,Emerson-Williams School,210,209,419,2014-15
1591111,1590011,Wethersfield School District,Highcrest School,219,209,428,2014-15
1591211,1590011,Wethersfield School District,Samuel B. Webb Elementary School,186,188,374,2014-15
1595211,1590011,Wethersfield School District,Silas Deane Middle School,277,277,554,2014-15
1596111,1590011,Wethersfield School District,Wethersfield High School,586,592,1178,2014-15
1600111,1600011,Willington School District,Center School,103,126,229,2014-15
1605111,1600011,Willington School District,Hall Memorial School,96,104,200,2014-15
1615211,1610011,Wilton School District,Middlebrook School,513,534,1047,2014-15
1610711,1610011,Wilton School District,Cider Mill School,499,479,978,2014-15
1610511,1610011,Wilton School District,Miller-Driscoll School,411,452,863,2014-15
1616111,1610011,Wilton School District,Wilton High School,678,674,1352,2014-15
1610111,1610011,Wilton School District,Wilton-Westport Evening School,*,*,8,2014-15
1620411,1620011,Winchester School District,Batcheller Early Education Center,80,106,186,2014-15
1620211,1620011,Winchester School District,Mary P. Hinsdale School,112,129,241,2014-15
1625111,1620011,Winchester School District,Pearson Middle School,71,78,149,2014-15
1620111,1620011,Winchester School District,WISE Academy,*,*,12,2014-15
1630411,1630011,Windham School District,Charles H. Barrows STEM Academy,218,210,428,2014-15
1638011,1630011,Windham School District,Early Headstart,10,14,24,2014-15
1630111,1630011,Windham School District,Natchaug School,147,193,340,2014-15
1630311,1630011,Windham School District,North Windham School,241,210,451,2014-15
1630611,1630011,Windham School District,W. B. Sweeney School,144,136,280,2014-15
1630511,1630011,Windham School District,Windham Center School,129,153,282,2014-15
1638311,1630011,Windham School District,Windham Early Childhood Prospect Street,116,133,249,2014-15
1636111,1630011,Windham School District,Windham High School,228,299,527,2014-15
1635111,1630011,Windham School District,Windham Middle School,278,301,579,2014-15
1650111,1650011,Windsor Locks School District,North Street School,208,229,437,2014-15
1650611,1650011,Windsor Locks School District,Pine Meadow Academy,11,18,29,2014-15
1650211,1650011,Windsor Locks School District,RISE Transition Academy,*,*,*,2014-15
1650411,1650011,Windsor Locks School District,South Elementary School,188,187,375,2014-15
1656111,1650011,Windsor Locks School District,Windsor Locks High School,208,249,457,2014-15
1655111,1650011,Windsor Locks School District,Windsor Locks Middle School,177,178,355,2014-15
1640111,1640011,Windsor School District,Clover Street School,115,138,253,2014-15
1640811,1640011,Windsor School District,John F. Kennedy School,187,230,417,2014-15
1640911,1640011,Windsor School District,Oliver Ellsworth School,196,235,431,2014-15
1640511,1640011,Windsor School District,Poquonock Elementary School,127,124,251,2014-15
1645311,1640011,Windsor School District,Sage Park Middle School,331,340,671,2014-15
1646111,1640011,Windsor School District,Windsor High School,548,568,1116,2014-15
1660311,1660011,Wolcott School District,ABC Classroom,*,*,*,2014-15
1660611,1660011,Wolcott School District,Alcott School,131,156,287,2014-15
1660211,1660011,Wolcott School District,Frisbie School,159,162,321,2014-15
1660411,1660011,Wolcott School District,Phoenix Program,0,*,*,2014-15
1665111,1660011,Wolcott School District,Tyrrell Middle School,296,342,638,2014-15
1660511,1660011,Wolcott School District,Wakelee School,163,166,329,2014-15
1666111,1660011,Wolcott School District,Wolcott High School,388,385,773,2014-15
1670311,1670011,Woodbridge School District,Beecher Road School,404,392,796,2014-15
9036122,9030022,Woodstock Academy District,Woodstock Academy,526,486,1012,2014-15
1690211,1690011,Woodstock School District,Woodstock Elementary School,231,228,459,2014-15
1695111,1690011,Woodstock School District,Woodstock Middle School,210,200,410,2014-15
2880113,2880013,Achievement First Hartford Academy Inc. District,Achievement First Hartford Academy Inc.,543,520,1063,2015-16
2795113,2790013,Amistad Academy District,Amistad Academy,536,500,1036,2015-16
0010111,0010011,Andover School District,Andover Elementary School,118,132,250,2015-16
0026111,0020011,Ansonia School District,Ansonia High School,274,323,597,2015-16
0025111,0020011,Ansonia School District,Ansonia Middle School,204,242,446,2015-16
0020311,0020011,Ansonia School District,Mead School,287,308,595,2015-16
0020111,0020011,Ansonia School District,P.A.C.E. (Positive And Creative Education),12,23,35,2015-16
0020811,0020011,Ansonia School District,Prendergast School,340,348,688,2015-16
2449614,2440014,Area Cooperative Educational Services,Center for Autism Spectrum and Development Disorders,7,31,38,2015-16
2449414,2440014,Area Cooperative Educational Services,Mill Road School,23,144,167,2015-16
2445114,2440014,Area Cooperative Educational Services,Thomas Edison Magnet Middle School,352,374,726,2015-16
2449514,2440014,Area Cooperative Educational Services,Village School,42,93,135,2015-16
2449214,2440014,Area Cooperative Educational Services,Whitney High School East,36,77,113,2015-16
2449114,2440014,Area Cooperative Educational Services,Whitney High School North,26,69,95,2015-16
2449314,2440014,Area Cooperative Educational Services,Whitney High School West,7,35,42,2015-16
2440314,2440014,Area Cooperative Educational Services,Wintergreen Interdistrict  Magnet School,316,316,632,2015-16
0030111,0030011,Ashford School District,Ashford School,194,203,397,2015-16
0046111,0040011,Avon School District,Avon High School,526,512,1038,2015-16
0045111,0040011,Avon School District,Avon Middle School,256,289,545,2015-16
0040111,0040011,Avon School District,Avon Public Schools Pre-K,26,19,45,2015-16
0040411,0040011,Avon School District,Pine Grove School,302,297,599,2015-16
0040311,0040011,Avon School District,Roaring Brook School,236,261,497,2015-16
0040511,0040011,Avon School District,Thompson Brook School,272,278,550,2015-16
0050111,0050011,Barkhamsted School District,Barkhamsted Elementary School,130,125,255,2015-16
0050211,0050011,Barkhamsted School District,Bridges at Barkhamsted Elementary School,*,*,*,2015-16
0058011,0050011,Barkhamsted School District,Shared Services Integrated Preschool,11,17,28,2015-16
0076111,0070011,Berlin School District,Berlin High School,445,508,953,2015-16
0075111,0070011,Berlin School District,Catherine M. McGee Middle School,303,369,672,2015-16
0070411,0070011,Berlin School District,Emma Hart Willard School,246,257,503,2015-16
0070511,0070011,Berlin School District,Mary E. Griswold School,232,265,497,2015-16
0070111,0070011,Berlin School District,Richard D. Hubbard School,118,120,238,2015-16
0080111,0080011,Bethany School District,Bethany Community School,191,192,383,2015-16
0090411,0090011,Bethel School District,Anna H. Rockwell School,204,216,420,2015-16
0096111,0090011,Bethel School District,Bethel High School,425,472,897,2015-16
0095111,0090011,Bethel School District,Bethel Middle School,317,341,658,2015-16
0090111,0090011,Bethel School District,Frank A. Berry School,243,318,561,2015-16
0090511,0090011,Bethel School District,Ralph M. T. Johnson School,202,224,426,2015-16
0116111,0110011,Bloomfield School District,Bloomfield High School,221,295,516,2015-16
0110711,0110011,Bloomfield School District,Carmen Arace Intermediate School,104,116,220,2015-16
0115211,0110011,Bloomfield School District,Carmen Arace Middle School,89,104,193,2015-16
0116311,0110011,Bloomfield School District,Global Experience Magnet School,126,92,218,2015-16
0110611,0110011,Bloomfield School District,Laurel School,181,154,335,2015-16
0116411,0110011,Bloomfield School District,Learning Academy at Bloomfield,*,*,10,2015-16
0110511,0110011,Bloomfield School District,Metacomet School,131,123,254,2015-16
0110811,0110011,Bloomfield School District,Wintonbury Early Childhood Magnet School,142,180,322,2015-16
0120111,0120011,Bolton School District,Bolton Center School,252,255,507,2015-16
0126111,0120011,Bolton School District,Bolton High School,163,144,307,2015-16
2950113,2950013,Booker T. Washington Academy District,Booker T. Washington Academy,81,99,180,2015-16
0130111,0130011,Bozrah School District,Fields Memorial School,97,104,201,2015-16
0146111,0140011,Branford School District,Branford High School,447,467,914,2015-16
0140211,0140011,Branford School District,Branford High School Horizons Program,14,26,40,2015-16
0145111,0140011,Branford School District,Francis Walsh Intermediate School,470,442,912,2015-16
0148011,0140011,Branford School District,Indian Neck School,13,27,40,2015-16
0141611,0140011,Branford School District,John B. Sliney School,161,188,349,2015-16
0141511,0140011,Branford School District,Mary R. Tisko School,178,188,366,2015-16
0141411,0140011,Branford School District,Mary T. Murphy School,180,244,424,2015-16
2900113,2900013,Brass City Charter School District,Brass City Charter School,110,76,186,2015-16
2850113,2850013,Bridgeport Achievement First District,Achievement First Bridgeport Academy,525,491,1016,2015-16
0150811,0150011,Bridgeport School District,"Aerospace/Hydrospace, Engineering and Physical Sciences HS at the Fairchild-Wheeler Magnet Campus",166,328,494,2015-16
0150111,0150011,Bridgeport School District,Barnum School,283,335,618,2015-16
0156111,0150011,Bridgeport School District,Bassick High School,418,533,951,2015-16
0150211,0150011,Bridgeport School District,Beardsley School,170,184,354,2015-16
0150611,0150011,Bridgeport School District,"Biotechnology, Research and Zoological Studies HS at the Fairchild-Wheeler Magnet Campus",348,141,489,2015-16
0150311,0150011,Bridgeport School District,Black Rock School,216,253,469,2015-16
0154011,0150011,Bridgeport School District,Blackham School,503,628,1131,2015-16
0159011,0150011,Bridgeport School District,Bridgeport Learning Center,11,50,61,2015-16
0151611,0150011,Bridgeport School District,Bridgeport Military Academy,113,157,270,2015-16
0150411,0150011,Bridgeport School District,Bryant School,185,200,385,2015-16
0152711,0150011,Bridgeport School District,Career and Craftsmanship,11,16,27,2015-16
0156211,0150011,Bridgeport School District,Central High School,765,752,1517,2015-16
0151411,0150011,Bridgeport School District,Cesar Batalla School,535,661,1196,2015-16
0152111,0150011,Bridgeport School District,Classical Studies Academy,206,187,393,2015-16
0150511,0150011,Bridgeport School District,Columbus School,420,432,852,2015-16
0153911,0150011,Bridgeport School District,Cross School,183,214,397,2015-16
0154211,0150011,Bridgeport School District,Curiale School,334,364,698,2015-16
0154111,0150011,Bridgeport School District,Dunbar School,204,212,416,2015-16
0150711,0150011,Bridgeport School District,Edison School,120,150,270,2015-16
0153211,0150011,Bridgeport School District,Geraldine Johnson School,373,421,794,2015-16
0151111,0150011,Bridgeport School District,Hall School,115,125,240,2015-16
0151211,0150011,Bridgeport School District,Hallen School,156,159,315,2015-16
0156311,0150011,Bridgeport School District,Harding High School,513,547,1060,2015-16
0154511,0150011,Bridgeport School District,High Horizons Magnet School,228,180,408,2015-16
0151311,0150011,Bridgeport School District,Hooker School,167,184,351,2015-16
0151511,0150011,Bridgeport School District,Information Technology and Software Engineering High School at the Fairchild-Wheeler Magnet Campus,175,317,492,2015-16
0153711,0150011,Bridgeport School District,Interdistrict Discovery Magnet School,245,261,506,2015-16
0152211,0150011,Bridgeport School District,Jettie S. Tisdale School,283,366,649,2015-16
0151011,0150011,Bridgeport School District,Luis Munoz Marin School,414,422,836,2015-16
0152011,0150011,Bridgeport School District,Madison School,230,282,512,2015-16
0154611,0150011,Bridgeport School District,Multicultural Magnet School,264,196,460,2015-16
0152811,0150011,Bridgeport School District,Opportunities for Self-Discovery Community Partnership,*,*,7,2015-16
0151711,0150011,Bridgeport School District,Park City Magnet School,257,226,483,2015-16
0152511,0150011,Bridgeport School District,Read School,418,473,891,2015-16
0152611,0150011,Bridgeport School District,Roosevelt School,306,317,623,2015-16
0154411,0150011,Bridgeport School District,Skane Center,88,136,224,2015-16
0153011,0150011,Bridgeport School District,Waltersville School,252,251,503,2015-16
0153611,0150011,Bridgeport School District,Winthrop School,319,354,673,2015-16
0179011,0170011,Bristol School District,Alternative Special Education Program (ASEP),*,*,20,2015-16
0176111,0170011,Bristol School District,Bristol Central High School,560,607,1167,2015-16
0170411,0170011,Bristol School District,Bristol Early Childhood Center-BECC,26,37,63,2015-16
0176211,0170011,Bristol School District,Bristol Eastern High School,597,624,1221,2015-16
0173311,0170011,Bristol School District,Bristol Preparatory Academy,23,25,48,2015-16
0175111,0170011,Bristol School District,Chippens Hill Middle School,324,380,704,2015-16
0171011,0170011,Bristol School District,Chippens Hill Middle School Functional Program,*,*,12,2015-16
0173411,0170011,Bristol School District,Chms Goal,0,7,7,2015-16
0179211,0170011,Bristol School District,Community/Vocational Program,6,6,12,2015-16
0170311,0170011,Bristol School District,Edgewood School,164,176,340,2015-16
0171411,0170011,Bristol School District,Ellen P. Hubbell School,233,218,451,2015-16
0170911,0170011,Bristol School District,Greene-Hills GOAL,0,*,*,2015-16
0170511,0170011,Bristol School District,Greene-Hills School,467,460,927,2015-16
0172111,0170011,Bristol School District,Hubbell/Extended Resource,*,*,6,2015-16
0172611,0170011,Bristol School District,Ivy Drive GOAL,*,*,*,2015-16
0172311,0170011,Bristol School District,Ivy Drive Medically Fragile,*,*,*,2015-16
0171911,0170011,Bristol School District,Ivy Drive School,194,201,395,2015-16
0171711,0170011,Bristol School District,Mountain View School,190,182,372,2015-16
0172511,0170011,Bristol School District,Mt. View GOAL,*,*,8,2015-16
0172711,0170011,Bristol School District,Northeast MS/Extended Resource,*,*,*,2015-16
0172811,0170011,Bristol School District,Northeast MS/GOAL,*,*,*,2015-16
0175211,0170011,Bristol School District,Northeast Middle School,203,219,422,2015-16
0172911,0170011,Bristol School District,PreK Autism,*,*,10,2015-16
0173011,0170011,Bristol School District,South Side Extended Resource,0,*,*,2015-16
0173111,0170011,Bristol School District,South Side GOAL,0,*,*,2015-16
0171111,0170011,Bristol School District,South Side School,250,241,491,2015-16
0173211,0170011,Bristol School District,Stafford Autism,*,*,24,2015-16
0171211,0170011,Bristol School District,Stafford School,222,214,436,2015-16
0172011,0170011,Bristol School District,West Bristol School,457,465,922,2015-16
0186111,0180011,Brookfield School District,Brookfield High School,445,435,880,2015-16
0180311,0180011,Brookfield School District,Center Elementary School,175,193,368,2015-16
0180411,0180011,Brookfield School District,Huckleberry Hill Elementary School,280,297,577,2015-16
0185311,0180011,Brookfield School District,Whisconier Middle School,417,438,855,2015-16
0190111,0190011,Brooklyn School District,Brooklyn Elementary School,239,282,521,2015-16
0195111,0190011,Brooklyn School District,Brooklyn Middle School,199,178,377,2015-16
0210111,0210011,Canaan School District,Lee H. Kellogg School,38,38,76,2015-16
0220211,0220011,Canterbury School District,Canterbury Elementary School,119,142,261,2015-16
0225111,0220011,Canterbury School District,Dr. Helen Baldwin Middle School,95,135,230,2015-16
0230411,0230011,Canton School District,Canton Academy,0,*,*,2015-16
0236111,0230011,Canton School District,Canton High School,247,241,488,2015-16
0230311,0230011,Canton School District,Canton Intermediate School,195,205,400,2015-16
0235111,0230011,Canton School District,Canton Middle School,151,133,284,2015-16
0230211,0230011,Canton School District,Cherry Brook Primary School,237,214,451,2015-16
2970113,2970013,Capital Preparatory Harbor School Inc. District,Capital Preparatory Harbor School Inc.,103,146,249,2015-16
2415114,2410014,Capitol Region Education Council,Academy of Aerospace and Engineering,187,515,702,2015-16
2410714,2410014,Capitol Region Education Council,Academy of Aerospace and Engineering Elementary,152,191,343,2015-16
2416514,2410014,Capitol Region Education Council,Academy of Science and Innovation,390,127,517,2015-16
2410614,2410014,Capitol Region Education Council,Ana Grace Academy of the Arts Elementary School,195,159,354,2015-16
2418114,2410014,Capitol Region Education Council,Discovery Academy,180,225,405,2015-16
2419214,2410014,Capitol Region Education Council,Farmington Valley Regional Diagnostic Center,10,6,16,2015-16
2410114,2410014,Capitol Region Education Council,Glastonbury/East Hartford Magnet School,199,252,451,2015-16
2416414,2410014,Capitol Region Education Council,Greater Hartford Academy of  the Arts High School - Full Time,322,118,440,2015-16
2415314,2410014,Capitol Region Education Council,Greater Hartford Academy of the Arts Magnet Middle,231,106,337,2015-16
2419414,2410014,Capitol Region Education Council,Integrated Program Models,*,*,*,2015-16
2410414,2410014,Capitol Region Education Council,International Magnet School for Global Citizenship,224,243,467,2015-16
2419014,2410014,Capitol Region Education Council,John J. Allison Polaris Center,21,36,57,2015-16
2419614,2410014,Capitol Region Education Council,Lincoln Academy Regional Interdistrict Collaborative,*,*,12,2015-16
2416114,2410014,Capitol Region Education Council,Metropolitan Learning Center for Global and International Studies,385,341,726,2015-16
2413114,2410014,Capitol Region Education Council,Montessori Magnet School,179,175,354,2015-16
2410514,2410014,Capitol Region Education Council,Museum Academy,241,227,468,2015-16
2415214,2410014,Capitol Region Education Council,Public Safety Academy,143,312,455,2015-16
2410314,2410014,Capitol Region Education Council,Reggio Magnet School of the Arts,224,231,455,2015-16
2419514,2410014,Capitol Region Education Council,River Street Early Learning Center (Site 2),17,49,66,2015-16
2419314,2410014,Capitol Region Education Council,River Street School,21,119,140,2015-16
2419114,2410014,Capitol Region Education Council,Soundbridge,16,26,42,2015-16
2411114,2410014,Capitol Region Education Council,Soundbridge @ Academy of Aerospace & Engineering Elementary,*,*,7,2015-16
2411214,2410014,Capitol Region Education Council,Soundbridge @ Museum Academy,*,*,8,2015-16
2411014,2410014,Capitol Region Education Council,Soundbridge @ Wethersfield High School,*,*,9,2015-16
2419714,2410014,Capitol Region Education Council,Strive (Southern Transition Real-World and Independent Vocational Education Program,*,*,8,2015-16
2416714,2410014,Capitol Region Education Council,Two Rivers Magnet High School,186,213,399,2015-16
2415014,2410014,Capitol Region Education Council,Two Rivers Magnet Middle School,239,415,654,2015-16
2410214,2410014,Capitol Region Education Council,University of Hartford Magnet School,241,216,457,2015-16
0240211,0240011,Chaplin School District,Chaplin Elementary School,79,97,176,2015-16
0250111,0250011,Cheshire School District,Chapman School,170,174,344,2015-16
0256111,0250011,Cheshire School District,Cheshire High School,696,785,1481,2015-16
0250311,0250011,Cheshire School District,Cheshire Quinnipiac University Transition Collaborative,*,*,10,2015-16
0250211,0250011,Cheshire School District,Darcey School,53,94,147,2015-16
0255111,0250011,Cheshire School District,Dodd Middle School,378,341,719,2015-16
0250611,0250011,Cheshire School District,Doolittle School,251,229,480,2015-16
0250411,0250011,Cheshire School District,Highland School,358,393,751,2015-16
0250911,0250011,Cheshire School District,Humiston Alternative School,7,11,18,2015-16
0250511,0250011,Cheshire School District,Norton School,222,223,445,2015-16
0260111,0260011,Chester School District,Chester Elementary School,122,89,211,2015-16
0270111,0270011,Clinton School District,Abraham Pierson School,158,154,312,2015-16
0275111,0270011,Clinton School District,Jared Eliot School,214,238,452,2015-16
0270311,0270011,Clinton School District,Lewin G. Joel Jr. School,256,266,522,2015-16
0276111,0270011,Clinton School District,The Morgan School,271,262,533,2015-16
0286111,0280011,Colchester School District,Bacon Academy,429,406,835,2015-16
0280511,0280011,Colchester School District,Bacon Academy Alternative Education,*,*,15,2015-16
0280411,0280011,Colchester School District,Colchester Elementary School,278,292,570,2015-16
0280211,0280011,Colchester School District,Jack Jackter Intermediate School,259,272,531,2015-16
0285111,0280011,Colchester School District,William J. Johnston Middle School,293,307,600,2015-16
0290111,0290011,Colebrook School District,Colebrook Consolidated School,37,47,84,2015-16
0300111,0300011,Columbia School District,Horace W. Porter School,212,233,445,2015-16
2686113,2680013,Common Ground High School District,Common Ground High School,79,107,186,2015-16
9001516,9000016,Connecticut Technical High School System,A. I. Prince Technical High School,407,361,768,2015-16
9001116,9000016,Connecticut Technical High School System,Bullard-Havens Technical High School,449,335,784,2015-16
9001916,9000016,Connecticut Technical High School System,E. C. Goodwin Technical High School,270,366,636,2015-16
9001416,9000016,Connecticut Technical High School System,Eli Whitney Technical High School,252,299,551,2015-16
9002716,9000016,Connecticut Technical High School System,Ella T. Grasso Southeastern Technical High School,208,297,505,2015-16
9002516,9000016,Connecticut Technical High School System,Emmett O'Brien Technical High School,233,340,573,2015-16
9001716,9000016,Connecticut Technical High School System,H. C. Wilcox Technical High School,321,439,760,2015-16
9001316,9000016,Connecticut Technical High School System,H. H. Ellis Technical High School,194,429,623,2015-16
9001216,9000016,Connecticut Technical High School System,Henry Abbott Technical High School,238,402,640,2015-16
9001616,9000016,Connecticut Technical High School System,Howell Cheney Technical High School,121,532,653,2015-16
9002116,9000016,Connecticut Technical High School System,J. M. Wright Technical High School,115,135,250,2015-16
9002016,9000016,Connecticut Technical High School System,Norwich Technical High School,256,401,657,2015-16
9002216,9000016,Connecticut Technical High School System,Oliver Wolcott Technical High School,269,388,657,2015-16
9002616,9000016,Connecticut Technical High School System,Platt Technical High School,318,493,811,2015-16
9001816,9000016,Connecticut Technical High School System,Vinal Technical High School,168,420,588,2015-16
9002316,9000016,Connecticut Technical High School System,W. F. Kaynor Technical High School,339,419,758,2015-16
9002416,9000016,Connecticut Technical High School System,Windham Technical High School,172,324,496,2015-16
2439214,2430014,Cooperative Educational Services,Developmental Learning Center (DLC),24,63,87,2015-16
2439114,2430014,Cooperative Educational Services,Preschool-Primary Learning Center (PLC),17,40,57,2015-16
2439314,2430014,Cooperative Educational Services,RISE Transitional Program,*,*,17,2015-16
2438014,2430014,Cooperative Educational Services,School Readiness,47,43,90,2015-16
2430114,2430014,Cooperative Educational Services,Six-Six Magnet School,244,224,468,2015-16
2439414,2430014,Cooperative Educational Services,Therapeutic Day Program,19,131,150,2015-16
0310111,0310011,Cornwall School District,Cornwall Consolidated School,33,59,92,2015-16
0325111,0320011,Coventry School District,Capt. Nathan Hale School,202,195,397,2015-16
0320111,0320011,Coventry School District,Coventry Academy,*,*,12,2015-16
0320211,0320011,Coventry School District,Coventry Grammar School,157,191,348,2015-16
0326111,0320011,Coventry School District,Coventry High School,232,233,465,2015-16
0320411,0320011,Coventry School District,George Hersey Robertson School,195,170,365,2015-16
0320311,0320011,Coventry School District,Hale Early Education Center,12,26,38,2015-16
0336111,0330011,Cromwell School District,Cromwell High School,282,296,578,2015-16
0335111,0330011,Cromwell School District,Cromwell Middle School,214,233,447,2015-16
0330211,0330011,Cromwell School District,Edna C. Stevens School,229,248,477,2015-16
0330311,0330011,Cromwell School District,Woodside Intermediate School,229,251,480,2015-16
0346211,0340011,Danbury School District,Alternative Center For Excellence,40,54,94,2015-16
0345111,0340011,Danbury School District,Broadview Middle School,512,527,1039,2015-16
0340111,0340011,Danbury School District,DPS Early Childhood Center,60,81,141,2015-16
0346111,0340011,Danbury School District,Danbury High School,1407,1534,2941,2015-16
0341411,0340011,Danbury School District,Ellsworth Avenue School,201,231,432,2015-16
0341111,0340011,Danbury School District,Great Plain School,162,192,354,2015-16
0340211,0340011,Danbury School District,Hayestown Avenue School,218,252,470,2015-16
0341711,0340011,Danbury School District,King Street Intermediate School,184,185,369,2015-16
0341311,0340011,Danbury School District,King Street Primary School,202,207,409,2015-16
0340511,0340011,Danbury School District,Mill Ridge Primary School,177,173,350,2015-16
0340611,0340011,Danbury School District,Morris Street School,184,173,357,2015-16
0340811,0340011,Danbury School District,Park Avenue School,276,319,595,2015-16
0341511,0340011,Danbury School District,Pembroke School,164,204,368,2015-16
0345211,0340011,Danbury School District,Rogers Park Middle School,476,462,938,2015-16
0341211,0340011,Danbury School District,Shelter Rock School,249,271,520,2015-16
0341011,0340011,Danbury School District,South Street School,194,184,378,2015-16
0341611,0340011,Danbury School District,Stadley Rough School,233,263,496,2015-16
0341911,0340011,Danbury School District,Western CT Academy of International Studies Elementary Magnet School,222,168,390,2015-16
0340311,0340011,Danbury School District,Westside Middle School Academy,236,260,496,2015-16
0356111,0350011,Darien School District,Darien High School,656,700,1356,2015-16
0350211,0350011,Darien School District,Hindley Elementary School,246,255,501,2015-16
0350711,0350011,Darien School District,Holmes Elementary School,242,220,462,2015-16
0355111,0350011,Darien School District,Middlesex Middle School,546,621,1167,2015-16
0351311,0350011,Darien School District,Ox Ridge Elementary School,210,248,458,2015-16
0350511,0350011,Darien School District,Royle Elementary School,205,228,433,2015-16
0350611,0350011,Darien School District,Tokeneke Elementary School,254,225,479,2015-16
0360111,0360011,Deep River School District,Deep River Elementary School,144,160,304,2015-16
3370215,3370015,Department of Mental Health and Addiction Services,Connecticut Valley Hospital,*,*,*,2015-16
0370611,0370011,Derby School District,Bradley School,173,174,347,2015-16
0376111,0370011,Derby School District,Derby High School,147,197,344,2015-16
0375011,0370011,Derby School District,Derby Middle School,158,174,332,2015-16
0370411,0370011,Derby School District,Irving School,160,168,328,2015-16
0370111,0370011,Derby School District,Little Raiders University,13,20,33,2015-16
0370511,0370011,Derby School District,RAISE Academy,0,*,*,2015-16
0400111,0400011,East Granby School District,Allgrove School,104,102,206,2015-16
0406111,0400011,East Granby School District,East Granby High School,128,136,264,2015-16
0405111,0400011,East Granby School District,East Granby Middle School,101,95,196,2015-16
0400211,0400011,East Granby School District,R. Dudley Seymour School,96,106,202,2015-16
0410111,0410011,East Haddam School District,East Haddam Elementary School,152,157,309,2015-16
0416111,0410011,East Haddam School District,Nathan Hale-Ray High School,173,148,321,2015-16
0415111,0410011,East Haddam School District,Nathan Hale-Ray Middle School,200,231,431,2015-16
0420311,0420011,East Hampton School District,Center School,144,153,297,2015-16
0426111,0420011,East Hampton School District,East Hampton High School,270,245,515,2015-16
0425111,0420011,East Hampton School District,East Hampton Middle School,201,232,433,2015-16
0420111,0420011,East Hampton School District,Memorial School,321,316,637,2015-16
0429011,0420011,East Hampton School District,The Learning Center at East Hampton,*,*,6,2015-16
0430911,0430011,East Hartford School District,Anna E. Norris School,147,165,312,2015-16
0436311,0430011,East Hartford School District,Connecticut IB Academy,123,69,192,2015-16
0430611,0430011,East Hartford School District,Dr. Franklin H. Mayberry School,181,175,356,2015-16
0432211,0430011,East Hartford School District,Dr. John A. Langford School,142,180,322,2015-16
0431011,0430011,East Hartford School District,Dr. Thomas S. O'Connell School,257,252,509,2015-16
0436211,0430011,East Hartford School District,East Hartford High School,801,848,1649,2015-16
0435111,0430011,East Hartford School District,East Hartford Middle School,519,555,1074,2015-16
0432011,0430011,East Hartford School District,Governor William Pitkin School,173,171,344,2015-16
0430511,0430011,East Hartford School District,Hockanum School,166,170,336,2015-16
0430411,0430011,East Hartford School District,Joseph O. Goodwin School,137,161,298,2015-16
0431811,0430011,East Hartford School District,Robert J. O'Brien School,230,245,475,2015-16
0431211,0430011,East Hartford School District,Silver Lane School,137,137,274,2015-16
0436411,0430011,East Hartford School District,Stevens Alternate High School,41,69,110,2015-16
0432411,0430011,East Hartford School District,Sunset Ridge Middle School,103,101,204,2015-16
0438011,0430011,East Hartford School District,Willowbrook Early Childhood,105,124,229,2015-16
0439011,0430011,East Hartford School District,Woodland School,29,153,182,2015-16
0441711,0440011,East Haven School District,Carbone School/East Haven Academy,129,135,264,2015-16
0441411,0440011,East Haven School District,D. C. Moore School,99,108,207,2015-16
0440111,0440011,East Haven School District,Deer Run School,158,150,308,2015-16
0441311,0440011,East Haven School District,Dominick H. Ferrara School,102,87,189,2015-16
0446111,0440011,East Haven School District,East Haven High School,428,461,889,2015-16
0441011,0440011,East Haven School District,Grove J. Tuttle School,97,75,172,2015-16
0445111,0440011,East Haven School District,Joseph Melillo Middle School,277,312,589,2015-16
0440711,0440011,East Haven School District,Momauguin School,92,94,186,2015-16
0441811,0440011,East Haven School District,Overbrook Elementary School,68,98,166,2015-16
0450511,0450011,East Lyme School District,Abilities in Motion (AIM) Program,*,*,16,2015-16
0450611,0450011,East Lyme School District,Coastal Connections,7,12,19,2015-16
0456111,0450011,East Lyme School District,East Lyme High School,529,516,1045,2015-16
0455111,0450011,East Lyme School District,East Lyme Middle School,409,439,848,2015-16
0450111,0450011,East Lyme School District,Flanders School,161,182,343,2015-16
0458011,0450011,East Lyme School District,Integrated Preschool,31,27,58,2015-16
0450411,0450011,East Lyme School District,Lillie B. Haynes School,137,153,290,2015-16
0450711,0450011,East Lyme School District,Medically Fragile Program (WAVES),*,*,*,2015-16
0450211,0450011,East Lyme School District,Niantic Center School,80,88,168,2015-16
0470111,0470011,East Windsor School District,Broad Brook Elementary School,180,201,381,2015-16
0476111,0470011,East Windsor School District,East Windsor High School,154,170,324,2015-16
0475411,0470011,East Windsor School District,East Windsor Middle School,182,206,388,2015-16
0470411,0470011,East Windsor School District,East Windsor Transition Program,*,0,*,2015-16
2536014,2530014,Eastern Connecticut Regional Educational Service Center (EASTCONN),Arts at the Capitol Theater Magnet School (ACT),100,29,129,2015-16
2539014,2530014,Eastern Connecticut Regional Educational Service Center (EASTCONN),EastConn Special Education,25,92,117,2015-16
2536114,2530014,Eastern Connecticut Regional Educational Service Center (EASTCONN),Quinebaug Middle College,106,73,179,2015-16
0390111,0390011,Eastford School District,Eastford Elementary School,64,70,134,2015-16
0465111,0460011,Easton School District,Helen Keller Middle School,138,171,309,2015-16
0460111,0460011,Easton School District,Samuel Staples Elementary School,301,311,612,2015-16
2428014,2420014,EdAdvance,EdAdvance Headstart,122,91,213,2015-16
2429014,2420014,EdAdvance,The ACCESS School at The Danuta M. Thibodeau Education Center,6,8,14,2015-16
0480111,0480011,Ellington School District,Center School,178,183,361,2015-16
0480211,0480011,Ellington School District,Crystal Lake School,87,114,201,2015-16
0486111,0480011,Ellington School District,Ellington High School,397,374,771,2015-16
0485111,0480011,Ellington School District,Ellington Middle School,191,229,420,2015-16
0480711,0480011,Ellington School District,Windermere Intermediate School,227,219,446,2015-16
0480611,0480011,Ellington School District,Windermere School,220,210,430,2015-16
0480311,0480011,Ellington School District,Windermere School Program for Alternative Learning K-5,0,*,*,2015-16
2890113,2890013,Elm City College Preparatory School District,Elm City College Preparatory School,384,319,703,2015-16
2910113,2910013,Elm City Montessori School District,Elm City Montessori School,55,58,113,2015-16
0491011,0490011,Enfield School District,EPS PK STEAM Academy,21,15,36,2015-16
0490511,0490011,Enfield School District,Edgar H. Parkman - Autism Spectrum Disorder (ASD),*,*,*,2015-16
0491311,0490011,Enfield School District,Edgar H. Parkman School,158,165,323,2015-16
0491411,0490011,Enfield School District,Eli Whitney - Intermediate Adaptive Learning (IAL),*,0,*,2015-16
0491611,0490011,Enfield School District,Eli Whitney School,213,198,411,2015-16
0496111,0490011,Enfield School District,Enfield High School,359,356,715,2015-16
0490311,0490011,Enfield School District,Enfield Street - Autism Spectrum Disorder (ASD),*,*,8,2015-16
0490211,0490011,Enfield School District,Enfield Street School,136,140,276,2015-16
0499011,0490011,Enfield School District,Enfield Transitional Learning Academy,*,*,6,2015-16
0496211,0490011,Enfield School District,Enrico Fermi High School,417,444,861,2015-16
0490411,0490011,Enfield School District,Hazardville Memorial School,155,189,344,2015-16
0498011,0490011,Enfield School District,Head Start Program,48,56,104,2015-16
0490611,0490011,Enfield School District,Henry Barnard - Educational Counseling Program (ECP),0,*,*,2015-16
0491811,0490011,Enfield School District,Henry Barnard School,163,201,364,2015-16
0495211,0490011,Enfield School District,John F. Kennedy Middle School,534,531,1065,2015-16
0490811,0490011,Enfield School District,Nathan Hale - Primary Adaptive Learning (PAL),*,*,6,2015-16
0491111,0490011,Enfield School District,Nathan Hale School,100,122,222,2015-16
0490711,0490011,Enfield School District,Prudence Crandall - Educational Counseling Program (ECP),0,*,*,2015-16
0491511,0490011,Enfield School District,Prudence Crandall School,209,203,412,2015-16
0500111,0500011,Essex School District,Essex Elementary School,199,218,417,2015-16
2726113,2720013,Explorations District,Explorations,58,34,92,2015-16
0510211,0510011,Fairfield School District,Burr Elementary School,200,218,418,2015-16
0510111,0510011,Fairfield School District,Dwight Elementary School,155,180,335,2015-16
0518011,0510011,Fairfield School District,Early Childhood Center,40,72,112,2015-16
0516011,0510011,Fairfield School District,Fairfield Ludlowe High School,775,733,1508,2015-16
0516211,0510011,Fairfield School District,Fairfield Warde High School,761,757,1518,2015-16
0515211,0510011,Fairfield School District,Fairfield Woods Middle School,421,465,886,2015-16
0510411,0510011,Fairfield School District,Holland Hill School,209,196,405,2015-16
0511711,0510011,Fairfield School District,Jennings School,125,195,320,2015-16
0510611,0510011,Fairfield School District,McKinley School,218,208,426,2015-16
0510711,0510011,Fairfield School District,Mill Hill School,192,190,382,2015-16
0511611,0510011,Fairfield School District,North Stratfield School,201,214,415,2015-16
0511811,0510011,Fairfield School District,Osborn Hill School,231,258,489,2015-16
0511211,0510011,Fairfield School District,Riverfield School,200,208,408,2015-16
0515311,0510011,Fairfield School District,Roger Ludlowe Middle School,404,398,802,2015-16
0511311,0510011,Fairfield School District,Sherman School,247,232,479,2015-16
0511411,0510011,Fairfield School District,Stratfield School,205,235,440,2015-16
0515111,0510011,Fairfield School District,Tomlinson Middle School,342,343,685,2015-16
0510311,0510011,Fairfield School District,Walter Fitzgerald Campus,10,16,26,2015-16
0520411,0520011,Farmington School District,East Farms School,218,225,443,2015-16
0520611,0520011,Farmington School District,Farmington Alternative High School,*,*,12,2015-16
0528011,0520011,Farmington School District,Farmington Collaborative PK,54,69,123,2015-16
0526111,0520011,Farmington School District,Farmington High School,551,669,1220,2015-16
0525111,0520011,Farmington School District,Irving A. Robbins Middle School,325,298,623,2015-16
0520211,0520011,Farmington School District,Noah Wallace School,185,178,363,2015-16
0520111,0520011,Farmington School District,Union School,160,162,322,2015-16
0520311,0520011,Farmington School District,West District School,146,154,300,2015-16
0520511,0520011,Farmington School District,West Woods Upper Elementary School,329,334,663,2015-16
0530111,0530011,Franklin School District,Franklin Elementary School,75,92,167,2015-16
0540211,0540011,Glastonbury School District,Buttonball Lane School,229,230,459,2015-16
0540311,0540011,Glastonbury School District,Eastbury School,132,124,256,2015-16
0540811,0540011,Glastonbury School District,Gideon Welles School,232,247,479,2015-16
0546111,0540011,Glastonbury School District,Glastonbury High School,1062,975,2037,2015-16
0540411,0540011,Glastonbury School District,Hebron Avenue School,197,203,400,2015-16
0540611,0540011,Glastonbury School District,Hopewell School,190,196,386,2015-16
0540111,0540011,Glastonbury School District,Links Academy,7,12,19,2015-16
0541411,0540011,Glastonbury School District,Links Transition,*,*,15,2015-16
0540711,0540011,Glastonbury School District,Naubuc School,178,183,361,2015-16
0540911,0540011,Glastonbury School District,Nayaug Elementary School,286,267,553,2015-16
0540511,0540011,Glastonbury School District,PreK-Eastbury,10,20,30,2015-16
0541011,0540011,Glastonbury School District,PreK-Nayaug,7,12,19,2015-16
0545211,0540011,Glastonbury School District,Smith Middle School,538,498,1036,2015-16
0560111,0560011,Granby School District,Frank M. Kearns Primary School,208,200,408,2015-16
0566111,0560011,Granby School District,Granby Memorial High School,328,366,694,2015-16
0565111,0560011,Granby School District,Granby Memorial Middle School,148,164,312,2015-16
0560411,0560011,Granby School District,Kelly Lane Primary School,142,129,271,2015-16
0560311,0560011,Granby School District,Wells Road Intermediate School,128,133,261,2015-16
2940113,2940013,Great Oaks Charter School District,Great Oaks Charter School,112,114,226,2015-16
0575111,0570011,Greenwich School District,Central Middle School,266,301,567,2015-16
0571211,0570011,Greenwich School District,Community Connections,*,*,*,2015-16
0570211,0570011,Greenwich School District,Cos Cob School,212,225,437,2015-16
0575211,0570011,Greenwich School District,Eastern Middle School,398,424,822,2015-16
0570411,0570011,Greenwich School District,Glenville School,229,222,451,2015-16
0571411,0570011,Greenwich School District,Greenwich Alternative High School,13,19,32,2015-16
0576111,0570011,Greenwich School District,Greenwich High School,1263,1271,2534,2015-16
0570511,0570011,Greenwich School District,Hamilton Avenue School,179,185,364,2015-16
0571311,0570011,Greenwich School District,International School At Dundee,187,181,368,2015-16
0570311,0570011,Greenwich School District,Julian Curtiss School,176,185,361,2015-16
0570611,0570011,Greenwich School District,New Lebanon School,121,144,265,2015-16
0570711,0570011,Greenwich School District,North Mianus School,224,258,482,2015-16
0570811,0570011,Greenwich School District,North Street School,180,212,392,2015-16
0570911,0570011,Greenwich School District,Old Greenwich School,221,228,449,2015-16
0571111,0570011,Greenwich School District,Parkway School,119,142,261,2015-16
0571011,0570011,Greenwich School District,Riverside School,217,266,483,2015-16
0575311,0570011,Greenwich School District,Western Middle School,253,282,535,2015-16
0580111,0580011,Griswold School District,Griswold Alternative School,*,*,14,2015-16
0580311,0580011,Griswold School District,Griswold Elementary School,356,401,757,2015-16
0586211,0580011,Griswold School District,Griswold High School,292,273,565,2015-16
0585111,0580011,Griswold School District,Griswold Middle School,279,266,545,2015-16
0595311,0590011,Groton School District,Carl C. Cutler Middle School,234,261,495,2015-16
0592011,0590011,Groton School District,Catherine Kolnaski Magnet School,182,214,396,2015-16
0591811,0590011,Groton School District,Charles Barnum School,180,203,383,2015-16
0590311,0590011,Groton School District,Claude Chester School,176,155,331,2015-16
0591711,0590011,Groton School District,Mary Morrisson School,195,181,376,2015-16
0590211,0590011,Groton School District,New Beginnings Alternative Program,9,13,22,2015-16
0591911,0590011,Groton School District,Northeast Academy Elementary School,173,206,379,2015-16
0591211,0590011,Groton School District,Pleasant Valley School,149,147,296,2015-16
0596111,0590011,Groton School District,Robert E. Fitch High School,507,563,1070,2015-16
0590111,0590011,Groton School District,S. B. Butler School,133,149,282,2015-16
0590611,0590011,Groton School District,Virtual Learning Academy,0,*,*,2015-16
0595211,0590011,Groton School District,West Side Middle School,231,224,455,2015-16
0600711,0600011,Guilford School District,A. Baldwin Middle School,268,291,559,2015-16
0600611,0600011,Guilford School District,A. W. Cox School,141,161,302,2015-16
0600411,0600011,Guilford School District,Calvin Leete School,101,153,254,2015-16
0605111,0600011,Guilford School District,E. C. Adams Middle School,277,275,552,2015-16
0606111,0600011,Guilford School District,Guilford High School,533,550,1083,2015-16
0600211,0600011,Guilford School District,Guilford Lakes School,153,169,322,2015-16
0600311,0600011,Guilford School District,Melissa Jones School,163,158,321,2015-16
0628011,0620011,Hamden School District,Alice Peck Learning Center,46,104,150,2015-16
0621211,0620011,Hamden School District,Bear Path School,217,239,456,2015-16
0620211,0620011,Hamden School District,Church Street School,161,172,333,2015-16
0620311,0620011,Hamden School District,Dunbar Hill School,121,153,274,2015-16
0620511,0620011,Hamden School District,Hamden Collaborative Learning Center,19,54,73,2015-16
0626111,0620011,Hamden School District,Hamden High School,767,831,1598,2015-16
0625211,0620011,Hamden School District,Hamden Middle School,405,411,816,2015-16
0620411,0620011,Hamden School District,Helen Street School,147,169,316,2015-16
0621111,0620011,Hamden School District,Ridge Hill School,153,164,317,2015-16
0620111,0620011,Hamden School District,Shepherd Glen School,138,166,304,2015-16
0621011,0620011,Hamden School District,Spring Glen School,223,222,445,2015-16
0621411,0620011,Hamden School District,West Woods School,202,206,408,2015-16
0630111,0630011,Hampton School District,Hampton Elementary School,40,61,101,2015-16
0640711,0640011,Hartford School District,Asian Studies Academy at Bellizzi School,296,353,649,2015-16
0648611,0640011,Hartford School District,Autism Program - Burr School,*,*,9,2015-16
0644311,0640011,Hartford School District,Autism Program - Hooker School,*,*,*,2015-16
0645711,0640011,Hartford School District,Autism Program - Naylor School,*,*,8,2015-16
0644411,0640011,Hartford School District,Autism Program - Rawson School,*,*,45,2015-16
0649311,0640011,Hartford School District,Autism Program - Simpson-Waverly School,*,*,14,2015-16
0640411,0640011,Hartford School District,Batchelder School,211,267,478,2015-16
0642811,0640011,Hartford School District,Betances Early Reading Lab Magnet School,141,138,279,2015-16
0643811,0640011,Hartford School District,Betances STEM Magnet School,118,191,309,2015-16
0643511,0640011,Hartford School District,Breakthrough II Magnet School,141,139,280,2015-16
0643311,0640011,Hartford School District,Breakthrough Magnet School,191,164,355,2015-16
0647111,0640011,Hartford School District,Bulkeley High School,173,206,379,2015-16
0646111,0640011,Hartford School District,Bulkeley High School Lower School,179,233,412,2015-16
0640611,0640011,Hartford School District,Burns Latino Studies Academy,242,278,520,2015-16
0642311,0640011,Hartford School District,Burr School,270,320,590,2015-16
0643911,0640011,Hartford School District,Capital Community College Magnet Academy,42,14,56,2015-16
0646911,0640011,Hartford School District,Capital Preparatory Magnet School,308,321,629,2015-16
0642411,0640011,Hartford School District,Clark School,132,114,246,2015-16
0646411,0640011,Hartford School District,Classical Magnet School,361,302,663,2015-16
0646011,0640011,Hartford School District,Culinary Arts Academy at Weaver High School,133,152,285,2015-16
0649411,0640011,Hartford School District,DDP - Simpson-Waverly School,0,*,*,2015-16
0645811,0640011,Hartford School District,EDP - Betances School,*,*,17,2015-16
0648311,0640011,Hartford School District,EDP - Bulkeley High School,*,*,15,2015-16
0648211,0640011,Hartford School District,EDP - HPHS Engineering and Green Technology Academy,*,*,29,2015-16
0645911,0640011,Hartford School District,EDP - M.D. Fox School,6,28,34,2015-16
0648111,0640011,Hartford School District,EDP - McDonough Middle School,*,*,9,2015-16
0644111,0640011,Hartford School District,Early Childhood Development Center (ECDC),7,21,28,2015-16
0640911,0640011,Hartford School District,Environmental Sciences Magnet at Hooker School,272,341,613,2015-16
0643211,0640011,Hartford School District,Expeditionary Learning Academy at Moylan School,260,272,532,2015-16
0643611,0640011,Hartford School District,Global Communications Academy,348,313,661,2015-16
0647911,0640011,Hartford School District,Great Path Academy at MCC,162,106,268,2015-16
0647211,0640011,Hartford School District,HPHS Engineering and Green Technology Academy,58,246,304,2015-16
0647411,0640011,Hartford School District,HPHS Law and Government Academy,157,210,367,2015-16
0647511,0640011,Hartford School District,HPHS Nursing and Health Sciences Academy,261,101,362,2015-16
0645411,0640011,Hartford School District,Hartford Magnet Trinity College Academy,562,460,1022,2015-16
0641311,0640011,Hartford School District,Hartford PreKindergarten Magnet School,74,69,143,2015-16
0647611,0640011,Hartford School District,"High School, Inc.",105,128,233,2015-16
0648411,0640011,Hartford School District,High Step Transition,7,9,16,2015-16
0647711,0640011,Hartford School District,Journalism and Media Academy Magnet School,133,74,207,2015-16
0641011,0640011,Hartford School District,Kennelly School,274,297,571,2015-16
0641111,0640011,Hartford School District,Kinsella Magnet School of Performing Arts,586,324,910,2015-16
0649511,0640011,Hartford School District,LC - Breakthrough II School,*,0,*,2015-16
0649611,0640011,Hartford School District,LC - Burns School,*,*,8,2015-16
0649811,0640011,Hartford School District,LC - Moylan School,*,*,*,2015-16
0640811,0640011,Hartford School District,M. D. Fox School,312,309,621,2015-16
0641611,0640011,Hartford School District,"M. L. King, Jr. School",157,199,356,2015-16
0644811,0640011,Hartford School District,MDP - Batchelder School,9,8,17,2015-16
0645011,0640011,Hartford School District,MDP - Bulkeley High School,*,*,17,2015-16
0644911,0640011,Hartford School District,MDP - HPHS Law and Government Academy,11,16,27,2015-16
0648511,0640011,Hartford School District,MDP - Moylan School,*,*,11,2015-16
0641211,0640011,Hartford School District,McDonough Middle School,116,123,239,2015-16
0641911,0640011,Hartford School District,Milner School,178,156,334,2015-16
0643711,0640011,Hartford School District,Montessori Magnet at Fisher School,178,162,340,2015-16
0640511,0640011,Hartford School District,Montessori Magnet at Moylan School,140,119,259,2015-16
0641411,0640011,Hartford School District,Naylor/CCSU Leadership Academy,325,335,660,2015-16
0641511,0640011,Hartford School District,Parkville Community School,254,283,537,2015-16
0646611,0640011,Hartford School District,Pathways Academy of Technology and Design,124,295,419,2015-16
0641711,0640011,Hartford School District,Rawson School,176,197,373,2015-16
0644011,0640011,Hartford School District,Renzulli Gifted and Talented Academy,55,44,99,2015-16
0640111,0640011,Hartford School District,SAND School,184,210,394,2015-16
0642511,0640011,Hartford School District,STEM Magnet at Fisher School,150,217,367,2015-16
0643011,0640011,Hartford School District,Sanchez School,255,225,480,2015-16
0642611,0640011,Hartford School District,Simpson-Waverly School,155,138,293,2015-16
0646511,0640011,Hartford School District,Sports and Medical Sciences Academy,307,400,707,2015-16
0646711,0640011,Hartford School District,University High School of Science and Engineering,140,291,431,2015-16
0642011,0640011,Hartford School District,Webster Micro Society Magnet School,323,337,660,2015-16
0642111,0640011,Hartford School District,West Middle School,171,188,359,2015-16
0642211,0640011,Hartford School District,Wish Museum School,154,150,304,2015-16
0650111,0650011,Hartland School District,Hartland School,81,106,187,2015-16
0670211,0670011,Hebron School District,Gilead Hill School,137,157,294,2015-16
0670111,0670011,Hebron School District,Hebron Elementary School,204,232,436,2015-16
2860113,2860013,Highville Charter School District,Highville Charter School,240,222,462,2015-16
2640113,2640013,Integrated Day Charter School District,Integrated Day Charter School,163,168,331,2015-16
2655113,2650013,Interdistrict School for Arts and Comm District,Interdistrict School For Arts And Communication,136,135,271,2015-16
2610113,2610013,Jumoke Academy District,Jumoke Academy,397,337,734,2015-16
0680111,0680011,Kent School District,Kent Center School,108,129,237,2015-16
0698011,0690011,Killingly School District,Goodyear Early Childhood Center,57,73,130,2015-16
0690611,0690011,Killingly School District,Killingly Alternative Learning Program,9,7,16,2015-16
0690111,0690011,Killingly School District,Killingly Central School,171,206,377,2015-16
0696111,0690011,Killingly School District,Killingly High School,412,413,825,2015-16
0695211,0690011,Killingly School District,Killingly Intermediate School,344,344,688,2015-16
0690311,0690011,Killingly School District,Killingly Memorial School,259,225,484,2015-16
2456014,2450014,Learn,Connecticut River Academy,244,190,434,2015-16
2455014,2450014,Learn,Dual Language & Arts Magnet Middle School,77,68,145,2015-16
2451214,2450014,Learn,Learn ABA Program at Center School,*,*,*,2015-16
2451114,2450014,Learn,Learn Haynes Elementary Intensive Program,*,*,12,2015-16
2450614,2450014,Learn,Learn High School ABA,*,*,*,2015-16
2450914,2450014,Learn,Learn Kelly Middle School Intensive Program,*,*,*,2015-16
2450714,2450014,Learn,Learn Ledyard RICHES Program,*,*,*,2015-16
2450514,2450014,Learn,Learn Pathways Program,0,*,*,2015-16
2450814,2450014,Learn,Learn SAILS Middle School Program,0,*,*,2015-16
2451014,2450014,Learn,Learn SAILS Program at Salem,*,*,8,2015-16
2450414,2450014,Learn,Learn STS 18-21 Year Old Program,*,*,*,2015-16
2456114,2450014,Learn,Marine Science Magnet High School of Southeastern Connecticut,146,125,271,2015-16
2450114,2450014,Learn,Regional Multicultural Magnet School,267,268,535,2015-16
2450314,2450014,Learn,Riverside Magnet School at Goodwin College,185,185,370,2015-16
2450214,2450014,Learn,The Friendship School,262,243,505,2015-16
2456214,2450014,Learn,Three Rivers Middle College Magnet School,45,22,67,2015-16
0710111,0710011,Lebanon School District,Lebanon Elementary School,165,203,368,2015-16
0715111,0710011,Lebanon School District,Lebanon Middle School,150,150,300,2015-16
0716211,0710011,Lebanon School District,Lyman Memorial High School,203,174,377,2015-16
0720211,0720011,Ledyard School District,Gales Ferry School,117,107,224,2015-16
0720411,0720011,Ledyard School District,Gallup Hill School,163,174,337,2015-16
0720311,0720011,Ledyard School District,Juliet W. Long School,141,153,294,2015-16
0720111,0720011,Ledyard School District,Ledyard Center School,179,228,407,2015-16
0726111,0720011,Ledyard School District,Ledyard High School,453,380,833,2015-16
0725111,0720011,Ledyard School District,Ledyard Middle School,145,178,323,2015-16
0730111,0730011,Lisbon School District,Lisbon Central School,197,191,388,2015-16
0740211,0740011,Litchfield School District,Center School,125,145,270,2015-16
0746111,0740011,Litchfield School District,Litchfield High School,132,164,296,2015-16
0740311,0740011,Litchfield School District,Litchfield Intermediate School,103,117,220,2015-16
0746011,0740011,Litchfield School District,Litchfield Middle School,91,84,175,2015-16
0766111,0760011,Madison School District,Daniel Hand High School,567,597,1164,2015-16
0760611,0760011,Madison School District,Dr. Robert H. Brown Middle School,178,238,416,2015-16
0760211,0760011,Madison School District,Island Avenue Elementary School,130,138,268,2015-16
0760111,0760011,Madison School District,J. Milton Jeffrey Elementary School,156,182,338,2015-16
0760311,0760011,Madison School District,Kathleen H. Ryerson Elementary School,106,123,229,2015-16
0769011,0760011,Madison School District,Town Campus Learning Center,15,28,43,2015-16
0765211,0760011,Madison School District,Walter C. Polson Upper Middle School,277,279,556,2015-16
0770211,0770011,Manchester School District,Bentley Alternative Education Program,24,29,53,2015-16
0770111,0770011,Manchester School District,Bowers School,175,217,392,2015-16
0770311,0770011,Manchester School District,Buckley School,163,202,365,2015-16
0771711,0770011,Manchester School District,Elisabeth M. Bennet Academy,211,209,420,2015-16
0770411,0770011,Manchester School District,Highland Park School,138,124,262,2015-16
0775311,0770011,Manchester School District,Illing Middle School,388,392,780,2015-16
0770611,0770011,Manchester School District,Keeney School,185,169,354,2015-16
0776111,0770011,Manchester School District,Manchester High School,783,751,1534,2015-16
0770811,0770011,Manchester School District,Manchester Preschool - Site 2,*,*,16,2015-16
0778011,0770011,Manchester School District,Manchester Preschool Center,86,100,186,2015-16
0779011,0770011,Manchester School District,Manchester Regional Academy,20,47,67,2015-16
0779111,0770011,Manchester School District,Manchester Transition Center,*,*,13,2015-16
0771611,0770011,Manchester School District,Martin School,139,129,268,2015-16
0770711,0770011,Manchester School District,New Horizons,*,*,22,2015-16
0771011,0770011,Manchester School District,Robertson School,180,176,356,2015-16
0771211,0770011,Manchester School District,Verplanck School,186,200,386,2015-16
0771311,0770011,Manchester School District,Waddell School,184,193,377,2015-16
0771411,0770011,Manchester School District,Washington School,176,181,357,2015-16
0780411,0780011,Mansfield School District,Annie E. Vinton School,126,142,268,2015-16
0780211,0780011,Mansfield School District,Dorothy C. Goodwin School,96,111,207,2015-16
0785111,0780011,Mansfield School District,Mansfield Middle School,244,286,530,2015-16
0780511,0780011,Mansfield School District,Southeast Elementary School,136,106,242,2015-16
0790111,0790011,Marlborough School District,Elmer Thienes-Mary Hall Elementary School,255,301,556,2015-16
0800711,0800011,Meriden School District,Nathan Hale School,302,328,630,2015-16
0800111,0800011,Meriden School District,Benjamin Franklin School,172,174,346,2015-16
0801111,0800011,Meriden School District,Casimir Pulaski School,279,278,557,2015-16
0800211,0800011,Meriden School District,Community Classroom Collaborative-Meriden School District,*,*,11,2015-16
0806111,0800011,Meriden School District,Francis T. Maloney High School,568,609,1177,2015-16
0800311,0800011,Meriden School District,Hanover School,297,319,616,2015-16
0800411,0800011,Meriden School District,Israel Putnam School,313,275,588,2015-16
0800511,0800011,Meriden School District,John Barry School,230,246,476,2015-16
0805211,0800011,Meriden School District,Lincoln Middle School,390,353,743,2015-16
0806211,0800011,Meriden School District,Orville H. Platt High School,495,518,1013,2015-16
0800811,0800011,Meriden School District,Roger Sherman School,249,310,559,2015-16
0800611,0800011,Meriden School District,STARS-Meriden School District,7,32,39,2015-16
0800911,0800011,Meriden School District,STEP-Meriden School District,*,*,19,2015-16
0801211,0800011,Meriden School District,Steps-Meriden School District,*,*,16,2015-16
0801011,0800011,Meriden School District,Thomas Hooker School,199,222,421,2015-16
0801311,0800011,Meriden School District,Venture Academy-Meriden School District,8,34,42,2015-16
0805411,0800011,Meriden School District,Washington Middle School,325,349,674,2015-16
0830211,0830011,Middletown School District,Bielefield School,148,141,289,2015-16
0831611,0830011,Middletown School District,Evening Program - MHS,*,*,11,2015-16
0830511,0830011,Middletown School District,Farm Hill School,186,151,337,2015-16
0830611,0830011,Middletown School District,ICM - Farm Hill,0,*,*,2015-16
0830711,0830011,Middletown School District,ICM - Lawrence,0,*,*,2015-16
0832011,0830011,Middletown School District,ICM - Spencer,*,*,7,2015-16
0830811,0830011,Middletown School District,ICM - Wesley,*,*,*,2015-16
0830411,0830011,Middletown School District,ICM- Woodrow Wilson Middle School,*,*,6,2015-16
0831511,0830011,Middletown School District,Keigwin Middle School,139,173,312,2015-16
0831311,0830011,Middletown School District,Lawrence School,139,141,280,2015-16
0831811,0830011,Middletown School District,MHS - Alternative Education Program 1,*,*,8,2015-16
0831911,0830011,Middletown School District,MHS - Alternative Education Program 2,0,7,7,2015-16
0832211,0830011,Middletown School District,MHS- Alternative Education Program 3,*,*,*,2015-16
0830911,0830011,Middletown School District,MacDonough School,102,106,208,2015-16
0836211,0830011,Middletown School District,Middletown High School,589,613,1202,2015-16
0831211,0830011,Middletown School District,Moody School,122,139,261,2015-16
0830311,0830011,Middletown School District,OASIS,0,*,*,2015-16
0832111,0830011,Middletown School District,STEM - Macdonough,13,7,20,2015-16
0831111,0830011,Middletown School District,Snow School,178,215,393,2015-16
0830111,0830011,Middletown School District,Spencer School,134,159,293,2015-16
0839111,0830011,Middletown School District,Transition to Life Center,6,19,25,2015-16
0831711,0830011,Middletown School District,Virtual Learning Academy - MHS,*,*,11,2015-16
0831411,0830011,Middletown School District,Wesley School,125,142,267,2015-16
0835411,0830011,Middletown School District,Woodrow Wilson Middle School,353,317,670,2015-16
0840111,0840011,Milford School District,Calf Pen Meadow School,146,147,293,2015-16
0845111,0840011,Milford School District,East Shore Middle School,235,221,456,2015-16
0845211,0840011,Milford School District,Harborside Middle School,231,305,536,2015-16
0841911,0840011,Milford School District,J. F. Kennedy School,180,198,378,2015-16
0846211,0840011,Milford School District,Jonathan Law High School,469,471,940,2015-16
0846311,0840011,Milford School District,Joseph A. Foran High School,442,478,920,2015-16
0841611,0840011,Milford School District,Live Oaks School,158,157,315,2015-16
0841711,0840011,Milford School District,Mathewson School,191,223,414,2015-16
0840711,0840011,Milford School District,Meadowside School,161,154,315,2015-16
0840811,0840011,Milford School District,Orange Avenue School,173,236,409,2015-16
0841811,0840011,Milford School District,Orchard Hills School,171,199,370,2015-16
0841011,0840011,Milford School District,Pumpkin Delight School,131,149,280,2015-16
0840311,0840011,Milford School District,The Academy,17,30,47,2015-16
0845311,0840011,Milford School District,West Shore Middle School,217,233,450,2015-16
0850511,0850011,Monroe School District,Fawn Hollow Elementary School,239,258,497,2015-16
0855211,0850011,Monroe School District,Jockey Hollow School,379,401,780,2015-16
0850211,0850011,Monroe School District,Masuk Alternative Program,*,*,13,2015-16
0856111,0850011,Monroe School District,Masuk High School,533,559,1092,2015-16
0850111,0850011,Monroe School District,Monroe Elementary School,182,172,354,2015-16
0850411,0850011,Monroe School District,REAL,0,*,*,2015-16
0850311,0850011,Monroe School District,Stepney Elementary School,226,204,430,2015-16
0860711,0860011,Montville School District,Dr. Charles E. Murphy School,161,181,342,2015-16
0865111,0860011,Montville School District,Leonard J. Tyl Middle School,266,285,551,2015-16
0860111,0860011,Montville School District,Mohegan School,166,167,333,2015-16
0866111,0860011,Montville School District,Montville High School,341,313,654,2015-16
0860511,0860011,Montville School District,Oakdale School,132,165,297,2015-16
0869011,0860011,Montville School District,Palmer Academy,8,20,28,2015-16
0860311,0860011,Montville School District,Pre School Program,17,23,40,2015-16
0880811,0880011,Naugatuck School District,Andrew Avenue School,133,139,272,2015-16
0888211,0880011,Naugatuck School District,Central Avenue Preschool,7,23,30,2015-16
0885111,0880011,Naugatuck School District,City Hill Middle School,296,379,675,2015-16
0880211,0880011,Naugatuck School District,Cross Street Intermediate School,146,166,312,2015-16
0880911,0880011,Naugatuck School District,Genesis Academy,*,*,11,2015-16
0888111,0880011,Naugatuck School District,Head Start,69,49,118,2015-16
0880411,0880011,Naugatuck School District,Hillside Intermediate School,143,169,312,2015-16
0880511,0880011,Naugatuck School District,Hop Brook Elementary School,134,176,310,2015-16
0880311,0880011,Naugatuck School District,Maple Hill School,211,239,450,2015-16
0886111,0880011,Naugatuck School District,Naugatuck High School,554,644,1198,2015-16
0880611,0880011,Naugatuck School District,Salem School,123,143,266,2015-16
0880711,0880011,Naugatuck School District,Western School,137,144,281,2015-16
2800113,2800013,New Beginnings Inc Family Academy District,New Beginnings Inc Family Academy,248,251,499,2015-16
0891011,0890011,New Britain School District,Behavior Support (Holmes),*,*,11,2015-16
0899111,0890011,New Britain School District,Brook Side School,19,32,51,2015-16
0899411,0890011,New Britain School District,CLIMB,6,12,18,2015-16
0890311,0890011,New Britain School District,Chamberlain  Elementary School,231,236,467,2015-16
0891111,0890011,New Britain School District,Frank J. DiLoreto School,419,372,791,2015-16
0890511,0890011,New Britain School District,Gaffney School,249,329,578,2015-16
0890611,0890011,New Britain School District,Holmes School,220,241,461,2015-16
0895411,0890011,New Britain School District,House of Arts Letters and Science (HALS)  Academy,72,77,149,2015-16
0890711,0890011,New Britain School District,Jefferson School,220,222,442,2015-16
0891611,0890011,New Britain School District,KEY Elementary (Gaffney),12,32,44,2015-16
0891711,0890011,New Britain School District,KEY Middle (Slade),0,12,12,2015-16
0890811,0890011,New Britain School District,Lincoln School,326,362,688,2015-16
0896111,0890011,New Britain School District,New Britain High School,1177,1283,2460,2015-16
0899011,0890011,New Britain School District,New Britain Transition Center,13,25,38,2015-16
0890911,0890011,New Britain School District,Northend School,144,141,285,2015-16
0895311,0890011,New Britain School District,Pulaski Middle School,337,429,766,2015-16
0890111,0890011,New Britain School District,Roosevelt Early Learning Center,61,76,137,2015-16
0895211,0890011,New Britain School District,Slade Middle School,333,400,733,2015-16
0891211,0890011,New Britain School District,Smalley Academy,327,351,678,2015-16
0891311,0890011,New Britain School District,Smith School,280,300,580,2015-16
0891811,0890011,New Britain School District,Steps,*,*,36,2015-16
0890411,0890011,New Britain School District,Sunrise Intermediate (Holmes),0,12,12,2015-16
0890211,0890011,New Britain School District,Sunrise Primary (Chamberlain),*,*,22,2015-16
0891511,0890011,New Britain School District,Vance School,261,262,523,2015-16
0900411,0900011,New Canaan School District,East School,253,290,543,2015-16
0906111,0900011,New Canaan School District,New Canaan High School,628,623,1251,2015-16
0905111,0900011,New Canaan School District,Saxe Middle School,652,675,1327,2015-16
0900211,0900011,New Canaan School District,South School,268,274,542,2015-16
0900311,0900011,New Canaan School District,West School,270,277,547,2015-16
0910311,0910011,New Fairfield School District,Alternative Learning Center,*,*,8,2015-16
0910111,0910011,New Fairfield School District,Consolidated School,246,255,501,2015-16
0910211,0910011,New Fairfield School District,Meeting House Hill School,228,262,490,2015-16
0916111,0910011,New Fairfield School District,New Fairfield High School,408,496,904,2015-16
0915211,0910011,New Fairfield School District,New Fairfield Middle School,290,297,587,2015-16
0920311,0920011,New Hartford School District,Ann Antolini School,154,142,296,2015-16
0920111,0920011,New Hartford School District,Bakerville Consolidated School,55,58,113,2015-16
0920211,0920011,New Hartford School District,New Hartford Elementary School,34,27,61,2015-16
0931211,0930011,New Haven School District,Edgewood School,221,216,437,2015-16
0931411,0930011,New Haven School District,Nathan Hale School,254,270,524,2015-16
0931511,0930011,New Haven School District,Augusta Lewis Troup School,222,260,482,2015-16
0930211,0930011,New Haven School District,Barnard Environmental Magnet School,285,278,563,2015-16
0930311,0930011,New Haven School District,Beecher School,243,262,505,2015-16
0931811,0930011,New Haven School District,Benjamin Jepson Magnet School,248,282,530,2015-16
0935511,0930011,New Haven School District,Betsy Ross Arts Magnet School,299,157,456,2015-16
0934311,0930011,New Haven School District,Bishop Woods Architecture and Design Magnet School,259,222,481,2015-16
0932411,0930011,New Haven School District,Blake Street Leadership Academy (STEP),7,9,16,2015-16
0932111,0930011,New Haven School District,Brennan Rogers School,226,266,492,2015-16
0934811,0930011,New Haven School District,"Celentano BioTech, Health and Medical Magnet School",183,185,368,2015-16
0930611,0930011,New Haven School District,Clinton Avenue School,263,314,577,2015-16
0934111,0930011,New Haven School District,Columbus Family Academy,226,235,461,2015-16
0933111,0930011,New Haven School District,Conte/West Hills Magnet School,329,308,637,2015-16
0936411,0930011,New Haven School District,Cooperative High School,455,192,647,2015-16
0936811,0930011,New Haven School District,Cortlandt V.R. Creed Health and Sport Sciences High School,63,131,194,2015-16
0930911,0930011,New Haven School District,Davis 21st Century Magnet Elementary School,262,235,497,2015-16
0935611,0930011,New Haven School District,Domus Academy,6,23,29,2015-16
0938111,0930011,New Haven School District,Early Learning Center,66,57,123,2015-16
0934611,0930011,New Haven School District,East Rock Community Magnet School,248,228,476,2015-16
0931711,0930011,New Haven School District,Engineering - Science University Magnet School,187,417,604,2015-16
0931611,0930011,New Haven School District,Fair Haven School,388,377,765,2015-16
0938011,0930011,New Haven School District,Headstart,164,203,367,2015-16
0938311,0930011,New Haven School District,Helene Grant HeadStart,112,154,266,2015-16
0936611,0930011,New Haven School District,High School In The Community,148,103,251,2015-16
0930711,0930011,New Haven School District,Hill Central Music Academy,235,260,495,2015-16
0936311,0930011,New Haven School District,Hill Regional Career High School,375,290,665,2015-16
0936211,0930011,New Haven School District,James Hillhouse High School,437,508,945,2015-16
0931311,0930011,New Haven School District,John C. Daniels,248,280,528,2015-16
0930811,0930011,New Haven School District,John S. Martinez Sea and Sky STEM School,249,276,525,2015-16
0933011,0930011,New Haven School District,King/Robinson Magnet School,277,282,559,2015-16
0932011,0930011,New Haven School District,Lincoln-Bassett School,189,189,378,2015-16
0931911,0930011,New Haven School District,Mauro-Sheridan Magnet School,250,289,539,2015-16
0936011,0930011,New Haven School District,Metropolitan Business Academy,196,207,403,2015-16
0934411,0930011,New Haven School District,NHPS Self Contained Autism,8,32,40,2015-16
0935011,0930011,New Haven School District,NHPS Self Contained Intellectually Disabled,13,17,30,2015-16
0934511,0930011,New Haven School District,NHPS Self Contained Multi-Handicapped,18,24,42,2015-16
0937011,0930011,New Haven School District,New Haven Academy,149,106,255,2015-16
0932211,0930011,New Haven School District,New Horizons High School,27,53,80,2015-16
0932611,0930011,New Haven School District,New Light High School,12,25,37,2015-16
0939211,0930011,New Haven School District,Polly T. McCabe Center,*,0,*,2015-16
0933511,0930011,New Haven School District,Quinnipiac Real World Math STEM School,159,147,306,2015-16
0939111,0930011,New Haven School District,Riverside Education Academy,38,42,80,2015-16
0934211,0930011,New Haven School District,Roberto Clemente Leadership Academy for Global Awareness,250,270,520,2015-16
0931011,0930011,New Haven School District,Ross/Woodward School,362,307,669,2015-16
0936711,0930011,New Haven School District,Sound School,162,178,340,2015-16
0932811,0930011,New Haven School District,Strong 21st Century Communications Magnet and SCSU Lab School,195,202,397,2015-16
0932911,0930011,New Haven School District,Truman School,229,264,493,2015-16
0934911,0930011,New Haven School District,West Rock Authors Academy,113,128,241,2015-16
0933211,0930011,New Haven School District,Wexler/Grant Community School,199,226,425,2015-16
0936111,0930011,New Haven School District,Wilbur Cross High School,729,717,1446,2015-16
0933811,0930011,New Haven School District,Worthington Hooker School,220,221,441,2015-16
0950311,0950011,New London School District,Jennings School,299,260,559,2015-16
0955111,0950011,New London School District,Bennie Dover Jackson Middle School,276,326,602,2015-16
0950611,0950011,New London School District,Harbor,62,53,115,2015-16
0950911,0950011,New London School District,Nathan Hale Arts Magnet School,278,225,503,2015-16
0956111,0950011,New London School District,New London High School,412,551,963,2015-16
0950811,0950011,New London School District,Winthrop STEM Elementary Magnet School,261,319,580,2015-16
0960511,0960011,New Milford School District,Hill And Plain School,218,216,434,2015-16
0969011,0960011,New Milford School District,Litchfield Hills Transition Center,*,*,17,2015-16
0966111,0960011,New Milford School District,New Milford High School,657,688,1345,2015-16
0960811,0960011,New Milford School District,Northville Elementary School,222,219,441,2015-16
0960911,0960011,New Milford School District,Sarah Noble Intermediate School,437,522,959,2015-16
0965211,0960011,New Milford School District,Schaghticoke Middle School,474,557,1031,2015-16
0940611,0940011,Newington School District,Anna Reynolds School,242,231,473,2015-16
0940211,0940011,Newington School District,Elizabeth Green School,150,144,294,2015-16
0940811,0940011,Newington School District,John Paterson School,198,186,384,2015-16
0945311,0940011,Newington School District,John Wallace Middle School,310,364,674,2015-16
0945111,0940011,Newington School District,Martin Kellogg Middle School,302,318,620,2015-16
0946111,0940011,Newington School District,Newington High School,628,638,1266,2015-16
0940711,0940011,Newington School District,Ruth Chaffee School,176,155,331,2015-16
0970111,0970011,Newtown School District,Hawley Elementary School,161,159,320,2015-16
0970411,0970011,Newtown School District,Head O'Meadow Elementary School,143,154,297,2015-16
0970311,0970011,Newtown School District,Middle Gate Elementary School,179,189,368,2015-16
0976111,0970011,Newtown School District,Newtown High School,798,881,1679,2015-16
0975111,0970011,Newtown School District,Newtown Middle School,380,432,812,2015-16
0978011,0970011,Newtown School District,Newtown Preschool,15,33,48,2015-16
0970511,0970011,Newtown School District,Reed Intermediate School,351,350,701,2015-16
0979011,0970011,Newtown School District,STARR,*,*,*,2015-16
0970211,0970011,Newtown School District,Sandy Hook Elementary School,173,164,337,2015-16
0980111,0980011,Norfolk School District,Botelle Elementary School,61,55,116,2015-16
0990411,0990011,North Branford School District,Jerome Harrison School,179,223,402,2015-16
0996111,0990011,North Branford School District,North Branford High School,307,272,579,2015-16
0995111,0990011,North Branford School District,North Branford Intermediate School,260,232,492,2015-16
0999011,0990011,North Branford School District,School to Work Program,0,*,*,2015-16
0990611,0990011,North Branford School District,Totoket Valley Elementary School,182,223,405,2015-16
1000111,1000011,North Canaan School District,North Canaan Elementary School,129,131,260,2015-16
1010811,1010011,North Haven School District,Clintonville Elementary School,132,170,302,2015-16
1010711,1010011,North Haven School District,Green Acres Elementary School,196,181,377,2015-16
1010211,1010011,North Haven School District,Montowese Elementary School,147,141,288,2015-16
1016111,1010011,North Haven School District,North Haven High School,490,510,1000,2015-16
1015211,1010011,North Haven School District,North Haven Middle School,390,395,785,2015-16
1010111,1010011,North Haven School District,North Haven Transition Partnership,*,*,9,2015-16
1010311,1010011,North Haven School District,Ridge Road Elementary School,205,194,399,2015-16
1020111,1020011,North Stonington School District,North Stonington Elementary School,181,185,366,2015-16
1026111,1020011,North Stonington School District,Wheeler High School,83,106,189,2015-16
1025111,1020011,North Stonington School District,Wheeler Middle School,79,94,173,2015-16
1036211,1030011,Norwalk School District,Brien McMahon High School,858,805,1663,2015-16
1030211,1030011,Norwalk School District,Brookside Elementary School,228,265,493,2015-16
1030311,1030011,Norwalk School District,Columbus Magnet School,186,162,348,2015-16
1030411,1030011,Norwalk School District,Cranbury Elementary School,224,256,480,2015-16
1032011,1030011,Norwalk School District,Fox Run Elementary School,198,246,444,2015-16
1030711,1030011,Norwalk School District,Jefferson Magnet School,299,312,611,2015-16
1030811,1030011,Norwalk School District,Kendall Elementary School,286,273,559,2015-16
1032211,1030011,Norwalk School District,Marvin Elementary School,233,253,486,2015-16
1032111,1030011,Norwalk School District,Naramake Elementary School,223,232,455,2015-16
1035211,1030011,Norwalk School District,Nathan Hale Middle School,317,360,677,2015-16
1036111,1030011,Norwalk School District,Norwalk High School,738,832,1570,2015-16
1036311,1030011,Norwalk School District,Norwalk Pathways Academy at Briggs,22,31,53,2015-16
1035311,1030011,Norwalk School District,Ponus Ridge Middle School,309,357,666,2015-16
1035511,1030011,Norwalk School District,Roton Middle School,236,240,476,2015-16
1031311,1030011,Norwalk School District,Rowayton School,228,215,443,2015-16
1032311,1030011,Norwalk School District,Silvermine Elementary School,239,259,498,2015-16
1031411,1030011,Norwalk School District,Tracey School,179,203,382,2015-16
1035411,1030011,Norwalk School District,West Rocks Middle School,330,340,670,2015-16
1032411,1030011,Norwalk School District,Wolfpit School,145,187,332,2015-16
9010322,9010022,Norwich Free Academy District,Alternative Pathways to Success,*,*,12,2015-16
9010122,9010022,Norwich Free Academy District,"LEAD (Life Skills, Education and Adult Development)",*,*,12,2015-16
9010222,9010022,Norwich Free Academy District,Night School,*,*,11,2015-16
9016122,9010022,Norwich Free Academy District,Norwich Free Academy,1160,1087,2247,2015-16
1049211,1040011,Norwich School District,Virtual Learning Academy,*,*,11,2015-16
1040411,1040011,Norwich School District,ABA Autism Program,*,*,16,2015-16
1040111,1040011,Norwich School District,Bishop School Early Learning Center,98,128,226,2015-16
1040211,1040011,Norwich School District,Case Street Early Learning Center at DTZ,28,32,60,2015-16
1040911,1040011,Norwich School District,IRS Program at Moriarty,0,*,*,2015-16
1040711,1040011,Norwich School District,IRS Program at Uncas,*,*,*,2015-16
1041411,1040011,Norwich School District,John B. Stanton Network School,185,172,357,2015-16
1045111,1040011,Norwich School District,Kelly Middle School,381,373,754,2015-16
1042011,1040011,Norwich School District,Moriarty Magnet School,204,201,405,2015-16
1040811,1040011,Norwich School District,Samuel Huntington School,171,170,341,2015-16
1040511,1040011,Norwich School District,Special Needs Program,13,10,23,2015-16
1045211,1040011,Norwich School District,Teachers' Memorial Middle School,152,185,337,2015-16
1041711,1040011,Norwich School District,Thomas W. Mahan School,131,136,267,2015-16
1041911,1040011,Norwich School District,Uncas Network School,120,110,230,2015-16
1041811,1040011,Norwich School District,Veterans' Memorial School,147,173,320,2015-16
1041511,1040011,Norwich School District,Wequonnoc Magnet School,117,128,245,2015-16
2635113,2630013,Odyssey Community School District,Odyssey Community School,160,168,328,2015-16
1060211,1060011,Old Saybrook School District,Kathleen E. Goodwin School,186,186,372,2015-16
1065211,1060011,Old Saybrook School District,Old Saybrook Middle School,250,271,521,2015-16
1066111,1060011,Old Saybrook School District,Old Saybrook Senior High School,230,214,444,2015-16
1070211,1070011,Orange School District,Mary L. Tracy School,69,94,163,2015-16
1070511,1070011,Orange School District,Peck Place School,179,176,355,2015-16
1070311,1070011,Orange School District,Race Brook School,167,199,366,2015-16
1070411,1070011,Orange School District,Turkey Hill School,136,156,292,2015-16
1080411,1080011,Oxford School District,Alternative Education,*,*,12,2015-16
1085111,1080011,Oxford School District,Great Oak School,253,238,491,2015-16
1080111,1080011,Oxford School District,Oxford Center School,235,237,472,2015-16
1086011,1080011,Oxford School District,Oxford High School,289,303,592,2015-16
1080311,1080011,Oxford School District,Quaker Farms School,192,200,392,2015-16
2835113,2830013,Park City Prep Charter School District,Park City Prep Charter School,182,178,360,2015-16
2930113,2930013,Path Academy District,Path Academy,67,76,143,2015-16
1098011,1090011,Plainfield School District,Early Childhood Center,9,9,18,2015-16
1090111,1090011,Plainfield School District,Moosup Elementary School,164,148,312,2015-16
1095111,1090011,Plainfield School District,Plainfield Central School,261,271,532,2015-16
1096111,1090011,Plainfield School District,Plainfield High School,343,352,695,2015-16
1090311,1090011,Plainfield School District,Plainfield Memorial School,156,170,326,2015-16
1090411,1090011,Plainfield School District,Shepard Hill Elementary School,208,220,428,2015-16
1100411,1100011,Plainville School District,Frank T. Wheeler School,145,164,309,2015-16
1100211,1100011,Plainville School District,Linden Street School,207,216,423,2015-16
1100511,1100011,Plainville School District,Louis Toffolon School,182,187,369,2015-16
1105211,1100011,Plainville School District,Middle School of Plainville,257,288,545,2015-16
1106111,1100011,Plainville School District,Plainville High School,360,384,744,2015-16
1115111,1110011,Plymouth School District,Eli Terry Jr. Middle School,166,171,337,2015-16
1110411,1110011,Plymouth School District,Harry S. Fisher Elementary School,177,200,377,2015-16
1117111,1110011,Plymouth School District,Plymouth Alternative High School,*,*,*,2015-16
1110211,1110011,Plymouth School District,Plymouth Center School,147,166,313,2015-16
1116111,1110011,Plymouth School District,Terryville High School,219,257,476,2015-16
1120111,1120011,Pomfret School District,Pomfret Community School,182,218,400,2015-16
1130511,1130011,Portland School District,Brownstone Intermediate School,117,102,219,2015-16
1130411,1130011,Portland School District,Gildersleeve School,102,104,206,2015-16
1136111,1130011,Portland School District,Portland High School,202,182,384,2015-16
1135111,1130011,Portland School District,Portland Middle School,103,117,220,2015-16
1130211,1130011,Portland School District,Valley View School,140,183,323,2015-16
1145111,1140011,Preston School District,Preston Plains School,83,69,152,2015-16
1140411,1140011,Preston School District,Preston Veterans' Memorial School,143,143,286,2015-16
1169011,1160011,Putnam School District,Helping Hands,0,*,*,2015-16
1160111,1160011,Putnam School District,PALS - Putnam Alternative Learning System,*,*,9,2015-16
1160311,1160011,Putnam School District,Putnam Elementary School,300,317,617,2015-16
1166111,1160011,Putnam School District,Putnam High School,150,126,276,2015-16
1165111,1160011,Putnam School District,Putnam Middle School,136,136,272,2015-16
1175111,1170011,Redding School District,John Read Middle School,225,248,473,2015-16
1170111,1170011,Redding School District,Redding Elementary School,226,254,480,2015-16
2016112,2010012,Regional School District 01,Housatonic Valley Regional High School,224,206,430,2015-16
2010412,2010012,Regional School District 01,LEAPSS,*,*,*,2015-16
2010312,2010012,Regional School District 01,SELC,0,*,*,2015-16
2010212,2010012,Regional School District 01,TOTAL,*,*,*,2015-16
2045112,2040012,Regional School District 04,John Winthrop Middle School,157,158,315,2015-16
2040112,2040012,Regional School District 04,Region 4 Transition Academy,*,*,*,2015-16
2046112,2040012,Regional School District 04,Valley Regional High School,310,290,600,2015-16
2055112,2050012,Regional School District 05,Amity Middle School: Bethany,183,200,383,2015-16
2055212,2050012,Regional School District 05,Amity Middle School: Orange,193,182,375,2015-16
2056112,2050012,Regional School District 05,Amity Regional High School,730,756,1486,2015-16
2068112,2060012,Regional School District 06,Early Childhood Learning Center,34,30,64,2015-16
2060112,2060012,Regional School District 06,Goshen Center School,81,68,149,2015-16
2060212,2060012,Regional School District 06,James Morris School,57,59,116,2015-16
2066112,2060012,Regional School District 06,Wamogo Regional High School,305,271,576,2015-16
2060312,2060012,Regional School District 06,Warren Elementary School,38,40,78,2015-16
2079112,2070012,Regional School District 07,AIM,*,*,9,2015-16
2079012,2070012,Regional School District 07,FLEX,0,*,*,2015-16
2079212,2070012,Regional School District 07,Links,*,*,17,2015-16
2076112,2070012,Regional School District 07,Northwestern Regional High School,379,340,719,2015-16
2075112,2070012,Regional School District 07,Northwestern Regional Middle School,148,167,315,2015-16
2079312,2070012,Regional School District 07,STEP,*,*,21,2015-16
2086112,2080012,Regional School District 08,RHAM High School,487,536,1023,2015-16
2085112,2080012,Regional School District 08,RHAM Middle School,293,274,567,2015-16
2096112,2090012,Regional School District 09,Joel Barlow High School,479,529,1008,2015-16
2105112,2100012,Regional School District 10,Har-Bur Middle School,380,406,786,2015-16
2100312,2100012,Regional School District 10,Harwinton Consolidated School,200,199,399,2015-16
2100212,2100012,Regional School District 10,Lake Garda Elementary School,204,238,442,2015-16
2106112,2100012,Regional School District 10,Lewis S. Mills High School,360,418,778,2015-16
2116112,2110012,Regional School District 11,Parish Hill High School,119,126,245,2015-16
2120212,2120012,Regional School District 12,Booth Free School,38,39,77,2015-16
2120312,2120012,Regional School District 12,Shepaug Valley School,219,220,439,2015-16
2120112,2120012,Regional School District 12,The Burnham School,25,28,53,2015-16
2120412,2120012,Regional School District 12,Washington Primary School,80,79,159,2015-16
2136112,2130012,Regional School District 13,Coginchaug Regional High School,276,280,556,2015-16
2130212,2130012,Regional School District 13,Francis E. Korn School,74,69,143,2015-16
2135112,2130012,Regional School District 13,Frank Ward Strong School,133,185,318,2015-16
2130112,2130012,Regional School District 13,Frederick Brewster School,94,102,196,2015-16
2130512,2130012,Regional School District 13,John Lyman School,143,95,238,2015-16
2130412,2130012,Regional School District 13,Middlefield Memorial School,133,133,266,2015-16
2130312,2130012,Regional School District 13,Middlesex Transition Academy,10,16,26,2015-16
2140112,2140012,Regional School District 14,Bethlehem Elementary School,137,119,256,2015-16
2148012,2140012,Regional School District 14,Integrated Star Preschool Program,22,26,48,2015-16
2140212,2140012,Regional School District 14,Mitchell Elementary School,170,195,365,2015-16
2140312,2140012,Regional School District 14,Nonnewaug Chiefs Alternative Program,0,*,*,2015-16
2146112,2140012,Regional School District 14,Nonnewaug High School,432,318,750,2015-16
2140412,2140012,Regional School District 14,Region 14 Transition Academy,0,*,*,2015-16
2145112,2140012,Regional School District 14,Woodbury Middle School,172,167,339,2015-16
2150412,2150012,Regional School District 15,Gainfield Elementary School,169,203,372,2015-16
2150712,2150012,Regional School District 15,Long Meadow Elementary School,226,291,517,2015-16
2150112,2150012,Regional School District 15,MIJ Program,8,7,15,2015-16
2155212,2150012,Regional School District 15,Memorial Middle School,206,240,446,2015-16
2150612,2150012,Regional School District 15,Middlebury Elementary School,171,158,329,2015-16
2156212,2150012,Regional School District 15,Pomperaug Regional High School,556,629,1185,2015-16
2150512,2150012,Regional School District 15,Pomperaug School,179,174,353,2015-16
2155112,2150012,Regional School District 15,Rochambeau Middle School,272,277,549,2015-16
2160112,2160012,Regional School District 16,Laurel Ledge School,177,203,380,2015-16
2165112,2160012,Regional School District 16,Long River Middle School,266,302,568,2015-16
2160512,2160012,Regional School District 16,Prospect Elementary School,335,281,616,2015-16
2160412,2160012,Regional School District 16,WRHS Alternative Education Program,*,*,10,2015-16
2166012,2160012,Regional School District 16,Woodland Regional High School,350,335,685,2015-16
2170212,2170012,Regional School District 17,Burr District Elementary School,131,147,278,2015-16
2170112,2170012,Regional School District 17,Haddam Elementary School,101,119,220,2015-16
2176112,2170012,Regional School District 17,Haddam-Killingworth High School,325,293,618,2015-16
2175112,2170012,Regional School District 17,Haddam-Killingworth Middle School,336,410,746,2015-16
2170312,2170012,Regional School District 17,Killingworth Elementary School,113,143,256,2015-16
2180312,2180012,Regional School District 18,Center School,21,25,46,2015-16
2180412,2180012,Regional School District 18,Alternative Program,*,*,*,2015-16
2180112,2180012,Regional School District 18,Lyme Consolidated School,99,105,204,2015-16
2186112,2180012,Regional School District 18,Lyme-Old Lyme High School,226,234,460,2015-16
2185112,2180012,Regional School District 18,Lyme-Old Lyme Middle School,176,175,351,2015-16
2180212,2180012,Regional School District 18,Mile Creek School,141,125,266,2015-16
2196112,2190012,Regional School District 19,E. O. Smith High School,610,543,1153,2015-16
2190112,2190012,Regional School District 19,E.O. Smith High School at the Depot Campus,18,10,28,2015-16
2190212,2190012,Regional School District 19,PM Panthers,12,13,25,2015-16
1188011,1180011,Ridgefield School District,Alternative High School,6,7,13,2015-16
1180811,1180011,Ridgefield School District,Barlow Mountain Elementary School,160,171,331,2015-16
1180611,1180011,Ridgefield School District,Branchville Elementary School,191,193,384,2015-16
1180111,1180011,Ridgefield School District,District Program BMES,0,*,*,2015-16
1181011,1180011,Ridgefield School District,District Program ERMS,0,*,*,2015-16
1180711,1180011,Ridgefield School District,District Program RES,*,*,9,2015-16
1180911,1180011,Ridgefield School District,District Program SES,*,*,*,2015-16
1185111,1180011,Ridgefield School District,East Ridge Middle School,387,370,757,2015-16
1180411,1180011,Ridgefield School District,Farmingville Elementary School,153,178,331,2015-16
1180311,1180011,Ridgefield School District,Ridgebury Elementary School,160,182,342,2015-16
1189011,1180011,Ridgefield School District,Ridgefield 18-21 Transition Program,*,*,7,2015-16
1186111,1180011,Ridgefield School District,Ridgefield High School,845,848,1693,2015-16
1180511,1180011,Ridgefield School District,Scotland Elementary School,183,181,364,2015-16
1185211,1180011,Ridgefield School District,Scotts Ridge Middle School,241,255,496,2015-16
1180211,1180011,Ridgefield School District,Veterans Park Elementary School,152,151,303,2015-16
1195111,1190011,Rocky Hill School District,Albert D. Griswold Middle School,317,319,636,2015-16
1190111,1190011,Rocky Hill School District,Alternative Learning Program,0,*,*,2015-16
1190411,1190011,Rocky Hill School District,Myrtle H. Stevens School,266,255,521,2015-16
1190311,1190011,Rocky Hill School District,Pathways,*,*,7,2015-16
1196111,1190011,Rocky Hill School District,Rocky Hill High School,343,362,705,2015-16
1190511,1190011,Rocky Hill School District,West Hill School,364,367,731,2015-16
1210111,1210011,Salem School District,Salem Elementary School,178,198,376,2015-16
1220111,1220011,Salisbury School District,Salisbury Central School,144,130,274,2015-16
1230111,1230011,Scotland School District,Scotland Elementary School,70,49,119,2015-16
1240111,1240011,Seymour School District,Bungay School,218,230,448,2015-16
1240211,1240011,Seymour School District,Chatfield-LoPresti School,260,270,530,2015-16
1246111,1240011,Seymour School District,Seymour High School,322,342,664,2015-16
1245111,1240011,Seymour School District,Seymour Middle School,293,269,562,2015-16
1250111,1250011,Sharon School District,Sharon Center School,79,81,160,2015-16
1260911,1260011,Shelton School District,Mohegan School,136,151,287,2015-16
1260211,1260011,Shelton School District,Alternative Learning Center 1,*,*,10,2015-16
1261011,1260011,Shelton School District,Booth Hill School,157,174,331,2015-16
1260511,1260011,Shelton School District,Elizabeth Shelton School,213,220,433,2015-16
1265111,1260011,Shelton School District,Intermediate School,415,453,868,2015-16
1260311,1260011,Shelton School District,Life Skills,*,*,*,2015-16
1260811,1260011,Shelton School District,Long Hill School,174,232,406,2015-16
1261111,1260011,Shelton School District,Perry Hill Elementary School,373,366,739,2015-16
1260111,1260011,Shelton School District,Pre-Kindergarten,21,38,59,2015-16
1266111,1260011,Shelton School District,Shelton High School,752,761,1513,2015-16
1260611,1260011,Shelton School District,Sunnyside School,121,113,234,2015-16
1260711,1260011,Shelton School District,Transition Program,7,14,21,2015-16
1270111,1270011,Sherman School District,Sherman School,163,170,333,2015-16
2700113,2700013,Side By Side Charter School District,Side By Side Charter School,118,118,236,2015-16
1280111,1280011,Simsbury School District,Central School,179,213,392,2015-16
1285111,1280011,Simsbury School District,Henry James Memorial School,339,371,710,2015-16
1280611,1280011,Simsbury School District,Latimer Lane School,195,176,371,2015-16
1286111,1280011,Simsbury School District,Simsbury High School,671,752,1423,2015-16
1280711,1280011,Simsbury School District,Squadron Line School,294,315,609,2015-16
1280311,1280011,Simsbury School District,Tariffville School,149,135,284,2015-16
1280411,1280011,Simsbury School District,Tootin' Hills School,184,186,370,2015-16
1290511,1290011,Somers School District,Aspire,*,*,7,2015-16
1295111,1290011,Somers School District,Mabelle B. Avery Middle School,175,184,359,2015-16
1290411,1290011,Somers School District,Somers Elementary School,279,306,585,2015-16
1296111,1290011,Somers School District,Somers High School,235,243,478,2015-16
1320211,1320011,South Windsor School District,Pleasant Valley School,184,172,356,2015-16
1320711,1320011,South Windsor School District,Eli Terry School,224,228,452,2015-16
1320611,1320011,South Windsor School District,Orchard Hill School,197,194,391,2015-16
1320111,1320011,South Windsor School District,Philip R. Smith School,148,172,320,2015-16
1329011,1320011,South Windsor School District,Project Worth Young Adult Academy,*,*,11,2015-16
1326211,1320011,South Windsor School District,South Windsor High School,644,674,1318,2015-16
1325111,1320011,South Windsor School District,Timothy Edwards School,475,493,968,2015-16
1320411,1320011,South Windsor School District,Wapping Elementary School,147,165,312,2015-16
1315311,1310011,Southington School District,John F. Kennedy Middle School,412,427,839,2015-16
1311711,1310011,Southington School District,Achieve,*,*,*,2015-16
1310111,1310011,Southington School District,Alta,7,26,33,2015-16
1311511,1310011,Southington School District,Derynoski Elementary School,291,309,600,2015-16
1310511,1310011,Southington School District,EASE,*,*,10,2015-16
1311311,1310011,Southington School District,Flanders Elementary School,142,158,300,2015-16
1310211,1310011,Southington School District,Hatton Elementary School,160,197,357,2015-16
1315111,1310011,Southington School District,Joseph A. Depaolo Middle School,383,360,743,2015-16
1310411,1310011,Southington School District,Language Based Classroom at Hatton School,*,*,11,2015-16
1311811,1310011,Southington School District,"Language Based Classroom, Multihandicapped",*,*,11,2015-16
1310611,1310011,Southington School District,Plantsville Elementary School,148,140,288,2015-16
1310711,1310011,Southington School District,South End Elementary School,120,112,232,2015-16
1316211,1310011,Southington School District,Southington High School,1006,961,1967,2015-16
1312111,1310011,Southington School District,Southington Public Schools Preschool Program,8,12,20,2015-16
1312011,1310011,Southington School District,Southington Public Schools Preschool Program at Hatton School,23,49,72,2015-16
1310811,1310011,Southington School District,Strong Elementary School,146,149,295,2015-16
1310911,1310011,Southington School District,Thalberg Elementary School,210,219,429,2015-16
1311611,1310011,Southington School District,Therapeutic Educational Alternative Model (TEAM),*,*,7,2015-16
1311211,1310011,Southington School District,Therapeutic Educational Setting (TEP),*,*,11,2015-16
1311411,1310011,Southington School District,Urbin T. Kelley School,151,168,319,2015-16
1330111,1330011,Sprague School District,Sayles School,157,203,360,2015-16
1340611,1340011,Stafford School District,Stafford Elementary School,230,241,471,2015-16
1346111,1340011,Stafford School District,Stafford High School,216,193,409,2015-16
1345211,1340011,Stafford School District,Stafford Middle School,148,183,331,2015-16
1340211,1340011,Stafford School District,Stafford Tutoring Program,*,*,*,2015-16
1340311,1340011,Stafford School District,Staffordville School,83,74,157,2015-16
1340411,1340011,Stafford School District,West Stafford School,74,87,161,2015-16
2826013,2820013,Stamford Academy District,Stamford Academy,69,81,150,2015-16
2960113,2960013,Stamford Charter School for Excellence District,Stamford Charter School for Excellence,74,90,164,2015-16
1350411,1350011,Stamford School District,Alternate Routes To Success,31,48,79,2015-16
1350111,1350011,Stamford School District,Apples PreK,49,91,140,2015-16
1355611,1350011,Stamford School District,Cloonan School,250,291,541,2015-16
1352011,1350011,Stamford School District,Davenport Ridge School,333,305,638,2015-16
1355311,1350011,Stamford School District,Dolan School,216,281,497,2015-16
1352211,1350011,Stamford School District,Hart School,282,346,628,2015-16
1350211,1350011,Stamford School District,Individuals Achieving Independence,10,12,22,2015-16
1351211,1350011,Stamford School District,Julia A. Stark School,302,309,611,2015-16
1350511,1350011,Stamford School District,K. T. Murphy School,262,287,549,2015-16
1350611,1350011,Stamford School District,Newfield School,310,313,623,2015-16
1351811,1350011,Stamford School District,Northeast School,295,341,636,2015-16
1358011,1350011,Stamford School District,Preschool Team,18,39,57,2015-16
1355811,1350011,Stamford School District,Rippowam Middle School,425,374,799,2015-16
1350811,1350011,Stamford School District,Rogers International School,422,379,801,2015-16
1350911,1350011,Stamford School District,Roxbury School,289,329,618,2015-16
1355711,1350011,Stamford School District,Scofield Middle School,373,342,715,2015-16
1351111,1350011,Stamford School District,Springdale School,345,306,651,2015-16
1356111,1350011,Stamford School District,Stamford High School,840,879,1719,2015-16
1352111,1350011,Stamford School District,Stillmeadow School,313,385,698,2015-16
1356411,1350011,Stamford School District,The Academy of Information Technology,295,391,686,2015-16
1351911,1350011,Stamford School District,Toquam Magnet School,318,388,706,2015-16
1355511,1350011,Stamford School District,Turn of River School,308,276,584,2015-16
1356311,1350011,Stamford School District,Westhill High School,1061,1035,2096,2015-16
1351411,1350011,Stamford School District,Westover School,382,384,766,2015-16
1360311,1360011,Sterling School District,Sterling Community School,198,249,447,2015-16
1370811,1370011,Stonington School District,Community Classroom,*,0,*,2015-16
1370511,1370011,Stonington School District,Deans Mill School,186,201,387,2015-16
1375211,1370011,Stonington School District,Mystic Middle School,187,219,406,2015-16
1375111,1370011,Stonington School District,Pawcatuck Middle School,134,135,269,2015-16
1370111,1370011,Stonington School District,Stonington BOE Pre-School,7,12,19,2015-16
1370211,1370011,Stonington School District,Stonington HS PreK,11,8,19,2015-16
1376111,1370011,Stonington School District,Stonington High School,358,355,713,2015-16
1370411,1370011,Stonington School District,West Broad Street School,60,88,148,2015-16
1370611,1370011,Stonington School District,West Vine Street School,91,98,189,2015-16
1381311,1380011,Stratford School District,Eli Whitney School,239,266,505,2015-16
1382511,1380011,Stratford School District,ABA Nichols,*,*,*,2015-16
1380611,1380011,Stratford School District,ABA Second Hill Lane,*,*,*,2015-16
1382411,1380011,Stratford School District,ABA Whitney,*,*,*,2015-16
1380511,1380011,Stratford School District,ALPHA,20,22,42,2015-16
1386211,1380011,Stratford School District,Bunnell High School,541,506,1047,2015-16
1380311,1380011,Stratford School District,Chapel School,246,272,518,2015-16
1382311,1380011,Stratford School District,DLC Whitney,*,*,*,2015-16
1385211,1380011,Stratford School District,David Wooster Middle School,276,272,548,2015-16
1382111,1380011,Stratford School District,Franklin STEPS K-2,0,*,*,2015-16
1380411,1380011,Stratford School District,Franklin School,138,143,281,2015-16
1385311,1380011,Stratford School District,Harry B. Flood Middle School,272,288,560,2015-16
1382011,1380011,Stratford School District,High School STEPS 9-12,0,6,6,2015-16
1380711,1380011,Stratford School District,High School Sails,*,*,10,2015-16
1381111,1380011,Stratford School District,IPP Classroom - Johnson,0,6,6,2015-16
1381211,1380011,Stratford School District,Johnson House STEPS 3-6,*,*,8,2015-16
1380811,1380011,Stratford School District,Lordship School,132,124,256,2015-16
1381911,1380011,Stratford School District,Middle School STEPS 7-8,*,*,*,2015-16
1381811,1380011,Stratford School District,Middle School Sails,*,*,*,2015-16
1380911,1380011,Stratford School District,Nichols School,207,212,419,2015-16
1381011,1380011,Stratford School District,Second Hill Lane School,316,302,618,2015-16
1382611,1380011,Stratford School District,Steps K-2 Nichols,*,*,*,2015-16
1381511,1380011,Stratford School District,Stratford Academy - Johnson House,210,201,411,2015-16
1382211,1380011,Stratford School District,Stratford Academy - Victoria Soto School,143,134,277,2015-16
1386111,1380011,Stratford School District,Stratford High School,460,487,947,2015-16
1389011,1380011,Stratford School District,Strive-Stratford,6,8,14,2015-16
1381411,1380011,Stratford School District,Wilcoxson School,158,183,341,2015-16
1390411,1390011,Suffield School District,A. Ward Spaulding School,229,269,498,2015-16
1390311,1390011,Suffield School District,McAlister Intermediate School,247,219,466,2015-16
1396111,1390011,Suffield School District,Suffield High School,421,407,828,2015-16
1395111,1390011,Suffield School District,Suffield Middle School,284,277,561,2015-16
2696113,2690013,The Bridge Academy District,The Bridge Academy,151,128,279,2015-16
9026122,9020022,The Gilbert School District,The Gilbert School,232,321,553,2015-16
1400111,1400011,Thomaston School District,Black Rock School,132,137,269,2015-16
1400211,1400011,Thomaston School District,Thomaston Center School,120,95,215,2015-16
1406211,1400011,Thomaston School District,Thomaston High School,200,210,410,2015-16
1410211,1410011,Thompson School District,District Autism Program,0,*,*,2015-16
1410111,1410011,Thompson School District,Mary R. Fisher Elementary School,174,213,387,2015-16
1415111,1410011,Thompson School District,Thompson Middle School,154,179,333,2015-16
1416111,1410011,Thompson School District,Tourtellotte Memorial High School,132,142,274,2015-16
1420111,1420011,Tolland School District,Birch Grove Primary School,257,272,529,2015-16
1420311,1420011,Tolland School District,TALC,*,*,11,2015-16
1426111,1420011,Tolland School District,Tolland High School,429,399,828,2015-16
1420211,1420011,Tolland School District,Tolland Intermediate School,257,288,545,2015-16
1425111,1420011,Tolland School District,Tolland Middle School,341,323,664,2015-16
1430111,1430011,Torrington School District,East School,166,181,347,2015-16
1431511,1430011,Torrington School District,ABC / Forbes School,0,*,*,2015-16
1432411,1430011,Torrington School District,ABC / Torringford,0,*,*,2015-16
1432211,1430011,Torrington School District,East TPS - PreK - Reg Ed,21,21,42,2015-16
1430211,1430011,Torrington School District,Forbes School,172,212,384,2015-16
1431611,1430011,Torrington School District,Pre-K SpEd,6,11,17,2015-16
1430811,1430011,Torrington School District,Southwest School,144,169,313,2015-16
1432311,1430011,Torrington School District,Torringford Community Outreach,*,*,7,2015-16
1430911,1430011,Torrington School District,Torringford School,290,337,627,2015-16
1431411,1430011,Torrington School District,Torrington Expulsion Program,*,*,7,2015-16
1436111,1430011,Torrington School District,Torrington High School,437,518,955,2015-16
1435111,1430011,Torrington School District,Torrington Middle School,480,534,1014,2015-16
1431311,1430011,Torrington School District,Vogel-Wetmore School,201,236,437,2015-16
2785113,2780013,Trailblazers Academy District,Trailblazers Academy,58,67,125,2015-16
1440111,1440011,Trumbull School District,Booth Hill School,223,233,456,2015-16
1440811,1440011,Trumbull School District,Daniels Farm School,233,227,460,2015-16
1441011,1440011,Trumbull School District,Frenchtown Elementary School,268,286,554,2015-16
1445211,1440011,Trumbull School District,Hillcrest Middle School,381,388,769,2015-16
1440411,1440011,Trumbull School District,Jane Ryan School,181,196,377,2015-16
1445111,1440011,Trumbull School District,Madison Middle School,405,387,792,2015-16
1440311,1440011,Trumbull School District,Middlebrook School,244,253,497,2015-16
1440911,1440011,Trumbull School District,Tashua School,185,216,401,2015-16
1448011,1440011,Trumbull School District,Trumbull Early Childhood Education Center,91,118,209,2015-16
1446111,1440011,Trumbull School District,Trumbull High School,1141,1010,2151,2015-16
3360115,3360015,Unified School District #1,Bridgeport Correctional Center,0,6,6,2015-16
3360215,3360015,Unified School District #1,Brooklyn Correctional Institution,0,*,*,2015-16
3360315,3360015,Unified School District #1,Cheshire Correctional Institution,0,10,10,2015-16
3362415,3360015,Unified School District #1,Corrigan/Radgowski Correctional Institution,0,11,11,2015-16
3360415,3360015,Unified School District #1,Enfield Correctional Institution,0,*,*,2015-16
3361915,3360015,Unified School District #1,Garner Correctional Institution,0,17,17,2015-16
3360615,3360015,Unified School District #1,Hartford Correctional Center,0,8,8,2015-16
3362215,3360015,Unified School District #1,MacDougall/Walker Correctional Institution,0,7,7,2015-16
3361115,3360015,Unified School District #1,Manson Youth Institution,*,*,295,2015-16
3360915,3360015,Unified School District #1,New Haven Correctional Center,0,*,*,2015-16
3362615,3360015,Unified School District #1,Northern Correctional Institution,0,7,7,2015-16
3361215,3360015,Unified School District #1,Osborn Correctional Institution,0,7,7,2015-16
3361315,3360015,Unified School District #1,Robinson Correctional Institution,0,*,*,2015-16
3361515,3360015,Unified School District #1,Willard/Cybulski Correctional Institution,0,*,*,2015-16
3362515,3360015,Unified School District #1,York Correctional Institution,11,0,11,2015-16
3470115,3470015,Unified School District #2,Children's Place School,0,28,28,2015-16
3470315,3470015,Unified School District #2,Riverview School,45,16,61,2015-16
3476715,3470015,Unified School District #2,Walter G. Cady School,*,*,62,2015-16
1450111,1450011,Union School District,Union Elementary School,42,38,80,2015-16
1460311,1460011,Vernon School District,Northeast School,156,166,322,2015-16
1461411,1460011,Vernon School District,Center Road School,245,257,502,2015-16
1460111,1460011,Vernon School District,Lake Street School,103,116,219,2015-16
1460511,1460011,Vernon School District,Loveland Hill School,*,*,10,2015-16
1460211,1460011,Vernon School District,Maple Street School,126,148,274,2015-16
1469011,1460011,Vernon School District,Next Step Program (AACBP),*,*,7,2015-16
1466111,1460011,Vernon School District,Rockville High School,439,381,820,2015-16
1461011,1460011,Vernon School District,Skinner Road School,169,165,334,2015-16
1460711,1460011,Vernon School District,VPS PreK Collaborative - YMCA,*,*,8,2015-16
1465111,1460011,Vernon School District,Vernon Center Middle School,330,352,682,2015-16
1470111,1470011,Voluntown School District,Voluntown Elementary School,137,159,296,2015-16
1480211,1480011,Wallingford School District,Highland School,147,160,307,2015-16
1489011,1480011,Wallingford School District,A.R.T.S. Academy,*,*,17,2015-16
1481011,1480011,Wallingford School District,Cook Hill School,172,193,365,2015-16
1485211,1480011,Wallingford School District,Dag Hammarskjold Middle School,369,364,733,2015-16
1480511,1480011,Wallingford School District,Education Enhancement Program,8,11,19,2015-16
1480911,1480011,Wallingford School District,Evarts C. Stevens School,160,169,329,2015-16
1489211,1480011,Wallingford School District,Harvest Park,0,9,9,2015-16
1485311,1480011,Wallingford School District,James H. Moran Middle School,349,347,696,2015-16
1486111,1480011,Wallingford School District,Lyman Hall High School,593,480,1073,2015-16
1486211,1480011,Wallingford School District,Mark T. Sheehan High School,433,416,849,2015-16
1480111,1480011,Wallingford School District,Moses Y. Beach School,161,170,331,2015-16
1489111,1480011,Wallingford School District,Multi-Vocational Life Skills Program,*,*,9,2015-16
1480311,1480011,Wallingford School District,Parker Farms School,138,129,267,2015-16
1481211,1480011,Wallingford School District,Pond Hill School,148,178,326,2015-16
1480411,1480011,Wallingford School District,Rock Hill School,172,165,337,2015-16
1480811,1480011,Wallingford School District,Yalesville School,145,176,321,2015-16
1515211,1510011,Waterbury School District,West Side Middle School,477,543,1020,2015-16
1512311,1510011,Waterbury School District,Washington School,141,169,310,2015-16
1512111,1510011,Waterbury School District,B. W. Tinker School,269,322,591,2015-16
1510411,1510011,Waterbury School District,B.W. Tinker BDLC,*,*,11,2015-16
1510511,1510011,Waterbury School District,Bucks Hill School,291,284,575,2015-16
1510111,1510011,Waterbury School District,Bunker Hill BDLC,0,15,15,2015-16
1510611,1510011,Waterbury School District,Bunker Hill School,249,246,495,2015-16
1511911,1510011,Waterbury School District,Carrington ESC,*,*,13,2015-16
1512711,1510011,Waterbury School District,Carrington School,255,249,504,2015-16
1516211,1510011,Waterbury School District,Crosby High School,543,649,1192,2015-16
1514011,1510011,Waterbury School District,Crosby NVCC (Waterbury Transition Learning Center),*,*,15,2015-16
1510911,1510011,Waterbury School District,Driggs School,243,272,515,2015-16
1513611,1510011,Waterbury School District,Duggan CBL,*,*,8,2015-16
1511611,1510011,Waterbury School District,Duggan School,231,232,463,2015-16
1519111,1510011,Waterbury School District,Enlightenment School,50,89,139,2015-16
1513811,1510011,Waterbury School District,Excel II,0,*,*,2015-16
1513911,1510011,Waterbury School District,Excel III,*,*,6,2015-16
1511411,1510011,Waterbury School District,F. J. Kingsbury School,261,280,541,2015-16
1512611,1510011,Waterbury School District,Gilmartin School,235,244,479,2015-16
1510711,1510011,Waterbury School District,H. S. Chase School,361,427,788,2015-16
1511311,1510011,Waterbury School District,Hopeville School,237,253,490,2015-16
1516411,1510011,Waterbury School District,John F. Kennedy High School,644,657,1301,2015-16
1513111,1510011,Waterbury School District,Maloney Interdistrict Magnet School,295,295,590,2015-16
1519811,1510011,Waterbury School District,Maloney Prek,15,15,30,2015-16
1513511,1510011,Waterbury School District,Margaret M. Generali Autism,6,20,26,2015-16
1511111,1510011,Waterbury School District,Margaret M. Generali Elementary School,265,292,557,2015-16
1512911,1510011,Waterbury School District,Michael F. Wallace Autism,*,*,19,2015-16
1515111,1510011,Waterbury School District,Michael F. Wallace Middle School,600,582,1182,2015-16
1511811,1510011,Waterbury School District,North End ESC,0,*,*,2015-16
1515311,1510011,Waterbury School District,North End Middle School,464,525,989,2015-16
1512411,1510011,Waterbury School District,Reed ESC,7,13,20,2015-16
1513411,1510011,Waterbury School District,Reed School,197,237,434,2015-16
1512811,1510011,Waterbury School District,Regan School,126,130,256,2015-16
1513311,1510011,Waterbury School District,Rotella Interdistrict Magnet School,316,297,613,2015-16
1518011,1510011,Waterbury School District,Special Education Preschool,85,132,217,2015-16
1512011,1510011,Waterbury School District,Sprague School,216,249,465,2015-16
1519011,1510011,Waterbury School District,State Street School,19,40,59,2015-16
1512211,1510011,Waterbury School District,Walsh School,182,190,372,2015-16
1516011,1510011,Waterbury School District,Waterbury Arts Magnet School (High),327,161,488,2015-16
1515011,1510011,Waterbury School District,Waterbury Arts Magnet School (Middle),213,118,331,2015-16
1516711,1510011,Waterbury School District,Waterbury Career Academy,388,305,693,2015-16
1510811,1510011,Waterbury School District,Wendell L. Cross School,156,168,324,2015-16
1511711,1510011,Waterbury School District,Wilby ESC,*,*,*,2015-16
1516311,1510011,Waterbury School District,Wilby High School,508,664,1172,2015-16
1511211,1510011,Waterbury School District,Woodrow Wilson BDLC,*,*,17,2015-16
1513211,1510011,Waterbury School District,Woodrow Wilson School,195,236,431,2015-16
1521111,1520011,Waterford School District,Autism Class,0,*,*,2015-16
1520311,1520011,Waterford School District,Avery Point Transition Program,*,*,6,2015-16
1525111,1520011,Waterford School District,Clark Lane Middle School,330,339,669,2015-16
1520211,1520011,Waterford School District,Great Neck Elementary School,164,150,314,2015-16
1520611,1520011,Waterford School District,Oswegatchie Elementary School,184,170,354,2015-16
1520711,1520011,Waterford School District,Quaker Hill Elementary School,162,182,344,2015-16
1526111,1520011,Waterford School District,Waterford High School,405,413,818,2015-16
1521211,1520011,Waterford School District,Waterford High School Tutor Center,*,*,*,2015-16
1530311,1530011,Watertown School District,Fletcher W. Judson School,125,164,289,2015-16
1530211,1530011,Watertown School District,John Trumbull Primary School,270,367,637,2015-16
1530411,1530011,Watertown School District,Polk School,176,184,360,2015-16
1535111,1530011,Watertown School District,Swift Middle School,314,351,665,2015-16
1536111,1530011,Watertown School District,Watertown High School,423,437,860,2015-16
1551711,1550011,West Hartford School District,Smith School,171,188,359,2015-16
1559111,1550011,West Hartford School District,Achieve,*,*,10,2015-16
1551611,1550011,West Hartford School District,Aiken School,200,217,417,2015-16
1559311,1550011,West Hartford School District,Braeburn Learning Center,*,*,6,2015-16
1550211,1550011,West Hartford School District,Braeburn School,172,192,364,2015-16
1555311,1550011,West Hartford School District,Bristow Middle School,214,208,422,2015-16
1550411,1550011,West Hartford School District,Bugbee School,233,197,430,2015-16
1550511,1550011,West Hartford School District,Charter Oak International Academy,175,147,322,2015-16
1556111,1550011,West Hartford School District,Conard High School,741,799,1540,2015-16
1550611,1550011,West Hartford School District,Duffy School,250,237,487,2015-16
1556211,1550011,West Hartford School District,Hall High School,737,726,1463,2015-16
1555111,1550011,West Hartford School District,King Philip Middle School,447,492,939,2015-16
1550911,1550011,West Hartford School District,Morley School,151,150,301,2015-16
1559411,1550011,West Hartford School District,Norfeldt Learning Center,*,*,8,2015-16
1551011,1550011,West Hartford School District,Norfeldt School,161,186,347,2015-16
1557311,1550011,West Hartford School District,REACH,18,18,36,2015-16
1555211,1550011,West Hartford School District,Sedgwick Middle School,414,447,861,2015-16
1559211,1550011,West Hartford School District,Strive-West Hartford,8,21,29,2015-16
1559011,1550011,West Hartford School District,WAAVE (W Hartford Applied Academic/Voc'l Experience),*,*,12,2015-16
1551211,1550011,West Hartford School District,Webster Hill School,225,205,430,2015-16
1559511,1550011,West Hartford School District,Whiting Lane Learning Center,0,8,8,2015-16
1551311,1550011,West Hartford School District,Whiting Lane School,196,241,437,2015-16
1559611,1550011,West Hartford School District,Wolcott Learning Center,*,*,8,2015-16
1551511,1550011,West Hartford School District,Wolcott School,231,236,467,2015-16
1561211,1560011,West Haven School District,Washington School,222,247,469,2015-16
1560111,1560011,West Haven School District,Life Skills,*,*,6,2015-16
1561111,1560011,West Haven School District,ASD Lab,*,*,10,2015-16
1560811,1560011,West Haven School District,Alma E. Pagels School,120,220,340,2015-16
1560711,1560011,West Haven School District,Blended,*,*,17,2015-16
1560511,1560011,West Haven School District,Blended (Molloy),9,8,17,2015-16
1565311,1560011,West Haven School District,Carrigan 5/6 Intermediate School,464,437,901,2015-16
1560611,1560011,West Haven School District,Edith E. Mackrille School,141,159,300,2015-16
1560311,1560011,West Haven School District,Forest School,236,225,461,2015-16
1565111,1560011,West Haven School District,Harry M. Bailey Middle School,404,438,842,2015-16
1560211,1560011,West Haven School District,PACE,9,27,36,2015-16
1561411,1560011,West Haven School District,Savin Rock Community School,242,239,481,2015-16
1560411,1560011,West Haven School District,Seth G. Haley School,209,210,419,2015-16
1566111,1560011,West Haven School District,West Haven High School,731,725,1456,2015-16
1540211,1540011,Westbrook School District,Daisy Ingraham School,137,124,261,2015-16
1546111,1540011,Westbrook School District,Westbrook High School,146,141,287,2015-16
1545111,1540011,Westbrook School District,Westbrook Middle School,98,129,227,2015-16
1570111,1570011,Weston School District,Hurlbutt Elementary School,217,229,446,2015-16
1576111,1570011,Weston School District,Weston High School,396,444,840,2015-16
1570211,1570011,Weston School District,Weston Intermediate School,259,272,531,2015-16
1575111,1570011,Weston School District,Weston Middle School,266,316,582,2015-16
1585111,1580011,Westport School District,Bedford Middle School,392,443,835,2015-16
1580111,1580011,Westport School District,CES Segregated,0,7,7,2015-16
1580311,1580011,Westport School District,Coleytown Elementary School,189,215,404,2015-16
1585311,1580011,Westport School District,Coleytown Middle School,270,258,528,2015-16
1580411,1580011,Westport School District,Green's Farms School,211,200,411,2015-16
1580211,1580011,Westport School District,Green's Farms Segregated,*,*,*,2015-16
1580511,1580011,Westport School District,King's Highway Elementary School,244,241,485,2015-16
1580611,1580011,Westport School District,King's Highway Segregated,*,*,6,2015-16
1580711,1580011,Westport School District,Long Lots School,280,280,560,2015-16
1580811,1580011,Westport School District,Saugatuck Elementary School,240,276,516,2015-16
1586111,1580011,Westport School District,Staples High School,924,961,1885,2015-16
1588011,1580011,Westport School District,Stepping Stones Preschool,22,28,50,2015-16
1590811,1590011,Wethersfield School District,Alfred W. Hanmer School,174,179,353,2015-16
1591011,1590011,Wethersfield School District,Charles Wright School,165,161,326,2015-16
1590211,1590011,Wethersfield School District,Emerson-Williams School,206,218,424,2015-16
1591111,1590011,Wethersfield School District,Highcrest School,228,198,426,2015-16
1591211,1590011,Wethersfield School District,Samuel B. Webb Elementary School,169,193,362,2015-16
1595211,1590011,Wethersfield School District,Silas Deane Middle School,276,268,544,2015-16
1596111,1590011,Wethersfield School District,Wethersfield High School,589,596,1185,2015-16
1600111,1600011,Willington School District,Center School,115,133,248,2015-16
1605111,1600011,Willington School District,Hall Memorial School,86,100,186,2015-16
1615211,1610011,Wilton School District,Middlebrook School,483,535,1018,2015-16
1610711,1610011,Wilton School District,Cider Mill School,505,466,971,2015-16
1610511,1610011,Wilton School District,Miller-Driscoll School,375,438,813,2015-16
1616111,1610011,Wilton School District,Wilton High School,692,644,1336,2015-16
1610111,1610011,Wilton School District,Wilton-Westport Evening School,*,*,*,2015-16
1620411,1620011,Winchester School District,Batcheller Early Education Center,61,88,149,2015-16
1620211,1620011,Winchester School District,Mary P. Hinsdale School,104,133,237,2015-16
1625111,1620011,Winchester School District,Pearson Middle School,92,79,171,2015-16
1630411,1630011,Windham School District,Charles H. Barrows STEM Academy,273,278,551,2015-16
1638011,1630011,Windham School District,Early Headstart,10,13,23,2015-16
1630111,1630011,Windham School District,Natchaug School,132,186,318,2015-16
1630811,1630011,Windham School District,North Windham ASD Program,*,*,*,2015-16
1630311,1630011,Windham School District,North Windham School,244,228,472,2015-16
1630911,1630011,Windham School District,Sweeney Medically Fragile Program,*,*,*,2015-16
1630611,1630011,Windham School District,W. B. Sweeney School,131,133,264,2015-16
1630511,1630011,Windham School District,Windham Center School,129,146,275,2015-16
1638311,1630011,Windham School District,Windham Early Childhood Prospect Street,94,92,186,2015-16
1631011,1630011,Windham School District,Windham Early Childhood Tuckie Road,19,28,47,2015-16
1636111,1630011,Windham School District,Windham High School,230,331,561,2015-16
1635111,1630011,Windham School District,Windham Middle School,274,289,563,2015-16
1650111,1650011,Windsor Locks School District,North Street School,217,211,428,2015-16
1650611,1650011,Windsor Locks School District,Pine Meadow Academy,12,19,31,2015-16
1650211,1650011,Windsor Locks School District,RISE Transition Academy,*,*,8,2015-16
1650411,1650011,Windsor Locks School District,South Elementary School,199,182,381,2015-16
1656111,1650011,Windsor Locks School District,Windsor Locks High School,205,229,434,2015-16
1655111,1650011,Windsor Locks School District,Windsor Locks Middle School,163,185,348,2015-16
1640111,1640011,Windsor School District,Clover Street School,145,143,288,2015-16
1640211,1640011,Windsor School District,Community Based Transition Academy,*,*,11,2015-16
1640411,1640011,Windsor School District,Expulsion,*,*,*,2015-16
1640811,1640011,Windsor School District,John F. Kennedy School,188,218,406,2015-16
1640911,1640011,Windsor School District,Oliver Ellsworth School,186,219,405,2015-16
1640611,1640011,Windsor School District,Plato Credit Recovery,*,0,*,2015-16
1640511,1640011,Windsor School District,Poquonock Elementary School,128,158,286,2015-16
1645311,1640011,Windsor School District,Sage Park Middle School,317,356,673,2015-16
1640311,1640011,Windsor School District,Spark,6,6,12,2015-16
1646111,1640011,Windsor School District,Windsor High School,544,552,1096,2015-16
1660311,1660011,Wolcott School District,ABC Classroom,*,*,*,2015-16
1660611,1660011,Wolcott School District,Alcott School,133,152,285,2015-16
1660211,1660011,Wolcott School District,Frisbie School,153,159,312,2015-16
1660411,1660011,Wolcott School District,Phoenix Program,0,*,*,2015-16
1665111,1660011,Wolcott School District,Tyrrell Middle School,295,309,604,2015-16
1660511,1660011,Wolcott School District,Wakelee School,148,181,329,2015-16
1666111,1660011,Wolcott School District,Wolcott High School,384,416,800,2015-16
1670311,1670011,Woodbridge School District,Beecher Road School,387,384,771,2015-16
9036122,9030022,Woodstock Academy District,Woodstock Academy,536,486,1022,2015-16
1690211,1690011,Woodstock School District,Woodstock Elementary School,222,202,424,2015-16
1695111,1690011,Woodstock School District,Woodstock Middle School,213,219,432,2015-16
2880113,2880013,Achievement First Hartford Academy Inc. District,Achievement First Hartford Academy Inc.,560,506,1066,2016-17
2795113,2790013,Amistad Academy District,Amistad Academy,542,515,1057,2016-17
0010111,0010011,Andover School District,Andover Elementary School,98,127,225,2016-17
0026111,0020011,Ansonia School District,Ansonia High School,293,323,616,2016-17
0025111,0020011,Ansonia School District,Ansonia Middle School,206,235,441,2016-17
0020311,0020011,Ansonia School District,Mead School,266,314,580,2016-17
0020111,0020011,Ansonia School District,P.A.C.E. (Positive And Creative Education),12,19,31,2016-17
0020411,0020011,Ansonia School District,P.A.C.E. - PM (Positive And Creative Education - PM),*,*,7,2016-17
0020811,0020011,Ansonia School District,Prendergast School,327,338,665,2016-17
2449614,2440014,Area Cooperative Educational Services,Center for Autism Spectrum and Development Disorders,7,33,40,2016-17
2449414,2440014,Area Cooperative Educational Services,Mill Road School,30,138,168,2016-17
2445114,2440014,Area Cooperative Educational Services,Thomas Edison Magnet Middle School,366,366,732,2016-17
2449514,2440014,Area Cooperative Educational Services,Village School,38,80,118,2016-17
2449214,2440014,Area Cooperative Educational Services,Whitney High School East,36,79,115,2016-17
2449114,2440014,Area Cooperative Educational Services,Whitney High School North,25,77,102,2016-17
2449314,2440014,Area Cooperative Educational Services,Whitney High School West,*,*,41,2016-17
2440314,2440014,Area Cooperative Educational Services,Wintergreen Interdistrict  Magnet School,318,313,631,2016-17
0030111,0030011,Ashford School District,Ashford School,198,208,406,2016-17
0046111,0040011,Avon School District,Avon High School,530,494,1024,2016-17
0045111,0040011,Avon School District,Avon Middle School,248,310,558,2016-17
0040111,0040011,Avon School District,Avon Public Schools Pre-K,23,33,56,2016-17
0040411,0040011,Avon School District,Pine Grove School,326,298,624,2016-17
0040311,0040011,Avon School District,Roaring Brook School,260,256,516,2016-17
0040511,0040011,Avon School District,Thompson Brook School,252,245,497,2016-17
0050111,0050011,Barkhamsted School District,Barkhamsted Elementary School,118,110,228,2016-17
0050211,0050011,Barkhamsted School District,Bridges at Barkhamsted Elementary School,*,*,*,2016-17
0058011,0050011,Barkhamsted School District,Shared Services Integrated Preschool,9,14,23,2016-17
0076111,0070011,Berlin School District,Berlin High School,404,487,891,2016-17
0075111,0070011,Berlin School District,Catherine M. McGee Middle School,334,380,714,2016-17
0070411,0070011,Berlin School District,Emma Hart Willard School,239,243,482,2016-17
0070511,0070011,Berlin School District,Mary E. Griswold School,232,259,491,2016-17
0070111,0070011,Berlin School District,Richard D. Hubbard School,113,100,213,2016-17
0080111,0080011,Bethany School District,Bethany Community School,180,176,356,2016-17
0090411,0090011,Bethel School District,Anna H. Rockwell School,188,209,397,2016-17
0096111,0090011,Bethel School District,Bethel High School,412,459,871,2016-17
0095111,0090011,Bethel School District,Bethel Middle School,316,367,683,2016-17
0090111,0090011,Bethel School District,Frank A. Berry School,237,305,542,2016-17
0090511,0090011,Bethel School District,Ralph M. T. Johnson School,240,239,479,2016-17
0090311,0090011,Bethel School District,TASK,*,*,12,2016-17
0116111,0110011,Bloomfield School District,Bloomfield High School,253,281,534,2016-17
0110711,0110011,Bloomfield School District,Carmen Arace Intermediate School,112,125,237,2016-17
0115211,0110011,Bloomfield School District,Carmen Arace Middle School,101,100,201,2016-17
0116311,0110011,Bloomfield School District,Global Experience Magnet School,126,91,217,2016-17
0110611,0110011,Bloomfield School District,Laurel School,178,184,362,2016-17
0116411,0110011,Bloomfield School District,Learning Academy at Bloomfield,*,*,13,2016-17
0110511,0110011,Bloomfield School District,Metacomet School,130,126,256,2016-17
0110811,0110011,Bloomfield School District,Wintonbury Early Childhood Magnet School,145,178,323,2016-17
0120111,0120011,Bolton School District,Bolton Center School,275,258,533,2016-17
0126111,0120011,Bolton School District,Bolton High School,150,131,281,2016-17
2950113,2950013,Booker T. Washington Academy District,Booker T. Washington Academy,103,138,241,2016-17
0130111,0130011,Bozrah School District,Fields Memorial School,97,111,208,2016-17
0146111,0140011,Branford School District,Branford High School,450,438,888,2016-17
0140211,0140011,Branford School District,Branford High School Horizons Program,16,27,43,2016-17
0145111,0140011,Branford School District,Francis Walsh Intermediate School,425,444,869,2016-17
0148011,0140011,Branford School District,Indian Neck School,18,21,39,2016-17
0141611,0140011,Branford School District,John B. Sliney School,157,172,329,2016-17
0141511,0140011,Branford School District,Mary R. Tisko School,180,203,383,2016-17
0141411,0140011,Branford School District,Mary T. Murphy School,194,219,413,2016-17
3480115,3480015,Branford School District,Bridgeport Detention Center,0,*,*,2016-17
2900113,2900013,Brass City Charter School District,Brass City Charter School,124,95,219,2016-17
2850113,2850013,Bridgeport Achievement First District,Achievement First Bridgeport Academy,543,501,1044,2016-17
0150811,0150011,Bridgeport School District,"Aerospace/Hydrospace, Engineering and Physical Sciences HS at the Fairchild-Wheeler Magnet Campus",159,340,499,2016-17
0150111,0150011,Bridgeport School District,Barnum School,288,345,633,2016-17
0156111,0150011,Bridgeport School District,Bassick High School,432,529,961,2016-17
0150211,0150011,Bridgeport School District,Beardsley School,160,189,349,2016-17
0150611,0150011,Bridgeport School District,"Biotechnology, Research and Zoological Studies HS at the Fairchild-Wheeler Magnet Campus",360,131,491,2016-17
0150311,0150011,Bridgeport School District,Black Rock School,227,238,465,2016-17
0154011,0150011,Bridgeport School District,Blackham School,502,625,1127,2016-17
0159011,0150011,Bridgeport School District,Bridgeport Learning Center,9,55,64,2016-17
0151611,0150011,Bridgeport School District,Bridgeport Military Academy,131,198,329,2016-17
0150411,0150011,Bridgeport School District,Bryant School,194,187,381,2016-17
0152711,0150011,Bridgeport School District,Career and Craftsmanship,21,23,44,2016-17
0156211,0150011,Bridgeport School District,Central High School,751,764,1515,2016-17
0151411,0150011,Bridgeport School District,Cesar Batalla School,532,635,1167,2016-17
0152111,0150011,Bridgeport School District,Classical Studies Academy,198,175,373,2016-17
0150511,0150011,Bridgeport School District,Columbus School,415,428,843,2016-17
0153911,0150011,Bridgeport School District,Cross School,174,213,387,2016-17
0154211,0150011,Bridgeport School District,Curiale School,358,354,712,2016-17
0154111,0150011,Bridgeport School District,Dunbar School,187,220,407,2016-17
0150711,0150011,Bridgeport School District,Edison School,117,146,263,2016-17
0153211,0150011,Bridgeport School District,Geraldine Johnson School,373,414,787,2016-17
0151111,0150011,Bridgeport School District,Hall School,124,118,242,2016-17
0151211,0150011,Bridgeport School District,Hallen School,164,169,333,2016-17
0156311,0150011,Bridgeport School District,Harding High School,464,509,973,2016-17
0154511,0150011,Bridgeport School District,High Horizons Magnet School,233,184,417,2016-17
0151311,0150011,Bridgeport School District,Hooker School,153,168,321,2016-17
0151511,0150011,Bridgeport School District,Information Technology and Software Engineering High School at the Fairchild-Wheeler Magnet Campus,180,322,502,2016-17
0153711,0150011,Bridgeport School District,Interdistrict Discovery Magnet School,252,238,490,2016-17
0152211,0150011,Bridgeport School District,Jettie S. Tisdale School,288,394,682,2016-17
0151011,0150011,Bridgeport School District,Luis Munoz Marin School,443,415,858,2016-17
0152011,0150011,Bridgeport School District,Madison School,238,299,537,2016-17
0154611,0150011,Bridgeport School District,Multicultural Magnet School,261,205,466,2016-17
0152811,0150011,Bridgeport School District,Opportunities for Self-Discovery Community Partnership,*,*,15,2016-17
0151711,0150011,Bridgeport School District,Park City Magnet School,261,248,509,2016-17
0152511,0150011,Bridgeport School District,Read School,432,491,923,2016-17
0152611,0150011,Bridgeport School District,Roosevelt School,307,280,587,2016-17
0154411,0150011,Bridgeport School District,Skane Center,88,132,220,2016-17
0153011,0150011,Bridgeport School District,Waltersville School,244,246,490,2016-17
0153611,0150011,Bridgeport School District,Winthrop School,309,369,678,2016-17
0170211,0170011,Bristol School District,ACCESS,*,0,*,2016-17
0179011,0170011,Bristol School District,Alternative Special Education Program (ASEP),*,*,21,2016-17
0176111,0170011,Bristol School District,Bristol Central High School,545,602,1147,2016-17
0170411,0170011,Bristol School District,Bristol Early Childhood Center-BECC,36,50,86,2016-17
0176211,0170011,Bristol School District,Bristol Eastern High School,567,571,1138,2016-17
0173311,0170011,Bristol School District,Bristol Preparatory Academy,15,31,46,2016-17
0175111,0170011,Bristol School District,Chippens Hill Middle School,374,377,751,2016-17
0171011,0170011,Bristol School District,Chippens Hill Middle School Functional Program,*,*,12,2016-17
0173411,0170011,Bristol School District,Chms Goal,0,7,7,2016-17
0179211,0170011,Bristol School District,Community/Vocational Program,6,6,12,2016-17
0170311,0170011,Bristol School District,Edgewood School,158,170,328,2016-17
0171411,0170011,Bristol School District,Ellen P. Hubbell School,205,210,415,2016-17
0173611,0170011,Bristol School District,Extended Resource Self-Contained,*,*,8,2016-17
0170911,0170011,Bristol School District,Greene-Hills GOAL,0,*,*,2016-17
0170511,0170011,Bristol School District,Greene-Hills School,461,463,924,2016-17
0173711,0170011,Bristol School District,Hubbell Autism Program,*,*,10,2016-17
0172111,0170011,Bristol School District,Hubbell/Extended Resource,7,6,13,2016-17
0172611,0170011,Bristol School District,Ivy Drive GOAL,*,*,*,2016-17
0172311,0170011,Bristol School District,Ivy Drive Medically Fragile,*,*,*,2016-17
0171911,0170011,Bristol School District,Ivy Drive School,183,205,388,2016-17
0171711,0170011,Bristol School District,Mountain View School,193,169,362,2016-17
0172511,0170011,Bristol School District,Mt. View GOAL,*,*,*,2016-17
0172711,0170011,Bristol School District,Northeast MS/Extended Resource,*,*,*,2016-17
0172811,0170011,Bristol School District,Northeast MS/GOAL,*,*,9,2016-17
0175211,0170011,Bristol School District,Northeast Middle School,210,240,450,2016-17
0172911,0170011,Bristol School District,PreK Autism,*,*,8,2016-17
0173011,0170011,Bristol School District,South Side Extended Resource,0,*,*,2016-17
0173111,0170011,Bristol School District,South Side GOAL,*,*,9,2016-17
0171111,0170011,Bristol School District,South Side School,226,242,468,2016-17
0173211,0170011,Bristol School District,Stafford Autism,0,8,8,2016-17
0171211,0170011,Bristol School District,Stafford School,215,233,448,2016-17
0172011,0170011,Bristol School District,West Bristol School,444,441,885,2016-17
0186111,0180011,Brookfield School District,Brookfield High School,427,429,856,2016-17
0180311,0180011,Brookfield School District,Center Elementary School,165,194,359,2016-17
0180411,0180011,Brookfield School District,Huckleberry Hill Elementary School,263,272,535,2016-17
0185311,0180011,Brookfield School District,Whisconier Middle School,457,458,915,2016-17
0190111,0190011,Brooklyn School District,Brooklyn Elementary School,234,267,501,2016-17
0195111,0190011,Brooklyn School District,Brooklyn Middle School,182,170,352,2016-17
0210111,0210011,Canaan School District,Lee H. Kellogg School,36,37,73,2016-17
0220211,0220011,Canterbury School District,Canterbury Elementary School,121,139,260,2016-17
0225111,0220011,Canterbury School District,Dr. Helen Baldwin Middle School,81,125,206,2016-17
0230411,0230011,Canton School District,Canton Academy,*,*,*,2016-17
0236111,0230011,Canton School District,Canton High School,262,234,496,2016-17
0230311,0230011,Canton School District,Canton Intermediate School,186,193,379,2016-17
0235111,0230011,Canton School District,Canton Middle School,141,141,282,2016-17
0230211,0230011,Canton School District,Cherry Brook Primary School,239,217,456,2016-17
2970113,2970013,Capital Preparatory Harbor School Inc. District,Capital Preparatory Harbor School Inc.,119,135,254,2016-17
2415114,2410014,Capitol Region Education Council,Academy of Aerospace and Engineering,201,532,733,2016-17
2410714,2410014,Capitol Region Education Council,Academy of Aerospace and Engineering Elementary,176,213,389,2016-17
2416514,2410014,Capitol Region Education Council,Academy of Science and Innovation,425,149,574,2016-17
2410614,2410014,Capitol Region Education Council,Ana Grace Academy of the Arts Elementary School,229,176,405,2016-17
2418114,2410014,Capitol Region Education Council,Discovery Academy,217,267,484,2016-17
2419214,2410014,Capitol Region Education Council,Farmington Valley Regional Diagnostic Center,*,*,15,2016-17
2410114,2410014,Capitol Region Education Council,Glastonbury/East Hartford Magnet School,194,258,452,2016-17
2416414,2410014,Capitol Region Education Council,Greater Hartford Academy of  the Arts High School - Full Time,329,139,468,2016-17
2415314,2410014,Capitol Region Education Council,Greater Hartford Academy of the Arts Magnet Middle,224,103,327,2016-17
2419414,2410014,Capitol Region Education Council,Integrated Program Models,*,*,*,2016-17
2410414,2410014,Capitol Region Education Council,International Magnet School for Global Citizenship,231,239,470,2016-17
2419014,2410014,Capitol Region Education Council,John J. Allison Polaris Center,18,40,58,2016-17
2419614,2410014,Capitol Region Education Council,Lincoln Academy Regional Interdistrict Collaborative,*,*,7,2016-17
2416114,2410014,Capitol Region Education Council,Metropolitan Learning Center for Global and International Studies,371,317,688,2016-17
2413114,2410014,Capitol Region Education Council,Montessori Magnet School,182,167,349,2016-17
2410514,2410014,Capitol Region Education Council,Museum Academy,234,235,469,2016-17
2415214,2410014,Capitol Region Education Council,Public Safety Academy,173,301,474,2016-17
2410314,2410014,Capitol Region Education Council,Reggio Magnet School of the Arts,232,205,437,2016-17
2419514,2410014,Capitol Region Education Council,River Street Early Learning Center (Site 2),16,49,65,2016-17
2419314,2410014,Capitol Region Education Council,River Street School,17,126,143,2016-17
2419114,2410014,Capitol Region Education Council,Soundbridge,15,17,32,2016-17
2411114,2410014,Capitol Region Education Council,Soundbridge @ Academy of Aerospace & Engineering Elementary,*,*,11,2016-17
2411314,2410014,Capitol Region Education Council,Soundbridge @ Academy of Science and Innovation,*,*,6,2016-17
2411214,2410014,Capitol Region Education Council,Soundbridge @ Museum Academy,*,*,*,2016-17
2419714,2410014,Capitol Region Education Council,Strive (Southern Transition Real-World and Independent Vocational Education Program,*,*,7,2016-17
2416714,2410014,Capitol Region Education Council,Two Rivers Magnet High School,180,228,408,2016-17
2415014,2410014,Capitol Region Education Council,Two Rivers Magnet Middle School,252,406,658,2016-17
2410214,2410014,Capitol Region Education Council,University of Hartford Magnet School,239,215,454,2016-17
0240211,0240011,Chaplin School District,Chaplin Elementary School,74,84,158,2016-17
0250111,0250011,Cheshire School District,Chapman School,161,162,323,2016-17
0256111,0250011,Cheshire School District,Cheshire High School,692,753,1445,2016-17
0250311,0250011,Cheshire School District,Cheshire Quinnipiac University Transition Collaborative,*,*,16,2016-17
0250211,0250011,Cheshire School District,Darcey School,66,91,157,2016-17
0255111,0250011,Cheshire School District,Dodd Middle School,393,390,783,2016-17
0250611,0250011,Cheshire School District,Doolittle School,232,232,464,2016-17
0250411,0250011,Cheshire School District,Highland School,350,372,722,2016-17
0250911,0250011,Cheshire School District,Humiston Alternative School,6,8,14,2016-17
0250511,0250011,Cheshire School District,Norton School,206,212,418,2016-17
0260111,0260011,Chester School District,Chester Elementary School,103,103,206,2016-17
0270111,0270011,Clinton School District,Abraham Pierson School,139,141,280,2016-17
0275111,0270011,Clinton School District,Jared Eliot School,211,240,451,2016-17
0270311,0270011,Clinton School District,Lewin G. Joel Jr. School,234,263,497,2016-17
0276111,0270011,Clinton School District,The Morgan School,290,269,559,2016-17
0286111,0280011,Colchester School District,Bacon Academy,417,391,808,2016-17
0280511,0280011,Colchester School District,Bacon Academy Alternative Education,*,*,12,2016-17
0280411,0280011,Colchester School District,Colchester Elementary School,280,269,549,2016-17
0280211,0280011,Colchester School District,Jack Jackter Intermediate School,249,249,498,2016-17
0285111,0280011,Colchester School District,William J. Johnston Middle School,287,318,605,2016-17
0290111,0290011,Colebrook School District,Colebrook Consolidated School,31,47,78,2016-17
0300111,0300011,Columbia School District,Horace W. Porter School,202,222,424,2016-17
2686113,2680013,Common Ground High School District,Common Ground High School,86,114,200,2016-17
9001516,9000016,Connecticut Technical High School System,A. I. Prince Technical High School,373,347,720,2016-17
9001116,9000016,Connecticut Technical High School System,Bullard-Havens Technical High School,455,325,780,2016-17
9001916,9000016,Connecticut Technical High School System,E. C. Goodwin Technical High School,258,366,624,2016-17
9001416,9000016,Connecticut Technical High School System,Eli Whitney Technical High School,268,278,546,2016-17
9002716,9000016,Connecticut Technical High School System,Ella T. Grasso Southeastern Technical High School,178,306,484,2016-17
9002516,9000016,Connecticut Technical High School System,Emmett O'Brien Technical High School,243,327,570,2016-17
9001716,9000016,Connecticut Technical High School System,H. C. Wilcox Technical High School,316,434,750,2016-17
9001316,9000016,Connecticut Technical High School System,H. H. Ellis Technical High School,194,450,644,2016-17
9001216,9000016,Connecticut Technical High School System,Henry Abbott Technical High School,261,406,667,2016-17
9001616,9000016,Connecticut Technical High School System,Howell Cheney Technical High School,140,484,624,2016-17
9002116,9000016,Connecticut Technical High School System,J. M. Wright Technical High School,145,174,319,2016-17
9002016,9000016,Connecticut Technical High School System,Norwich Technical High School,275,368,643,2016-17
9002216,9000016,Connecticut Technical High School System,Oliver Wolcott Technical High School,270,369,639,2016-17
9002616,9000016,Connecticut Technical High School System,Platt Technical High School,293,490,783,2016-17
9001816,9000016,Connecticut Technical High School System,Vinal Technical High School,152,370,522,2016-17
9002316,9000016,Connecticut Technical High School System,W. F. Kaynor Technical High School,335,432,767,2016-17
9002416,9000016,Connecticut Technical High School System,Windham Technical High School,175,299,474,2016-17
2439214,2430014,Cooperative Educational Services,Developmental Learning Center (DLC),23,64,87,2016-17
2439114,2430014,Cooperative Educational Services,Preschool-Primary Learning Center (PLC),14,37,51,2016-17
2439314,2430014,Cooperative Educational Services,RISE Transitional Program,*,*,14,2016-17
2438014,2430014,Cooperative Educational Services,School Readiness,42,42,84,2016-17
2430114,2430014,Cooperative Educational Services,Six-Six Magnet School,238,228,466,2016-17
2439414,2430014,Cooperative Educational Services,Therapeutic Day Program,25,115,140,2016-17
0310111,0310011,Cornwall School District,Cornwall Consolidated School,28,44,72,2016-17
0325111,0320011,Coventry School District,Capt. Nathan Hale School,195,179,374,2016-17
0320111,0320011,Coventry School District,Coventry Academy,*,*,10,2016-17
0320211,0320011,Coventry School District,Coventry Grammar School,155,180,335,2016-17
0326111,0320011,Coventry School District,Coventry High School,240,225,465,2016-17
0320411,0320011,Coventry School District,George Hersey Robertson School,191,195,386,2016-17
0320311,0320011,Coventry School District,Hale Early Education Center,22,24,46,2016-17
0336111,0330011,Cromwell School District,Cromwell High School,285,278,563,2016-17
0335111,0330011,Cromwell School District,Cromwell Middle School,233,246,479,2016-17
0330211,0330011,Cromwell School District,Edna C. Stevens School,245,264,509,2016-17
0330311,0330011,Cromwell School District,Woodside Intermediate School,200,238,438,2016-17
0346211,0340011,Danbury School District,Alternative Center For Excellence,39,44,83,2016-17
0345111,0340011,Danbury School District,Broadview Middle School,501,510,1011,2016-17
0340111,0340011,Danbury School District,DPS Early Childhood Center,53,81,134,2016-17
0346111,0340011,Danbury School District,Danbury High School,1452,1589,3041,2016-17
0341411,0340011,Danbury School District,Ellsworth Avenue School,221,228,449,2016-17
0341111,0340011,Danbury School District,Great Plain School,164,181,345,2016-17
0340211,0340011,Danbury School District,Hayestown Avenue School,227,240,467,2016-17
0341711,0340011,Danbury School District,King Street Intermediate School,172,184,356,2016-17
0341311,0340011,Danbury School District,King Street Primary School,204,215,419,2016-17
0340511,0340011,Danbury School District,Mill Ridge Primary School,175,174,349,2016-17
0340611,0340011,Danbury School District,Morris Street School,186,187,373,2016-17
0340811,0340011,Danbury School District,Park Avenue School,274,318,592,2016-17
0341511,0340011,Danbury School District,Pembroke School,135,213,348,2016-17
0345211,0340011,Danbury School District,Rogers Park Middle School,472,478,950,2016-17
0341211,0340011,Danbury School District,Shelter Rock School,259,286,545,2016-17
0341011,0340011,Danbury School District,South Street School,207,196,403,2016-17
0341611,0340011,Danbury School District,Stadley Rough School,244,251,495,2016-17
0341911,0340011,Danbury School District,Western CT Academy of International Studies Elementary Magnet School,216,177,393,2016-17
0340711,0340011,Danbury School District,Western Connection,*,*,*,2016-17
0340311,0340011,Danbury School District,Westside Middle School Academy,300,295,595,2016-17
0356111,0350011,Darien School District,Darien High School,678,676,1354,2016-17
0350211,0350011,Darien School District,Hindley Elementary School,244,247,491,2016-17
0350711,0350011,Darien School District,Holmes Elementary School,236,235,471,2016-17
0355111,0350011,Darien School District,Middlesex Middle School,529,604,1133,2016-17
0351311,0350011,Darien School District,Ox Ridge Elementary School,218,234,452,2016-17
0350511,0350011,Darien School District,Royle Elementary School,182,232,414,2016-17
0350611,0350011,Darien School District,Tokeneke Elementary School,249,237,486,2016-17
0360111,0360011,Deep River School District,Deep River Elementary School,132,151,283,2016-17
3370215,3370015,Department of Mental Health and Addiction Services,Connecticut Valley Hospital,*,0,*,2016-17
3370515,3370015,Department of Mental Health and Addiction Services,Greater Bridgeport Community Mental Health Center,*,0,*,2016-17
0370611,0370011,Derby School District,Bradley School,157,169,326,2016-17
0376111,0370011,Derby School District,Derby High School,147,198,345,2016-17
0375011,0370011,Derby School District,Derby Middle School,150,171,321,2016-17
0370411,0370011,Derby School District,Irving School,159,170,329,2016-17
0370111,0370011,Derby School District,Little Raiders University,14,31,45,2016-17
0370511,0370011,Derby School District,RAISE Academy,8,7,15,2016-17
0400111,0400011,East Granby School District,Allgrove School,93,98,191,2016-17
0406111,0400011,East Granby School District,East Granby High School,131,116,247,2016-17
0405111,0400011,East Granby School District,East Granby Middle School,105,115,220,2016-17
0400211,0400011,East Granby School District,R. Dudley Seymour School,97,101,198,2016-17
0410111,0410011,East Haddam School District,East Haddam Elementary School,145,149,294,2016-17
0416111,0410011,East Haddam School District,Nathan Hale-Ray High School,173,161,334,2016-17
0415111,0410011,East Haddam School District,Nathan Hale-Ray Middle School,182,216,398,2016-17
0420311,0420011,East Hampton School District,Center School,166,158,324,2016-17
0426111,0420011,East Hampton School District,East Hampton High School,242,246,488,2016-17
0425111,0420011,East Hampton School District,East Hampton Middle School,196,227,423,2016-17
0420111,0420011,East Hampton School District,Memorial School,316,317,633,2016-17
0429011,0420011,East Hampton School District,The Learning Center at East Hampton,0,*,*,2016-17
3480315,3480015,East Hartford School District,Hartford Detention Center,*,*,9,2016-17
0430911,0430011,East Hartford School District,Anna E. Norris School,144,175,319,2016-17
0436311,0430011,East Hartford School District,Connecticut IB Academy,121,76,197,2016-17
0430611,0430011,East Hartford School District,Dr. Franklin H. Mayberry School,184,177,361,2016-17
0432211,0430011,East Hartford School District,Dr. John A. Langford School,140,189,329,2016-17
0431011,0430011,East Hartford School District,Dr. Thomas S. O'Connell School,277,267,544,2016-17
0436211,0430011,East Hartford School District,East Hartford High School,790,839,1629,2016-17
0435111,0430011,East Hartford School District,East Hartford Middle School,490,549,1039,2016-17
0432011,0430011,East Hartford School District,Governor William Pitkin School,172,183,355,2016-17
0430211,0430011,East Hartford School District,Hockanum Pre-K,138,169,307,2016-17
0430411,0430011,East Hartford School District,Joseph O. Goodwin School,191,172,363,2016-17
0431811,0430011,East Hartford School District,Robert J. O'Brien School,219,211,430,2016-17
0431211,0430011,East Hartford School District,Silver Lane School,146,130,276,2016-17
0436411,0430011,East Hartford School District,Stevens Alternate High School,33,54,87,2016-17
0432411,0430011,East Hartford School District,Sunset Ridge Middle School,155,152,307,2016-17
0439011,0430011,East Hartford School District,Woodland School,29,141,170,2016-17
0441711,0440011,East Haven School District,Carbone School/East Haven Academy,172,181,353,2016-17
0440111,0440011,East Haven School District,Deer Run School,119,134,253,2016-17
0441311,0440011,East Haven School District,Dominick H. Ferrara School,110,82,192,2016-17
0446111,0440011,East Haven School District,East Haven High School,408,513,921,2016-17
0441011,0440011,East Haven School District,Grove J. Tuttle School,130,144,274,2016-17
0445111,0440011,East Haven School District,Joseph Melillo Middle School,281,276,557,2016-17
0440711,0440011,East Haven School District,Momauguin School,146,145,291,2016-17
0441811,0440011,East Haven School District,Overbrook Elementary School,66,64,130,2016-17
0450511,0450011,East Lyme School District,Abilities in Motion (AIM) Program,*,*,13,2016-17
0450611,0450011,East Lyme School District,Coastal Connections,7,15,22,2016-17
0456111,0450011,East Lyme School District,East Lyme High School,511,508,1019,2016-17
0455111,0450011,East Lyme School District,East Lyme Middle School,379,453,832,2016-17
0450111,0450011,East Lyme School District,Flanders School,176,187,363,2016-17
0458011,0450011,East Lyme School District,Integrated Preschool,21,29,50,2016-17
0450411,0450011,East Lyme School District,Lillie B. Haynes School,150,155,305,2016-17
0450711,0450011,East Lyme School District,Medically Fragile Program (WAVES),*,*,*,2016-17
0450211,0450011,East Lyme School District,Niantic Center School,85,84,169,2016-17
0470111,0470011,East Windsor School District,Broad Brook Elementary School,208,222,430,2016-17
0476111,0470011,East Windsor School District,East Windsor High School,136,167,303,2016-17
0475411,0470011,East Windsor School District,East Windsor Middle School,143,160,303,2016-17
0470411,0470011,East Windsor School District,East Windsor Transition Program,*,0,*,2016-17
2536014,2530014,Eastern Connecticut Regional Educational Service Center (EASTCONN),Arts at the Capitol Theater Magnet School (ACT),94,27,121,2016-17
2539014,2530014,Eastern Connecticut Regional Educational Service Center (EASTCONN),EastConn Special Education,24,104,128,2016-17
2536114,2530014,Eastern Connecticut Regional Educational Service Center (EASTCONN),Quinebaug Middle College,99,65,164,2016-17
0390111,0390011,Eastford School District,Eastford Elementary School,62,81,143,2016-17
0465111,0460011,Easton School District,Helen Keller Middle School,162,156,318,2016-17
0460111,0460011,Easton School District,Samuel Staples Elementary School,276,287,563,2016-17
2428014,2420014,EdAdvance,EdAdvance Headstart,118,95,213,2016-17
2429014,2420014,EdAdvance,The ACCESS School at The Danuta M. Thibodeau Education Center,*,*,6,2016-17
0480111,0480011,Ellington School District,Center School,218,212,430,2016-17
0480211,0480011,Ellington School District,Crystal Lake School,107,130,237,2016-17
0486111,0480011,Ellington School District,Ellington High School,369,409,778,2016-17
0485111,0480011,Ellington School District,Ellington Middle School,224,214,438,2016-17
0480611,0480011,Ellington School District,Windermere School,365,396,761,2016-17
2890113,2890013,Elm City College Preparatory School District,Elm City College Preparatory School,383,343,726,2016-17
2910113,2910013,Elm City Montessori School District,Elm City Montessori School,67,73,140,2016-17
0492211,0490011,Enfield School District,EPS Integrated Pre-Kindergarten,27,49,76,2016-17
0491011,0490011,Enfield School District,EPS PK STEAM Academy,21,29,50,2016-17
0490511,0490011,Enfield School District,Edgar H. Parkman - Autism Spectrum Disorder (ASD),*,*,*,2016-17
0491311,0490011,Enfield School District,Edgar H. Parkman School,158,167,325,2016-17
0491411,0490011,Enfield School District,Eli Whitney - Intermediate Adaptive Learning (IAL),*,0,*,2016-17
0491611,0490011,Enfield School District,Eli Whitney School,207,190,397,2016-17
0496111,0490011,Enfield School District,Enfield High School,754,776,1530,2016-17
0490311,0490011,Enfield School District,Enfield Street - Autism Spectrum Disorder (ASD),*,*,8,2016-17
0490211,0490011,Enfield School District,Enfield Street School,138,150,288,2016-17
0499011,0490011,Enfield School District,Enfield Transitional Learning Academy,*,*,10,2016-17
0490411,0490011,Enfield School District,Hazardville Memorial School,136,142,278,2016-17
0498011,0490011,Enfield School District,Head Start Program,48,56,104,2016-17
0490611,0490011,Enfield School District,Henry Barnard - Educational Counseling Program (ECP),0,*,*,2016-17
0491811,0490011,Enfield School District,Henry Barnard School,187,194,381,2016-17
0495211,0490011,Enfield School District,John F. Kennedy Middle School,553,573,1126,2016-17
0490811,0490011,Enfield School District,Nathan Hale - Primary Adaptive Learning (PAL),*,*,6,2016-17
0491111,0490011,Enfield School District,Nathan Hale School,113,118,231,2016-17
0490711,0490011,Enfield School District,Prudence Crandall - Educational Counseling Program (ECP),0,8,8,2016-17
0491511,0490011,Enfield School District,Prudence Crandall School,195,204,399,2016-17
0500111,0500011,Essex School District,Essex Elementary School,178,190,368,2016-17
2726113,2720013,Explorations District,Explorations,59,33,92,2016-17
0510211,0510011,Fairfield School District,Burr Elementary School,197,216,413,2016-17
0510111,0510011,Fairfield School District,Dwight Elementary School,158,179,337,2016-17
0518011,0510011,Fairfield School District,Early Childhood Center,47,80,127,2016-17
0516011,0510011,Fairfield School District,Fairfield Ludlowe High School,776,719,1495,2016-17
0510511,0510011,Fairfield School District,Fairfield School/Community Partnership,*,*,18,2016-17
0516211,0510011,Fairfield School District,Fairfield Warde High School,753,745,1498,2016-17
0515211,0510011,Fairfield School District,Fairfield Woods Middle School,434,460,894,2016-17
0510411,0510011,Fairfield School District,Holland Hill School,206,198,404,2016-17
0511711,0510011,Fairfield School District,Jennings School,132,185,317,2016-17
0510611,0510011,Fairfield School District,McKinley School,229,220,449,2016-17
0510711,0510011,Fairfield School District,Mill Hill School,192,192,384,2016-17
0511611,0510011,Fairfield School District,North Stratfield School,193,204,397,2016-17
0511811,0510011,Fairfield School District,Osborn Hill School,207,238,445,2016-17
0511211,0510011,Fairfield School District,Riverfield School,194,231,425,2016-17
0515311,0510011,Fairfield School District,Roger Ludlowe Middle School,375,398,773,2016-17
0511311,0510011,Fairfield School District,Sherman School,250,234,484,2016-17
0511411,0510011,Fairfield School District,Stratfield School,189,230,419,2016-17
0515111,0510011,Fairfield School District,Tomlinson Middle School,324,360,684,2016-17
0510311,0510011,Fairfield School District,Walter Fitzgerald Campus,14,14,28,2016-17
0520411,0520011,Farmington School District,East Farms School,221,228,449,2016-17
0520611,0520011,Farmington School District,Farmington Alternative High School,*,*,*,2016-17
0528011,0520011,Farmington School District,Farmington Collaborative PK,56,56,112,2016-17
0526111,0520011,Farmington School District,Farmington High School,541,643,1184,2016-17
0525111,0520011,Farmington School District,Irving A. Robbins Middle School,345,329,674,2016-17
0520211,0520011,Farmington School District,Noah Wallace School,181,188,369,2016-17
0520111,0520011,Farmington School District,Union School,145,165,310,2016-17
0520311,0520011,Farmington School District,West District School,155,154,309,2016-17
0520511,0520011,Farmington School District,West Woods Upper Elementary School,316,335,651,2016-17
0530111,0530011,Franklin School District,Franklin Elementary School,82,80,162,2016-17
0540211,0540011,Glastonbury School District,Buttonball Lane School,229,227,456,2016-17
0540311,0540011,Glastonbury School District,Eastbury School,147,119,266,2016-17
0540811,0540011,Glastonbury School District,Gideon Welles School,251,226,477,2016-17
0546111,0540011,Glastonbury School District,Glastonbury High School,1035,956,1991,2016-17
0540411,0540011,Glastonbury School District,Hebron Avenue School,185,207,392,2016-17
0540611,0540011,Glastonbury School District,Hopewell School,169,215,384,2016-17
0540111,0540011,Glastonbury School District,Links Academy,8,16,24,2016-17
0541411,0540011,Glastonbury School District,Links Transition,10,6,16,2016-17
0540711,0540011,Glastonbury School District,Naubuc School,174,177,351,2016-17
0540911,0540011,Glastonbury School District,Nayaug Elementary School,281,275,556,2016-17
0540511,0540011,Glastonbury School District,PreK-Eastbury,11,19,30,2016-17
0541011,0540011,Glastonbury School District,PreK-Nayaug,7,13,20,2016-17
0545211,0540011,Glastonbury School District,Smith Middle School,511,499,1010,2016-17
0566111,0560011,Granby School District,Granby Memorial High School,319,339,658,2016-17
0565111,0560011,Granby School District,Granby Memorial Middle School,213,222,435,2016-17
0560411,0560011,Granby School District,Kelly Lane Primary School,204,188,392,2016-17
0560311,0560011,Granby School District,Wells Road Intermediate School,197,192,389,2016-17
2940113,2940013,Great Oaks Charter School District,Great Oaks Charter School,155,169,324,2016-17
0575111,0570011,Greenwich School District,Central Middle School,275,283,558,2016-17
0571211,0570011,Greenwich School District,Community Connections,*,*,7,2016-17
0570211,0570011,Greenwich School District,Cos Cob School,216,230,446,2016-17
0575211,0570011,Greenwich School District,Eastern Middle School,424,422,846,2016-17
0570411,0570011,Greenwich School District,Glenville School,208,236,444,2016-17
0571411,0570011,Greenwich School District,Greenwich Alternative High School,9,13,22,2016-17
0576111,0570011,Greenwich School District,Greenwich High School,1269,1356,2625,2016-17
0570511,0570011,Greenwich School District,Hamilton Avenue School,199,198,397,2016-17
0571311,0570011,Greenwich School District,International School At Dundee,197,186,383,2016-17
0570311,0570011,Greenwich School District,Julian Curtiss School,158,172,330,2016-17
0570611,0570011,Greenwich School District,New Lebanon School,121,136,257,2016-17
0570711,0570011,Greenwich School District,North Mianus School,227,269,496,2016-17
0570811,0570011,Greenwich School District,North Street School,187,236,423,2016-17
0570911,0570011,Greenwich School District,Old Greenwich School,197,238,435,2016-17
0571111,0570011,Greenwich School District,Parkway School,119,141,260,2016-17
0571011,0570011,Greenwich School District,Riverside School,209,259,468,2016-17
0575311,0570011,Greenwich School District,Western Middle School,288,270,558,2016-17
0580111,0580011,Griswold School District,Griswold Alternative School,*,*,13,2016-17
0580311,0580011,Griswold School District,Griswold Elementary School,351,368,719,2016-17
0586211,0580011,Griswold School District,Griswold High School,298,270,568,2016-17
0585111,0580011,Griswold School District,Griswold Middle School,266,272,538,2016-17
0595311,0590011,Groton School District,Carl C. Cutler Middle School,224,273,497,2016-17
0592011,0590011,Groton School District,Catherine Kolnaski Magnet School,179,198,377,2016-17
0591811,0590011,Groton School District,Charles Barnum School,181,194,375,2016-17
0590311,0590011,Groton School District,Claude Chester School,148,150,298,2016-17
0591711,0590011,Groton School District,Mary Morrisson School,187,176,363,2016-17
0590211,0590011,Groton School District,New Beginnings Alternative Program,9,15,24,2016-17
0591911,0590011,Groton School District,Northeast Academy Elementary School,196,194,390,2016-17
0591211,0590011,Groton School District,Pleasant Valley School,151,150,301,2016-17
0596111,0590011,Groton School District,Robert E. Fitch High School,528,525,1053,2016-17
0590111,0590011,Groton School District,S. B. Butler School,133,153,286,2016-17
0591011,0590011,Groton School District,Transition Academy,*,*,9,2016-17
0590611,0590011,Groton School District,Virtual Learning Academy,*,*,*,2016-17
0595211,0590011,Groton School District,West Side Middle School,240,216,456,2016-17
0600711,0600011,Guilford School District,A. Baldwin Middle School,274,303,577,2016-17
0600611,0600011,Guilford School District,A. W. Cox School,148,141,289,2016-17
0600411,0600011,Guilford School District,Calvin Leete School,101,139,240,2016-17
0605111,0600011,Guilford School District,E. C. Adams Middle School,260,275,535,2016-17
0606111,0600011,Guilford School District,Guilford High School,580,543,1123,2016-17
0600211,0600011,Guilford School District,Guilford Lakes School,139,168,307,2016-17
0600311,0600011,Guilford School District,Melissa Jones School,158,158,316,2016-17
0628011,0620011,Hamden School District,Alice Peck Learning Center,47,90,137,2016-17
0621211,0620011,Hamden School District,Bear Path School,197,248,445,2016-17
0620211,0620011,Hamden School District,Church Street School,162,157,319,2016-17
0620311,0620011,Hamden School District,Dunbar Hill School,144,155,299,2016-17
0620511,0620011,Hamden School District,Hamden Collaborative Learning Center,12,29,41,2016-17
0626111,0620011,Hamden School District,Hamden High School,744,813,1557,2016-17
0625211,0620011,Hamden School District,Hamden Middle School,407,405,812,2016-17
0620611,0620011,Hamden School District,Hamden Transition Academy @ SCSU (AACPB),*,*,11,2016-17
0620411,0620011,Hamden School District,Helen Street School,157,190,347,2016-17
0621111,0620011,Hamden School District,Ridge Hill School,167,169,336,2016-17
0620111,0620011,Hamden School District,Shepherd Glen School,154,167,321,2016-17
0621011,0620011,Hamden School District,Spring Glen School,230,202,432,2016-17
0621411,0620011,Hamden School District,West Woods School,186,186,372,2016-17
0630111,0630011,Hampton School District,Hampton Elementary School,42,63,105,2016-17
0640711,0640011,Hartford School District,Asian Studies Academy at Bellizzi School,289,345,634,2016-17
0648611,0640011,Hartford School District,Autism Program - Burr School,*,*,9,2016-17
0644311,0640011,Hartford School District,Autism Program - Hooker School,*,*,6,2016-17
0645711,0640011,Hartford School District,Autism Program - Naylor School,*,*,26,2016-17
0644411,0640011,Hartford School District,Autism Program - Rawson School,6,39,45,2016-17
0649311,0640011,Hartford School District,Autism Program - Simpson-Waverly School,*,*,11,2016-17
0640411,0640011,Hartford School District,Batchelder School,196,237,433,2016-17
0642811,0640011,Hartford School District,Betances Early Reading Lab Magnet School,163,136,299,2016-17
0643811,0640011,Hartford School District,Betances STEM Magnet School,142,233,375,2016-17
0643511,0640011,Hartford School District,Breakthrough II Magnet School,132,134,266,2016-17
0643311,0640011,Hartford School District,Breakthrough Magnet School,179,181,360,2016-17
0647111,0640011,Hartford School District,Bulkeley High School,302,386,688,2016-17
0640611,0640011,Hartford School District,Burns Latino Studies Academy,227,269,496,2016-17
0642311,0640011,Hartford School District,Burr School,281,335,616,2016-17
0643911,0640011,Hartford School District,Capital Community College Magnet Academy,43,14,57,2016-17
0646911,0640011,Hartford School District,Capital Preparatory Magnet School,273,283,556,2016-17
0646411,0640011,Hartford School District,Classical Magnet School,306,254,560,2016-17
0646011,0640011,Hartford School District,Culinary Arts Academy at Weaver High School,80,88,168,2016-17
0649411,0640011,Hartford School District,DDP - Simpson-Waverly School,*,*,10,2016-17
0648311,0640011,Hartford School District,EDP - Bulkeley High School,*,*,13,2016-17
0648211,0640011,Hartford School District,EDP - HPHS Engineering and Green Technology Academy,9,22,31,2016-17
0645911,0640011,Hartford School District,EDP - M.D. Fox School,*,*,35,2016-17
0644611,0640011,Hartford School District,EDP - West Middle School,0,15,15,2016-17
0644111,0640011,Hartford School District,Early Childhood Development Center (ECDC),6,10,16,2016-17
0640911,0640011,Hartford School District,Environmental Sciences Magnet at Hooker School,289,321,610,2016-17
0643211,0640011,Hartford School District,Expeditionary Learning Academy at Moylan School,233,268,501,2016-17
0643611,0640011,Hartford School District,Global Communications Academy,325,292,617,2016-17
0647911,0640011,Hartford School District,Great Path Academy at MCC,164,108,272,2016-17
0647211,0640011,Hartford School District,HPHS Engineering and Green Technology Academy,74,272,346,2016-17
0647411,0640011,Hartford School District,HPHS Law and Government Academy,140,174,314,2016-17
0647511,0640011,Hartford School District,HPHS Nursing and Health Sciences Academy,272,111,383,2016-17
0645411,0640011,Hartford School District,Hartford Magnet Trinity College Academy,565,459,1024,2016-17
0641311,0640011,Hartford School District,Hartford PreKindergarten Magnet School,73,84,157,2016-17
0647611,0640011,Hartford School District,"High School, Inc.",114,122,236,2016-17
0648411,0640011,Hartford School District,High Step Transition,9,8,17,2016-17
0647711,0640011,Hartford School District,Journalism and Media Academy Magnet School,112,78,190,2016-17
0641011,0640011,Hartford School District,Kennelly School,273,284,557,2016-17
0641111,0640011,Hartford School District,Kinsella Magnet School of Performing Arts,594,319,913,2016-17
0649511,0640011,Hartford School District,LC - Breakthrough II School,*,*,8,2016-17
0649611,0640011,Hartford School District,LC - Burns School,*,*,*,2016-17
0649811,0640011,Hartford School District,LC - Moylan School,*,*,6,2016-17
0640811,0640011,Hartford School District,M. D. Fox School,333,314,647,2016-17
0641611,0640011,Hartford School District,"M. L. King, Jr. School",136,158,294,2016-17
0644811,0640011,Hartford School District,MDP - Batchelder School,9,10,19,2016-17
0645011,0640011,Hartford School District,MDP - Bulkeley High School,7,17,24,2016-17
0644911,0640011,Hartford School District,MDP - HPHS Law and Government Academy,15,33,48,2016-17
0648511,0640011,Hartford School District,MDP - Moylan School,*,*,9,2016-17
0641211,0640011,Hartford School District,McDonough Middle School,126,135,261,2016-17
0641911,0640011,Hartford School District,Milner School,146,146,292,2016-17
0643711,0640011,Hartford School District,Montessori Magnet at Fisher School,163,173,336,2016-17
0640511,0640011,Hartford School District,Montessori Magnet at Moylan School,168,136,304,2016-17
0641411,0640011,Hartford School District,Naylor/CCSU Leadership Academy,324,312,636,2016-17
0641511,0640011,Hartford School District,Parkville Community School,255,279,534,2016-17
0646611,0640011,Hartford School District,Pathways Academy of Technology and Design,122,299,421,2016-17
0641711,0640011,Hartford School District,Rawson School,185,198,383,2016-17
0644011,0640011,Hartford School District,Renzulli Gifted and Talented Academy,70,61,131,2016-17
0640111,0640011,Hartford School District,SAND School,174,188,362,2016-17
0642511,0640011,Hartford School District,STEM Magnet at Fisher School,149,217,366,2016-17
0643011,0640011,Hartford School District,Sanchez School,206,190,396,2016-17
0642611,0640011,Hartford School District,Simpson-Waverly School,167,147,314,2016-17
0646511,0640011,Hartford School District,Sports and Medical Sciences Academy,292,417,709,2016-17
0646711,0640011,Hartford School District,University High School of Science and Engineering,144,287,431,2016-17
0642011,0640011,Hartford School District,Webster Micro Society Magnet School,313,320,633,2016-17
0642111,0640011,Hartford School District,West Middle School,225,224,449,2016-17
0642211,0640011,Hartford School District,Wish Museum School,210,219,429,2016-17
0650111,0650011,Hartland School District,Hartland School,85,104,189,2016-17
0670211,0670011,Hebron School District,Gilead Hill School,153,153,306,2016-17
0670111,0670011,Hebron School District,Hebron Elementary School,189,210,399,2016-17
2860113,2860013,Highville Charter School District,Highville Charter School,259,243,502,2016-17
2640113,2640013,Integrated Day Charter School District,Integrated Day Charter School,166,164,330,2016-17
2655113,2650013,Interdistrict School for Arts and Comm District,Interdistrict School For Arts And Communication,140,130,270,2016-17
2610113,2610013,Jumoke Academy District,Jumoke Academy,395,358,753,2016-17
0680111,0680011,Kent School District,Kent Center School,112,123,235,2016-17
0698011,0690011,Killingly School District,Goodyear Early Childhood Center,61,72,133,2016-17
0690611,0690011,Killingly School District,Killingly Alternative Learning Program,8,9,17,2016-17
0690111,0690011,Killingly School District,Killingly Central School,180,189,369,2016-17
0696111,0690011,Killingly School District,Killingly High School,421,402,823,2016-17
0695211,0690011,Killingly School District,Killingly Intermediate School,356,327,683,2016-17
0690311,0690011,Killingly School District,Killingly Memorial School,246,247,493,2016-17
2456014,2450014,Learn,Connecticut River Academy,254,200,454,2016-17
2455014,2450014,Learn,Dual Language & Arts Magnet Middle School,74,73,147,2016-17
2451214,2450014,Learn,Learn ABA Program at Center School,*,*,8,2016-17
2451114,2450014,Learn,Learn Haynes Elementary Intensive Program,*,*,16,2016-17
2450614,2450014,Learn,Learn High School ABA,*,*,*,2016-17
2450714,2450014,Learn,Learn Ledyard RICHES Program,*,*,*,2016-17
2450514,2450014,Learn,Learn Pathways Program,0,*,*,2016-17
2450814,2450014,Learn,Learn SAILS Middle School Program,0,*,*,2016-17
2451014,2450014,Learn,Learn SAILS Program at Salem,*,*,6,2016-17
2450414,2450014,Learn,Learn STS 18-21 Year Old Program,*,*,*,2016-17
2456114,2450014,Learn,Marine Science Magnet High School of Southeastern Connecticut,145,126,271,2016-17
2450114,2450014,Learn,Regional Multicultural Magnet School,256,279,535,2016-17
2450314,2450014,Learn,Riverside Magnet School at Goodwin College,203,191,394,2016-17
2450214,2450014,Learn,The Friendship School,253,252,505,2016-17
2456214,2450014,Learn,Three Rivers Middle College Magnet School,52,15,67,2016-17
0710111,0710011,Lebanon School District,Lebanon Elementary School,160,192,352,2016-17
0715111,0710011,Lebanon School District,Lebanon Middle School,146,149,295,2016-17
0716211,0710011,Lebanon School District,Lyman Memorial High School,198,166,364,2016-17
0720211,0720011,Ledyard School District,Gales Ferry School,107,108,215,2016-17
0720411,0720011,Ledyard School District,Gallup Hill School,166,169,335,2016-17
0720311,0720011,Ledyard School District,Juliet W. Long School,132,152,284,2016-17
0720111,0720011,Ledyard School District,Ledyard Center School,189,213,402,2016-17
0726111,0720011,Ledyard School District,Ledyard High School,416,381,797,2016-17
0725111,0720011,Ledyard School District,Ledyard Middle School,166,166,332,2016-17
0730111,0730011,Lisbon School District,Lisbon Central School,215,178,393,2016-17
0740211,0740011,Litchfield School District,Center School,137,159,296,2016-17
0746111,0740011,Litchfield School District,Litchfield High School,141,151,292,2016-17
0740311,0740011,Litchfield School District,Litchfield Intermediate School,86,102,188,2016-17
0746011,0740011,Litchfield School District,Litchfield Middle School,83,77,160,2016-17
0766111,0760011,Madison School District,Daniel Hand High School,578,575,1153,2016-17
0760611,0760011,Madison School District,Dr. Robert H. Brown Middle School,188,226,414,2016-17
0760211,0760011,Madison School District,Island Avenue Elementary School,130,139,269,2016-17
0760111,0760011,Madison School District,J. Milton Jeffrey Elementary School,158,169,327,2016-17
0760311,0760011,Madison School District,Kathleen H. Ryerson Elementary School,112,123,235,2016-17
0769011,0760011,Madison School District,Town Campus Learning Center,18,28,46,2016-17
0765211,0760011,Madison School District,Walter C. Polson Upper Middle School,208,279,487,2016-17
3480315,3480015,Manchester School District,Hartford Detention Center,*,*,9,2016-17
3481115,3480015,Manchester School District,BRAVE,0,*,*,2016-17
0770211,0770011,Manchester School District,Bentley Alternative Education Program,18,25,43,2016-17
0770111,0770011,Manchester School District,Bowers School,196,218,414,2016-17
0770311,0770011,Manchester School District,Buckley School,168,207,375,2016-17
0771111,0770011,Manchester School District,Elementary Site 2,*,*,*,2016-17
0771711,0770011,Manchester School District,Elisabeth M. Bennet Academy,186,221,407,2016-17
0770411,0770011,Manchester School District,Highland Park School,140,132,272,2016-17
0775311,0770011,Manchester School District,Illing Middle School,417,394,811,2016-17
0770611,0770011,Manchester School District,Keeney School,170,191,361,2016-17
0776111,0770011,Manchester School District,Manchester High School,783,772,1555,2016-17
0770811,0770011,Manchester School District,Manchester Preschool - Site 2,*,*,12,2016-17
0778011,0770011,Manchester School District,Manchester Preschool Center,89,90,179,2016-17
0779011,0770011,Manchester School District,Manchester Regional Academy,19,51,70,2016-17
0779111,0770011,Manchester School District,Manchester Transition Center,7,11,18,2016-17
0771611,0770011,Manchester School District,Martin School,137,129,266,2016-17
0770711,0770011,Manchester School District,New Horizons,*,*,18,2016-17
0771011,0770011,Manchester School District,Robertson School,176,187,363,2016-17
0771211,0770011,Manchester School District,Verplanck School,191,199,390,2016-17
0771311,0770011,Manchester School District,Waddell School,169,178,347,2016-17
0771411,0770011,Manchester School District,Washington School,164,180,344,2016-17
0780411,0780011,Mansfield School District,Annie E. Vinton School,124,130,254,2016-17
0780211,0780011,Mansfield School District,Dorothy C. Goodwin School,103,97,200,2016-17
0785111,0780011,Mansfield School District,Mansfield Middle School,245,288,533,2016-17
0780511,0780011,Mansfield School District,Southeast Elementary School,127,100,227,2016-17
0790111,0790011,Marlborough School District,Elmer Thienes-Mary Hall Elementary School,243,292,535,2016-17
0800711,0800011,Meriden School District,Nathan Hale School,296,317,613,2016-17
0800111,0800011,Meriden School District,Benjamin Franklin School,180,165,345,2016-17
0801111,0800011,Meriden School District,Casimir Pulaski School,253,279,532,2016-17
0800211,0800011,Meriden School District,Community Classroom Collaborative-Meriden School District,*,*,10,2016-17
0806111,0800011,Meriden School District,Francis T. Maloney High School,565,626,1191,2016-17
0800311,0800011,Meriden School District,Hanover School,264,322,586,2016-17
0800411,0800011,Meriden School District,Israel Putnam School,300,267,567,2016-17
0800511,0800011,Meriden School District,John Barry School,235,241,476,2016-17
0805211,0800011,Meriden School District,Lincoln Middle School,372,353,725,2016-17
0806211,0800011,Meriden School District,Orville H. Platt High School,453,518,971,2016-17
0800811,0800011,Meriden School District,Roger Sherman School,264,320,584,2016-17
0801511,0800011,Meriden School District,STARS-MS,0,6,6,2016-17
0800611,0800011,Meriden School District,STARS-Meriden School District,8,34,42,2016-17
0800911,0800011,Meriden School District,STEP-Meriden School District,6,13,19,2016-17
0801211,0800011,Meriden School District,Steps-Meriden School District,*,*,20,2016-17
0801411,0800011,Meriden School District,Success Academy,19,16,35,2016-17
0801011,0800011,Meriden School District,Thomas Hooker School,195,222,417,2016-17
0801311,0800011,Meriden School District,Venture Academy-Meriden School District,10,30,40,2016-17
0805411,0800011,Meriden School District,Washington Middle School,336,373,709,2016-17
3480315,3480015,Middletown School District,Hartford Detention Center,*,*,9,2016-17
3480415,3480015,Middletown School District,SAGE,0,*,*,2016-17
0830211,0830011,Middletown School District,Bielefield School,147,141,288,2016-17
0831611,0830011,Middletown School District,Evening Program - MHS,*,*,10,2016-17
0830511,0830011,Middletown School District,Farm Hill School,177,156,333,2016-17
0830611,0830011,Middletown School District,ICM - Farm Hill,0,*,*,2016-17
0830711,0830011,Middletown School District,ICM - Lawrence,0,6,6,2016-17
0832011,0830011,Middletown School District,ICM - Spencer,0,7,7,2016-17
0830811,0830011,Middletown School District,ICM - Wesley,*,*,6,2016-17
0830411,0830011,Middletown School District,ICM- Woodrow Wilson Middle School,*,*,*,2016-17
0831511,0830011,Middletown School District,Keigwin Middle School,149,147,296,2016-17
0831311,0830011,Middletown School District,Lawrence School,133,145,278,2016-17
0831811,0830011,Middletown School District,MHS - Alternative Education Program 1,*,*,7,2016-17
0831911,0830011,Middletown School District,MHS - Alternative Education Program 2,*,*,7,2016-17
0830911,0830011,Middletown School District,MacDonough School,109,110,219,2016-17
0836211,0830011,Middletown School District,Middletown High School,630,608,1238,2016-17
0831211,0830011,Middletown School District,Moody School,117,133,250,2016-17
0832111,0830011,Middletown School District,STEM - Macdonough,14,10,24,2016-17
0831111,0830011,Middletown School District,Snow School,196,208,404,2016-17
0830111,0830011,Middletown School District,Spencer School,118,144,262,2016-17
0839111,0830011,Middletown School District,Transition to Life Center,6,20,26,2016-17
0831711,0830011,Middletown School District,Virtual Learning Academy - MHS,*,*,8,2016-17
0831411,0830011,Middletown School District,Wesley School,112,139,251,2016-17
0835411,0830011,Middletown School District,Woodrow Wilson Middle School,334,361,695,2016-17
0840111,0840011,Milford School District,Calf Pen Meadow School,138,134,272,2016-17
0845111,0840011,Milford School District,East Shore Middle School,228,207,435,2016-17
0840411,0840011,Milford School District,Fifth Year Vocational Experience,*,*,8,2016-17
0845211,0840011,Milford School District,Harborside Middle School,231,299,530,2016-17
0841911,0840011,Milford School District,J. F. Kennedy School,165,189,354,2016-17
0846211,0840011,Milford School District,Jonathan Law High School,427,438,865,2016-17
0846311,0840011,Milford School District,Joseph A. Foran High School,439,464,903,2016-17
0841611,0840011,Milford School District,Live Oaks School,152,150,302,2016-17
0841711,0840011,Milford School District,Mathewson School,208,202,410,2016-17
0840711,0840011,Milford School District,Meadowside School,166,131,297,2016-17
0840811,0840011,Milford School District,Orange Avenue School,158,251,409,2016-17
0841811,0840011,Milford School District,Orchard Hills School,170,179,349,2016-17
0840611,0840011,Milford School District,Post Grad Transitional Academy,*,*,*,2016-17
0841011,0840011,Milford School District,Pumpkin Delight School,127,133,260,2016-17
0840311,0840011,Milford School District,The Academy,15,20,35,2016-17
0845311,0840011,Milford School District,West Shore Middle School,227,223,450,2016-17
0850511,0850011,Monroe School District,Fawn Hollow Elementary School,262,253,515,2016-17
0855211,0850011,Monroe School District,Jockey Hollow School,387,395,782,2016-17
0850211,0850011,Monroe School District,Masuk Alternative Program,*,*,9,2016-17
0856111,0850011,Monroe School District,Masuk High School,512,539,1051,2016-17
0850111,0850011,Monroe School District,Monroe Elementary School,197,178,375,2016-17
0850311,0850011,Monroe School District,Stepney Elementary School,222,225,447,2016-17
0860711,0860011,Montville School District,Dr. Charles E. Murphy School,149,180,329,2016-17
0865111,0860011,Montville School District,Leonard J. Tyl Middle School,294,265,559,2016-17
0860111,0860011,Montville School District,Mohegan School,154,175,329,2016-17
0866111,0860011,Montville School District,Montville High School,315,321,636,2016-17
0860511,0860011,Montville School District,Oakdale School,140,141,281,2016-17
0869011,0860011,Montville School District,Palmer Academy,9,14,23,2016-17
0860311,0860011,Montville School District,Pre School Program,19,24,43,2016-17
0880811,0880011,Naugatuck School District,Andrew Avenue School,136,143,279,2016-17
0888211,0880011,Naugatuck School District,Central Avenue Preschool,7,24,31,2016-17
0885111,0880011,Naugatuck School District,City Hill Middle School,313,352,665,2016-17
0880211,0880011,Naugatuck School District,Cross Street Intermediate School,147,168,315,2016-17
0880911,0880011,Naugatuck School District,Genesis Academy,10,10,20,2016-17
0888111,0880011,Naugatuck School District,Head Start,64,55,119,2016-17
0880411,0880011,Naugatuck School District,Hillside Intermediate School,160,172,332,2016-17
0880511,0880011,Naugatuck School District,Hop Brook Elementary School,149,174,323,2016-17
0880311,0880011,Naugatuck School District,Maple Hill School,214,233,447,2016-17
0886111,0880011,Naugatuck School District,Naugatuck High School,555,663,1218,2016-17
0880611,0880011,Naugatuck School District,Salem School,123,145,268,2016-17
0880711,0880011,Naugatuck School District,Western School,126,130,256,2016-17
2800113,2800013,New Beginnings Inc Family Academy District,New Beginnings Inc Family Academy,246,253,499,2016-17
0891011,0890011,New Britain School District,Behavior Support (Holmes),*,*,10,2016-17
0899111,0890011,New Britain School District,Brook Side School,18,36,54,2016-17
0899411,0890011,New Britain School District,CLIMB,7,15,22,2016-17
0890311,0890011,New Britain School District,Chamberlain  Elementary School,239,254,493,2016-17
0891111,0890011,New Britain School District,Frank J. DiLoreto School,459,391,850,2016-17
0890511,0890011,New Britain School District,Gaffney School,260,333,593,2016-17
0890611,0890011,New Britain School District,Holmes School,242,252,494,2016-17
0895411,0890011,New Britain School District,House of Arts Letters and Science (HALS)  Academy,73,74,147,2016-17
0890711,0890011,New Britain School District,Jefferson School,218,237,455,2016-17
0891611,0890011,New Britain School District,KEY Elementary (Gaffney),13,30,43,2016-17
0891711,0890011,New Britain School District,KEY Middle (Slade),*,*,14,2016-17
0890811,0890011,New Britain School District,Lincoln School,313,356,669,2016-17
0896111,0890011,New Britain School District,New Britain High School,1040,1158,2198,2016-17
0899011,0890011,New Britain School District,New Britain Transition Center,17,34,51,2016-17
0890911,0890011,New Britain School District,Northend School,134,120,254,2016-17
0895311,0890011,New Britain School District,Pulaski Middle School,368,423,791,2016-17
0890111,0890011,New Britain School District,Roosevelt Early Learning Center,56,109,165,2016-17
0899511,0890011,New Britain School District,Satellite Careers Academy,70,87,157,2016-17
0895211,0890011,New Britain School District,Slade Middle School,354,453,807,2016-17
0891211,0890011,New Britain School District,Smalley Academy,345,340,685,2016-17
0891311,0890011,New Britain School District,Smith School,278,288,566,2016-17
0890411,0890011,New Britain School District,Sunrise Intermediate (Holmes),0,7,7,2016-17
0890211,0890011,New Britain School District,Sunrise Primary (Chamberlain),*,*,24,2016-17
0891511,0890011,New Britain School District,Vance School,266,249,515,2016-17
0900411,0900011,New Canaan School District,East School,268,279,547,2016-17
0906111,0900011,New Canaan School District,New Canaan High School,616,650,1266,2016-17
0905111,0900011,New Canaan School District,Saxe Middle School,660,699,1359,2016-17
0900211,0900011,New Canaan School District,South School,273,272,545,2016-17
0900311,0900011,New Canaan School District,West School,247,277,524,2016-17
0910311,0910011,New Fairfield School District,Alternative Learning Center,*,*,13,2016-17
0910111,0910011,New Fairfield School District,Consolidated School,243,259,502,2016-17
0910211,0910011,New Fairfield School District,Meeting House Hill School,227,261,488,2016-17
0916111,0910011,New Fairfield School District,New Fairfield High School,402,442,844,2016-17
0915211,0910011,New Fairfield School District,New Fairfield Middle School,262,278,540,2016-17
0920311,0920011,New Hartford School District,Ann Antolini School,149,129,278,2016-17
0920111,0920011,New Hartford School District,Bakerville Consolidated School,46,53,99,2016-17
0920211,0920011,New Hartford School District,New Hartford Elementary School,34,32,66,2016-17
0931211,0930011,New Haven School District,Edgewood School,219,208,427,2016-17
0931411,0930011,New Haven School District,Nathan Hale School,269,281,550,2016-17
0931511,0930011,New Haven School District,Augusta Lewis Troup School,217,254,471,2016-17
0930211,0930011,New Haven School District,Barnard Environmental Magnet School,274,288,562,2016-17
0930311,0930011,New Haven School District,Beecher School,244,259,503,2016-17
0933411,0930011,New Haven School District,Benjamin Jepson Head Start,*,*,12,2016-17
0931811,0930011,New Haven School District,Benjamin Jepson Magnet School,244,271,515,2016-17
0935511,0930011,New Haven School District,Betsy Ross Arts Magnet School,302,146,448,2016-17
0934311,0930011,New Haven School District,Bishop Woods Architecture and Design Magnet School,267,226,493,2016-17
0937911,0930011,New Haven School District,Bishop Woods Self Contained Autism,0,11,11,2016-17
0932111,0930011,New Haven School District,Brennan Rogers School,263,279,542,2016-17
0937211,0930011,New Haven School District,Brennan Rogers Self Contained Autism,*,*,21,2016-17
0934811,0930011,New Haven School District,"Celentano BioTech, Health and Medical Magnet School",197,192,389,2016-17
0937411,0930011,New Haven School District,Celentano Self Contained ID,*,*,11,2016-17
0930611,0930011,New Haven School District,Clinton Avenue School,250,268,518,2016-17
0937811,0930011,New Haven School District,Clinton Self Contained ID,*,*,10,2016-17
0934111,0930011,New Haven School District,Columbus Family Academy,233,254,487,2016-17
0933111,0930011,New Haven School District,Conte/West Hills Magnet School,329,316,645,2016-17
0936411,0930011,New Haven School District,Cooperative High School,460,184,644,2016-17
0936811,0930011,New Haven School District,Cortlandt V.R. Creed Health and Sport Sciences High School,80,142,222,2016-17
0930911,0930011,New Haven School District,Davis 21st Century Magnet Elementary School,264,247,511,2016-17
0935611,0930011,New Haven School District,Domus Academy,8,21,29,2016-17
0932711,0930011,New Haven School District,Dr. Reginald Mayo Early Learning Center,235,223,458,2016-17
0934611,0930011,New Haven School District,East Rock Community Magnet School,245,245,490,2016-17
0937511,0930011,New Haven School District,East Rock Self Contained MD,10,19,29,2016-17
0931711,0930011,New Haven School District,Engineering - Science University Magnet School,190,411,601,2016-17
0931611,0930011,New Haven School District,Fair Haven School,421,453,874,2016-17
0938711,0930011,New Haven School District,Fair Haven Self Contained ID,*,*,*,2016-17
0938011,0930011,New Haven School District,Headstart,99,121,220,2016-17
0938311,0930011,New Haven School District,Helene Grant HeadStart,18,18,36,2016-17
0936611,0930011,New Haven School District,High School In The Community,135,116,251,2016-17
0930711,0930011,New Haven School District,Hill Central Music Academy,236,251,487,2016-17
0936311,0930011,New Haven School District,Hill Regional Career High School,385,263,648,2016-17
0936211,0930011,New Haven School District,James Hillhouse High School,398,515,913,2016-17
0931311,0930011,New Haven School District,John C. Daniels,249,276,525,2016-17
0930811,0930011,New Haven School District,John S. Martinez Sea and Sky STEM School,258,279,537,2016-17
0933011,0930011,New Haven School District,King/Robinson Magnet School,264,272,536,2016-17
0932011,0930011,New Haven School District,Lincoln-Bassett School,180,202,382,2016-17
0931911,0930011,New Haven School District,Mauro-Sheridan Magnet School,248,289,537,2016-17
0936011,0930011,New Haven School District,Metropolitan Business Academy,199,208,407,2016-17
0937711,0930011,New Haven School District,Nathan Hale Self Contained ID,*,*,10,2016-17
0937011,0930011,New Haven School District,New Haven Academy,145,143,288,2016-17
0932211,0930011,New Haven School District,New Horizons High School,39,54,93,2016-17
0932611,0930011,New Haven School District,New Light High School,17,47,64,2016-17
0937311,0930011,New Haven School District,Off-Campus Classroom Program (OCC),17,28,45,2016-17
0933511,0930011,New Haven School District,Quinnipiac Real World Math STEM School,169,161,330,2016-17
0939111,0930011,New Haven School District,Riverside Education Academy,42,44,86,2016-17
0934211,0930011,New Haven School District,Roberto Clemente Leadership Academy for Global Awareness,240,240,480,2016-17
0931011,0930011,New Haven School District,Ross/Woodward School,354,335,689,2016-17
0936711,0930011,New Haven School District,Sound School,160,173,333,2016-17
0932811,0930011,New Haven School District,Strong 21st Century Communications Magnet and SCSU Lab School,175,169,344,2016-17
0937611,0930011,New Haven School District,Strong Self Contained Autism,*,*,21,2016-17
0932911,0930011,New Haven School District,Truman School,256,277,533,2016-17
0934911,0930011,New Haven School District,West Rock Authors Academy,99,110,209,2016-17
0938411,0930011,New Haven School District,West Rock Self Contained Autism,*,*,11,2016-17
0938611,0930011,New Haven School District,Wexler Grant Self Contained,0,*,*,2016-17
0933211,0930011,New Haven School District,Wexler/Grant Community School,205,230,435,2016-17
0936111,0930011,New Haven School District,Wilbur Cross High School,732,756,1488,2016-17
0938511,0930011,New Haven School District,Wilbur Cross Self Contained MD,10,11,21,2016-17
0933811,0930011,New Haven School District,Worthington Hooker School,225,219,444,2016-17
0950311,0950011,New London School District,Jennings School,283,251,534,2016-17
0955111,0950011,New London School District,Bennie Dover Jackson Middle School,194,222,416,2016-17
0950611,0950011,New London School District,Harbor,113,111,224,2016-17
0950911,0950011,New London School District,Nathan Hale Arts Magnet School,295,228,523,2016-17
0956111,0950011,New London School District,New London High School,265,320,585,2016-17
0951411,0950011,New London School District,New London Visual and Performing Arts Magnet School,53,52,105,2016-17
0950711,0950011,New London School District,Pre-Kindergarten at Winthrop,*,*,*,2016-17
0951311,0950011,New London School District,Science and Technology Magnet School of Southeastern Connecticut,254,305,559,2016-17
0950811,0950011,New London School District,Winthrop STEM Elementary Magnet School,244,316,560,2016-17
0960511,0960011,New Milford School District,Hill And Plain School,211,234,445,2016-17
0969011,0960011,New Milford School District,Litchfield Hills Transition Center,*,*,19,2016-17
0966111,0960011,New Milford School District,New Milford High School,652,714,1366,2016-17
0960811,0960011,New Milford School District,Northville Elementary School,219,228,447,2016-17
0960911,0960011,New Milford School District,Sarah Noble Intermediate School,433,470,903,2016-17
0965211,0960011,New Milford School District,Schaghticoke Middle School,478,547,1025,2016-17
3480415,3480015,Newington School District,SAGE,0,*,*,2016-17
0940611,0940011,Newington School District,Anna Reynolds School,239,241,480,2016-17
0940211,0940011,Newington School District,Elizabeth Green School,148,148,296,2016-17
0940811,0940011,Newington School District,John Paterson School,187,184,371,2016-17
0945311,0940011,Newington School District,John Wallace Middle School,302,386,688,2016-17
0945111,0940011,Newington School District,Martin Kellogg Middle School,303,296,599,2016-17
0946111,0940011,Newington School District,Newington High School,625,644,1269,2016-17
0940711,0940011,Newington School District,Ruth Chaffee School,182,165,347,2016-17
0970111,0970011,Newtown School District,Hawley Elementary School,155,145,300,2016-17
0970411,0970011,Newtown School District,Head O'Meadow Elementary School,132,141,273,2016-17
0970311,0970011,Newtown School District,Middle Gate Elementary School,181,184,365,2016-17
0976111,0970011,Newtown School District,Newtown High School,810,874,1684,2016-17
0975111,0970011,Newtown School District,Newtown Middle School,353,397,750,2016-17
0978011,0970011,Newtown School District,Newtown Preschool,16,44,60,2016-17
0970511,0970011,Newtown School District,Reed Intermediate School,332,327,659,2016-17
0970211,0970011,Newtown School District,Sandy Hook Elementary School,183,173,356,2016-17
0980111,0980011,Norfolk School District,Botelle Elementary School,46,56,102,2016-17
0990411,0990011,North Branford School District,Jerome Harrison School,190,211,401,2016-17
0996111,0990011,North Branford School District,North Branford High School,309,268,577,2016-17
0995111,0990011,North Branford School District,North Branford Intermediate School,239,223,462,2016-17
0999011,0990011,North Branford School District,School to Work Program,*,*,*,2016-17
0990611,0990011,North Branford School District,Totoket Valley Elementary School,168,223,391,2016-17
1000111,1000011,North Canaan School District,North Canaan Elementary School,142,136,278,2016-17
1010811,1010011,North Haven School District,Clintonville Elementary School,154,164,318,2016-17
1010711,1010011,North Haven School District,Green Acres Elementary School,180,189,369,2016-17
1010211,1010011,North Haven School District,Montowese Elementary School,138,138,276,2016-17
1016111,1010011,North Haven School District,North Haven High School,492,523,1015,2016-17
1015211,1010011,North Haven School District,North Haven Middle School,365,381,746,2016-17
1010111,1010011,North Haven School District,North Haven Transition Partnership,*,*,6,2016-17
1010311,1010011,North Haven School District,Ridge Road Elementary School,211,194,405,2016-17
1020111,1020011,North Stonington School District,North Stonington Elementary School,177,194,371,2016-17
1026111,1020011,North Stonington School District,Wheeler High School,164,195,359,2016-17
1036211,1030011,Norwalk School District,Brien McMahon High School,707,774,1481,2016-17
1030211,1030011,Norwalk School District,Brookside Elementary School,212,244,456,2016-17
1030511,1030011,Norwalk School District,Center for Global Studies,193,97,290,2016-17
1030311,1030011,Norwalk School District,Columbus Magnet School,181,161,342,2016-17
1030411,1030011,Norwalk School District,Cranbury Elementary School,218,230,448,2016-17
1032011,1030011,Norwalk School District,Fox Run Elementary School,195,251,446,2016-17
1030711,1030011,Norwalk School District,Jefferson Magnet School,271,323,594,2016-17
1030811,1030011,Norwalk School District,Kendall Elementary School,270,267,537,2016-17
1032211,1030011,Norwalk School District,Marvin Elementary School,213,234,447,2016-17
1032111,1030011,Norwalk School District,Naramake Elementary School,203,203,406,2016-17
1035211,1030011,Norwalk School District,Nathan Hale Middle School,313,344,657,2016-17
1030111,1030011,Norwalk School District,Norwalk Early Childhood Center,64,107,171,2016-17
1036111,1030011,Norwalk School District,Norwalk High School,751,865,1616,2016-17
1036311,1030011,Norwalk School District,Norwalk Pathways Academy at Briggs,20,29,49,2016-17
1035311,1030011,Norwalk School District,Ponus Ridge Middle School,336,356,692,2016-17
1035511,1030011,Norwalk School District,Roton Middle School,245,240,485,2016-17
1031311,1030011,Norwalk School District,Rowayton School,217,208,425,2016-17
1032311,1030011,Norwalk School District,Silvermine Elementary School,217,255,472,2016-17
1031411,1030011,Norwalk School District,Tracey School,165,222,387,2016-17
1035411,1030011,Norwalk School District,West Rocks Middle School,347,341,688,2016-17
1032411,1030011,Norwalk School District,Wolfpit School,144,179,323,2016-17
9010322,9010022,Norwich Free Academy District,Alternative Pathways to Success,*,*,7,2016-17
9010222,9010022,Norwich Free Academy District,Night School,*,*,8,2016-17
9016122,9010022,Norwich Free Academy District,Norwich Free Academy,1191,1132,2323,2016-17
1041011,1040011,Norwich School District,Transition Academy,*,*,18,2016-17
1049211,1040011,Norwich School District,Virtual Learning Academy,*,*,9,2016-17
1040411,1040011,Norwich School District,ABA Autism Program,*,*,20,2016-17
1041111,1040011,Norwich School District,ABA Program @ Kelly,*,*,6,2016-17
1040111,1040011,Norwich School District,Bishop School Early Learning Center,85,119,204,2016-17
1040211,1040011,Norwich School District,Case Street Early Learning Center at DTZ,25,35,60,2016-17
1040911,1040011,Norwich School District,IRS Program at Moriarty,*,*,*,2016-17
1041411,1040011,Norwich School District,John B. Stanton Network School,164,167,331,2016-17
1045111,1040011,Norwich School District,Kelly Middle School,347,353,700,2016-17
1042011,1040011,Norwich School District,Moriarty Magnet School,204,202,406,2016-17
1040811,1040011,Norwich School District,Samuel Huntington School,179,176,355,2016-17
1040511,1040011,Norwich School District,Special Needs Program,*,*,13,2016-17
1045211,1040011,Norwich School District,Teachers' Memorial Middle School,168,163,331,2016-17
1041711,1040011,Norwich School District,Thomas W. Mahan School,132,141,273,2016-17
1041911,1040011,Norwich School District,Uncas Network School,112,130,242,2016-17
1041811,1040011,Norwich School District,Veterans' Memorial School,158,157,315,2016-17
1041511,1040011,Norwich School District,Wequonnoc Magnet School,116,143,259,2016-17
2635113,2630013,Odyssey Community School District,Odyssey Community School,162,166,328,2016-17
1060211,1060011,Old Saybrook School District,Kathleen E. Goodwin School,178,185,363,2016-17
1065211,1060011,Old Saybrook School District,Old Saybrook Middle School,246,251,497,2016-17
1066111,1060011,Old Saybrook School District,Old Saybrook Senior High School,235,216,451,2016-17
1070211,1070011,Orange School District,Mary L. Tracy School,97,97,194,2016-17
1070511,1070011,Orange School District,Peck Place School,171,174,345,2016-17
1070311,1070011,Orange School District,Race Brook School,155,188,343,2016-17
1070411,1070011,Orange School District,Turkey Hill School,130,153,283,2016-17
1080411,1080011,Oxford School District,Alternative Education,*,*,14,2016-17
1085111,1080011,Oxford School District,Great Oak School,261,235,496,2016-17
1080111,1080011,Oxford School District,Oxford Center School,221,215,436,2016-17
1086011,1080011,Oxford School District,Oxford High School,298,301,599,2016-17
1080311,1080011,Oxford School District,Quaker Farms School,189,204,393,2016-17
2835113,2830013,Park City Prep Charter School District,Park City Prep Charter School,168,192,360,2016-17
2930113,2930013,Path Academy District,Path Academy,67,90,157,2016-17
1098011,1090011,Plainfield School District,Early Childhood Center,12,8,20,2016-17
1090111,1090011,Plainfield School District,Moosup Elementary School,168,141,309,2016-17
1095111,1090011,Plainfield School District,Plainfield Central School,255,251,506,2016-17
1096111,1090011,Plainfield School District,Plainfield High School,332,337,669,2016-17
1090311,1090011,Plainfield School District,Plainfield Memorial School,170,174,344,2016-17
1090411,1090011,Plainfield School District,Shepard Hill Elementary School,194,231,425,2016-17
1100411,1100011,Plainville School District,Frank T. Wheeler School,145,154,299,2016-17
1100211,1100011,Plainville School District,Linden Street School,214,200,414,2016-17
1100511,1100011,Plainville School District,Louis Toffolon School,181,205,386,2016-17
1105211,1100011,Plainville School District,Middle School of Plainville,254,294,548,2016-17
1106111,1100011,Plainville School District,Plainville High School,340,360,700,2016-17
1115111,1110011,Plymouth School District,Eli Terry Jr. Middle School,170,168,338,2016-17
1110411,1110011,Plymouth School District,Harry S. Fisher Elementary School,157,184,341,2016-17
1110211,1110011,Plymouth School District,Plymouth Center School,144,169,313,2016-17
1116111,1110011,Plymouth School District,Terryville High School,221,272,493,2016-17
1120111,1120011,Pomfret School District,Pomfret Community School,176,199,375,2016-17
1130511,1130011,Portland School District,Brownstone Intermediate School,98,111,209,2016-17
1130411,1130011,Portland School District,Gildersleeve School,138,157,295,2016-17
1136111,1130011,Portland School District,Portland High School,192,184,376,2016-17
1135111,1130011,Portland School District,Portland Middle School,103,113,216,2016-17
1130211,1130011,Portland School District,Valley View School,111,123,234,2016-17
1145111,1140011,Preston School District,Preston Plains School,76,62,138,2016-17
1140411,1140011,Preston School District,Preston Veterans' Memorial School,147,140,287,2016-17
1169011,1160011,Putnam School District,Helping Hands,0,*,*,2016-17
1160111,1160011,Putnam School District,PALS - Putnam Alternative Learning System,*,*,*,2016-17
1160311,1160011,Putnam School District,Putnam Elementary School,308,311,619,2016-17
1166111,1160011,Putnam School District,Putnam High School,153,127,280,2016-17
1165111,1160011,Putnam School District,Putnam Middle School,139,129,268,2016-17
1175111,1170011,Redding School District,John Read Middle School,213,223,436,2016-17
1170111,1170011,Redding School District,Redding Elementary School,237,263,500,2016-17
2010512,2010012,Regional School District 01,ALPSS,0,*,*,2016-17
2016112,2010012,Regional School District 01,Housatonic Valley Regional High School,207,205,412,2016-17
2010412,2010012,Regional School District 01,LEAPSS,*,*,*,2016-17
2010312,2010012,Regional School District 01,SELC,*,*,*,2016-17
2010212,2010012,Regional School District 01,TOTAL,0,*,*,2016-17
2045112,2040012,Regional School District 04,John Winthrop Middle School,176,157,333,2016-17
2040112,2040012,Regional School District 04,Region 4 Transition Academy,*,*,6,2016-17
2046112,2040012,Regional School District 04,Valley Regional High School,304,302,606,2016-17
2055112,2050012,Regional School District 05,Amity Middle School: Bethany,183,187,370,2016-17
2055212,2050012,Regional School District 05,Amity Middle School: Orange,210,190,400,2016-17
2056112,2050012,Regional School District 05,Amity Regional High School,726,726,1452,2016-17
2060112,2060012,Regional School District 06,Goshen Center School,110,84,194,2016-17
2060212,2060012,Regional School District 06,James Morris School,72,76,148,2016-17
2066112,2060012,Regional School District 06,Wamogo Regional High School,289,259,548,2016-17
2060312,2060012,Regional School District 06,Warren Elementary School,42,40,82,2016-17
2079112,2070012,Regional School District 07,AIM,*,*,7,2016-17
2079012,2070012,Regional School District 07,FLEX,*,*,8,2016-17
2070112,2070012,Regional School District 07,Highlander Transition Academy,10,9,19,2016-17
2079212,2070012,Regional School District 07,Links,*,*,16,2016-17
2076112,2070012,Regional School District 07,Northwestern Regional High School,379,326,705,2016-17
2075112,2070012,Regional School District 07,Northwestern Regional Middle School,167,159,326,2016-17
2079312,2070012,Regional School District 07,STEP,*,*,12,2016-17
2086112,2080012,Regional School District 08,RHAM High School,498,527,1025,2016-17
2085112,2080012,Regional School District 08,RHAM Middle School,255,259,514,2016-17
2096112,2090012,Regional School District 09,Joel Barlow High School,442,510,952,2016-17
2105112,2100012,Regional School District 10,Har-Bur Middle School,359,418,777,2016-17
2100312,2100012,Regional School District 10,Harwinton Consolidated School,188,184,372,2016-17
2100212,2100012,Regional School District 10,Lake Garda Elementary School,210,233,443,2016-17
2106112,2100012,Regional School District 10,Lewis S. Mills High School,373,387,760,2016-17
2116112,2110012,Regional School District 11,Parish Hill High School,114,132,246,2016-17
2120212,2120012,Regional School District 12,Booth Free School,45,41,86,2016-17
2120312,2120012,Regional School District 12,Shepaug Valley School,202,207,409,2016-17
2120112,2120012,Regional School District 12,The Burnham School,23,24,47,2016-17
2120412,2120012,Regional School District 12,Washington Primary School,89,76,165,2016-17
2136112,2130012,Regional School District 13,Coginchaug Regional High School,264,283,547,2016-17
2135112,2130012,Regional School District 13,Frank Ward Strong School,130,167,297,2016-17
2130112,2130012,Regional School District 13,Frederick Brewster School,119,141,260,2016-17
2130512,2130012,Regional School District 13,John Lyman School,149,112,261,2016-17
2130412,2130012,Regional School District 13,Middlefield Memorial School,181,168,349,2016-17
2130312,2130012,Regional School District 13,Middlesex Transition Academy,10,15,25,2016-17
2140112,2140012,Regional School District 14,Bethlehem Elementary School,128,126,254,2016-17
2148012,2140012,Regional School District 14,Integrated Star Preschool Program,17,21,38,2016-17
2140212,2140012,Regional School District 14,Mitchell Elementary School,178,196,374,2016-17
2146112,2140012,Regional School District 14,Nonnewaug High School,415,307,722,2016-17
2140412,2140012,Regional School District 14,Region 14 Transition Academy,0,*,*,2016-17
2145112,2140012,Regional School District 14,Woodbury Middle School,187,181,368,2016-17
2150412,2150012,Regional School District 15,Gainfield Elementary School,169,194,363,2016-17
2150712,2150012,Regional School District 15,Long Meadow Elementary School,226,287,513,2016-17
2150112,2150012,Regional School District 15,MIJ Program,7,9,16,2016-17
2155212,2150012,Regional School District 15,Memorial Middle School,211,237,448,2016-17
2150612,2150012,Regional School District 15,Middlebury Elementary School,148,155,303,2016-17
2156212,2150012,Regional School District 15,Pomperaug Regional High School,562,657,1219,2016-17
2150512,2150012,Regional School District 15,Pomperaug School,166,182,348,2016-17
2155112,2150012,Regional School District 15,Rochambeau Middle School,244,250,494,2016-17
2160112,2160012,Regional School District 16,Laurel Ledge School,162,196,358,2016-17
2165112,2160012,Regional School District 16,Long River Middle School,277,271,548,2016-17
2160512,2160012,Regional School District 16,Prospect Elementary School,303,300,603,2016-17
2160412,2160012,Regional School District 16,WRHS Alternative Education Program,*,*,12,2016-17
2166012,2160012,Regional School District 16,Woodland Regional High School,345,335,680,2016-17
2170212,2170012,Regional School District 17,Burr District Elementary School,127,150,277,2016-17
2170112,2170012,Regional School District 17,Haddam Elementary School,79,110,189,2016-17
2176112,2170012,Regional School District 17,Haddam-Killingworth High School,335,308,643,2016-17
2175112,2170012,Regional School District 17,Haddam-Killingworth Middle School,337,390,727,2016-17
2170312,2170012,Regional School District 17,Killingworth Elementary School,119,144,263,2016-17
2170412,2170012,Regional School District 17,RSD17 Transition Program,*,*,*,2016-17
2180312,2180012,Regional School District 18,Center School,23,22,45,2016-17
2180412,2180012,Regional School District 18,Alternative Program,*,*,*,2016-17
2180112,2180012,Regional School District 18,Lyme Consolidated School,96,105,201,2016-17
2186112,2180012,Regional School District 18,Lyme-Old Lyme High School,249,238,487,2016-17
2185112,2180012,Regional School District 18,Lyme-Old Lyme Middle School,158,163,321,2016-17
2180212,2180012,Regional School District 18,Mile Creek School,129,118,247,2016-17
2196112,2190012,Regional School District 19,E. O. Smith High School,599,538,1137,2016-17
2190112,2190012,Regional School District 19,E.O. Smith High School at the Depot Campus,6,10,16,2016-17
2190212,2190012,Regional School District 19,PM Panthers,8,12,20,2016-17
2190312,2190012,Regional School District 19,STAAR Program,8,11,19,2016-17
1188011,1180011,Ridgefield School District,Alternative High School,6,9,15,2016-17
1180811,1180011,Ridgefield School District,Barlow Mountain Elementary School,151,170,321,2016-17
1180611,1180011,Ridgefield School District,Branchville Elementary School,171,180,351,2016-17
1181011,1180011,Ridgefield School District,District Program ERMS,0,*,*,2016-17
1180711,1180011,Ridgefield School District,District Program RES,*,*,8,2016-17
1180911,1180011,Ridgefield School District,District Program SES,*,*,*,2016-17
1181111,1180011,Ridgefield School District,District Program SRMS,0,*,*,2016-17
1185111,1180011,Ridgefield School District,East Ridge Middle School,398,386,784,2016-17
1180411,1180011,Ridgefield School District,Farmingville Elementary School,156,172,328,2016-17
1180311,1180011,Ridgefield School District,Ridgebury Elementary School,166,174,340,2016-17
1189011,1180011,Ridgefield School District,Ridgefield 18-21 Transition Program,0,6,6,2016-17
1186111,1180011,Ridgefield School District,Ridgefield High School,843,823,1666,2016-17
1180511,1180011,Ridgefield School District,Scotland Elementary School,191,181,372,2016-17
1185211,1180011,Ridgefield School District,Scotts Ridge Middle School,228,251,479,2016-17
1180211,1180011,Ridgefield School District,Veterans Park Elementary School,145,147,292,2016-17
1195111,1190011,Rocky Hill School District,Albert D. Griswold Middle School,296,304,600,2016-17
1190111,1190011,Rocky Hill School District,Alternative Learning Program,*,*,*,2016-17
1190411,1190011,Rocky Hill School District,Myrtle H. Stevens School,290,265,555,2016-17
1190311,1190011,Rocky Hill School District,Pathways,*,*,*,2016-17
1196111,1190011,Rocky Hill School District,Rocky Hill High School,352,374,726,2016-17
1190511,1190011,Rocky Hill School District,West Hill School,365,359,724,2016-17
1210111,1210011,Salem School District,Salem Elementary School,206,196,402,2016-17
1220111,1220011,Salisbury School District,Salisbury Central School,143,137,280,2016-17
1230111,1230011,Scotland School District,Scotland Elementary School,68,48,116,2016-17
1240111,1240011,Seymour School District,Bungay School,218,225,443,2016-17
1240211,1240011,Seymour School District,Chatfield-LoPresti School,243,258,501,2016-17
1246111,1240011,Seymour School District,Seymour High School,317,337,654,2016-17
1245111,1240011,Seymour School District,Seymour Middle School,279,272,551,2016-17
1250111,1250011,Sharon School District,Sharon Center School,79,71,150,2016-17
1260911,1260011,Shelton School District,Mohegan School,120,149,269,2016-17
1260211,1260011,Shelton School District,Alternative Learning Center 1,0,6,6,2016-17
1261311,1260011,Shelton School District,Alternative Learning Center 2,*,*,*,2016-17
1261011,1260011,Shelton School District,Booth Hill School,160,183,343,2016-17
1260511,1260011,Shelton School District,Elizabeth Shelton School,225,227,452,2016-17
1265111,1260011,Shelton School District,Intermediate School,381,402,783,2016-17
1260311,1260011,Shelton School District,Life Skills,*,*,*,2016-17
1260811,1260011,Shelton School District,Long Hill School,178,230,408,2016-17
1261111,1260011,Shelton School District,Perry Hill Elementary School,362,380,742,2016-17
1260111,1260011,Shelton School District,Pre-Kindergarten,17,37,54,2016-17
1266111,1260011,Shelton School District,Shelton High School,736,745,1481,2016-17
1260611,1260011,Shelton School District,Sunnyside School,110,109,219,2016-17
1261211,1260011,Shelton School District,Therapeutic Learning Center,0,*,*,2016-17
1260711,1260011,Shelton School District,Transition Program,*,*,14,2016-17
1270111,1270011,Sherman School District,Sherman School,152,161,313,2016-17
2700113,2700013,Side By Side Charter School District,Side By Side Charter School,126,110,236,2016-17
3480415,3480015,Simsbury School District,SAGE,0,*,*,2016-17
1280111,1280011,Simsbury School District,Central School,162,196,358,2016-17
1280211,1280011,Simsbury School District,Farmington Valley Transition Academy,14,17,31,2016-17
1285111,1280011,Simsbury School District,Henry James Memorial School,323,366,689,2016-17
1280611,1280011,Simsbury School District,Latimer Lane School,210,178,388,2016-17
1286111,1280011,Simsbury School District,Simsbury High School,668,744,1412,2016-17
1280711,1280011,Simsbury School District,Squadron Line School,316,343,659,2016-17
1280311,1280011,Simsbury School District,Tariffville School,132,124,256,2016-17
1280411,1280011,Simsbury School District,Tootin' Hills School,173,176,349,2016-17
1290511,1290011,Somers School District,Aspire,*,*,8,2016-17
1295111,1290011,Somers School District,Mabelle B. Avery Middle School,171,187,358,2016-17
1290411,1290011,Somers School District,Somers Elementary School,290,300,590,2016-17
1296111,1290011,Somers School District,Somers High School,230,237,467,2016-17
1320211,1320011,South Windsor School District,Pleasant Valley School,172,188,360,2016-17
1320711,1320011,South Windsor School District,Eli Terry School,217,222,439,2016-17
1320611,1320011,South Windsor School District,Orchard Hill School,213,209,422,2016-17
1320111,1320011,South Windsor School District,Philip R. Smith School,146,166,312,2016-17
1329011,1320011,South Windsor School District,Project Worth Young Adult Academy,*,*,8,2016-17
1326211,1320011,South Windsor School District,South Windsor High School,644,682,1326,2016-17
1325111,1320011,South Windsor School District,Timothy Edwards School,472,492,964,2016-17
1320411,1320011,South Windsor School District,Wapping Elementary School,164,164,328,2016-17
3480315,3480015,Southington School District,Hartford Detention Center,*,*,9,2016-17
1315311,1310011,Southington School District,John F. Kennedy Middle School,423,378,801,2016-17
1311711,1310011,Southington School District,Achieve,*,*,7,2016-17
1310111,1310011,Southington School District,Alta,14,29,43,2016-17
1311511,1310011,Southington School District,Derynoski Elementary School,267,295,562,2016-17
1310511,1310011,Southington School District,EASE,*,*,12,2016-17
1311311,1310011,Southington School District,Flanders Elementary School,129,142,271,2016-17
1310211,1310011,Southington School District,Hatton Elementary School,161,187,348,2016-17
1315111,1310011,Southington School District,Joseph A. Depaolo Middle School,386,411,797,2016-17
1312311,1310011,Southington School District,Language Based Classroom II,0,9,9,2016-17
1310411,1310011,Southington School District,Language Based Classroom at Hatton School,0,7,7,2016-17
1311811,1310011,Southington School District,"Language Based Classroom, Multihandicapped",*,*,8,2016-17
1310611,1310011,Southington School District,Plantsville Elementary School,146,133,279,2016-17
1312211,1310011,Southington School District,STELLAR,*,*,8,2016-17
1310711,1310011,Southington School District,South End Elementary School,116,113,229,2016-17
1316211,1310011,Southington School District,Southington High School,1030,973,2003,2016-17
1312111,1310011,Southington School District,Southington Public Schools Preschool Program,7,19,26,2016-17
1312011,1310011,Southington School District,Southington Public Schools Preschool Program at Hatton School,30,51,81,2016-17
1310811,1310011,Southington School District,Strong Elementary School,135,141,276,2016-17
1310911,1310011,Southington School District,Thalberg Elementary School,221,215,436,2016-17
1311611,1310011,Southington School District,Therapeutic Educational Alternative Model (TEAM),0,10,10,2016-17
1311211,1310011,Southington School District,Therapeutic Educational Setting (TEP),*,*,9,2016-17
1311411,1310011,Southington School District,Urbin T. Kelley School,148,167,315,2016-17
1330111,1330011,Sprague School District,Sayles School,149,187,336,2016-17
1340611,1340011,Stafford School District,Stafford Elementary School,242,238,480,2016-17
1346111,1340011,Stafford School District,Stafford High School,203,196,399,2016-17
1345211,1340011,Stafford School District,Stafford Middle School,153,175,328,2016-17
1340211,1340011,Stafford School District,Stafford Tutoring Program,*,*,9,2016-17
1340311,1340011,Stafford School District,Staffordville School,85,76,161,2016-17
1340411,1340011,Stafford School District,West Stafford School,58,81,139,2016-17
2826013,2820013,Stamford Academy District,Stamford Academy,64,84,148,2016-17
2960113,2960013,Stamford Charter School for Excellence District,Stamford Charter School for Excellence,110,107,217,2016-17
1350411,1350011,Stamford School District,Alternate Routes To Success,31,37,68,2016-17
1350111,1350011,Stamford School District,Apples PreK,49,113,162,2016-17
1355611,1350011,Stamford School District,Cloonan School,254,282,536,2016-17
1352011,1350011,Stamford School District,Davenport Ridge School,324,327,651,2016-17
1355311,1350011,Stamford School District,Dolan School,219,259,478,2016-17
1352211,1350011,Stamford School District,Hart School,289,353,642,2016-17
1350211,1350011,Stamford School District,Individuals Achieving Independence,9,12,21,2016-17
1351211,1350011,Stamford School District,Julia A. Stark School,286,315,601,2016-17
1350511,1350011,Stamford School District,K. T. Murphy School,244,292,536,2016-17
1350711,1350011,Stamford School District,New School at 200 Strawberry Hill Avenue,117,112,229,2016-17
1350611,1350011,Stamford School District,Newfield School,300,315,615,2016-17
1351811,1350011,Stamford School District,Northeast School,317,319,636,2016-17
1358011,1350011,Stamford School District,Preschool Team,19,51,70,2016-17
1355811,1350011,Stamford School District,Rippowam Middle School,356,347,703,2016-17
1350811,1350011,Stamford School District,Rogers International School,421,398,819,2016-17
1350911,1350011,Stamford School District,Roxbury School,280,321,601,2016-17
1355711,1350011,Stamford School District,Scofield Middle School,341,333,674,2016-17
1351111,1350011,Stamford School District,Springdale School,342,300,642,2016-17
1356111,1350011,Stamford School District,Stamford High School,863,902,1765,2016-17
1352111,1350011,Stamford School District,Stillmeadow School,318,397,715,2016-17
1356411,1350011,Stamford School District,The Academy of Information Technology,292,374,666,2016-17
1351911,1350011,Stamford School District,Toquam Magnet School,300,378,678,2016-17
1355511,1350011,Stamford School District,Turn of River School,309,315,624,2016-17
1356311,1350011,Stamford School District,Westhill High School,1124,1014,2138,2016-17
1351411,1350011,Stamford School District,Westover School,354,361,715,2016-17
1360311,1360011,Sterling School District,Sterling Community School,198,226,424,2016-17
3480415,3480015,Stonington School District,SAGE,0,*,*,2016-17
1370811,1370011,Stonington School District,Community Classroom,*,0,*,2016-17
1370511,1370011,Stonington School District,Deans Mill School,190,189,379,2016-17
1375211,1370011,Stonington School District,Mystic Middle School,176,193,369,2016-17
1375111,1370011,Stonington School District,Pawcatuck Middle School,134,145,279,2016-17
1370711,1370011,Stonington School District,SAILS,*,*,*,2016-17
1370111,1370011,Stonington School District,Stonington BOE Pre-School,*,*,20,2016-17
1370211,1370011,Stonington School District,Stonington HS PreK,14,6,20,2016-17
1376111,1370011,Stonington School District,Stonington High School,346,340,686,2016-17
1370411,1370011,Stonington School District,West Broad Street School,63,78,141,2016-17
1370611,1370011,Stonington School District,West Vine Street School,95,83,178,2016-17
1381311,1380011,Stratford School District,Eli Whitney School,233,247,480,2016-17
1382511,1380011,Stratford School District,ABA Nichols,*,*,*,2016-17
1380611,1380011,Stratford School District,ABA Second Hill Lane,*,*,*,2016-17
1382411,1380011,Stratford School District,ABA Whitney,*,*,6,2016-17
1380511,1380011,Stratford School District,ALPHA,14,17,31,2016-17
1386211,1380011,Stratford School District,Bunnell High School,518,501,1019,2016-17
1380311,1380011,Stratford School District,Chapel School,237,278,515,2016-17
1382311,1380011,Stratford School District,DLC Whitney,*,*,6,2016-17
1385211,1380011,Stratford School District,David Wooster Middle School,264,276,540,2016-17
1382111,1380011,Stratford School District,Franklin STEPS K-2,*,*,*,2016-17
1380411,1380011,Stratford School District,Franklin School,131,146,277,2016-17
1385311,1380011,Stratford School District,Harry B. Flood Middle School,283,303,586,2016-17
1382011,1380011,Stratford School District,High School STEPS 9-12,*,*,7,2016-17
1380711,1380011,Stratford School District,High School Sails,*,*,11,2016-17
1382711,1380011,Stratford School District,IPP Class Room - Second Hill Lane,0,6,6,2016-17
1381111,1380011,Stratford School District,IPP Classroom - Johnson,0,*,*,2016-17
1381211,1380011,Stratford School District,Johnson House STEPS 3-6,*,*,9,2016-17
1380811,1380011,Stratford School District,Lordship School,142,127,269,2016-17
1381911,1380011,Stratford School District,Middle School STEPS 7-8,0,*,*,2016-17
1381811,1380011,Stratford School District,Middle School Sails,*,*,6,2016-17
1380911,1380011,Stratford School District,Nichols School,197,215,412,2016-17
1381011,1380011,Stratford School District,Second Hill Lane School,319,306,625,2016-17
1382611,1380011,Stratford School District,Steps K-2 Nichols,0,*,*,2016-17
1381511,1380011,Stratford School District,Stratford Academy - Johnson House,207,194,401,2016-17
1382211,1380011,Stratford School District,Stratford Academy - Victoria Soto School,138,138,276,2016-17
1386111,1380011,Stratford School District,Stratford High School,445,475,920,2016-17
1389011,1380011,Stratford School District,Strive-Stratford,6,13,19,2016-17
1381411,1380011,Stratford School District,Wilcoxson School,169,185,354,2016-17
1390411,1390011,Suffield School District,A. Ward Spaulding School,203,277,480,2016-17
1390311,1390011,Suffield School District,McAlister Intermediate School,260,210,470,2016-17
1396111,1390011,Suffield School District,Suffield High School,421,377,798,2016-17
1395111,1390011,Suffield School District,Suffield Middle School,256,267,523,2016-17
2696113,2690013,The Bridge Academy District,The Bridge Academy,148,133,281,2016-17
9026122,9020022,The Gilbert School District,The Gilbert School,240,322,562,2016-17
1400111,1400011,Thomaston School District,Black Rock School,123,139,262,2016-17
1400211,1400011,Thomaston School District,Thomaston Center School,117,88,205,2016-17
1406211,1400011,Thomaston School District,Thomaston High School,211,217,428,2016-17
1410211,1410011,Thompson School District,District Autism Program,0,*,*,2016-17
1410111,1410011,Thompson School District,Mary R. Fisher Elementary School,183,228,411,2016-17
1415111,1410011,Thompson School District,Thompson Middle School,160,186,346,2016-17
1416111,1410011,Thompson School District,Tourtellotte Memorial High School,119,128,247,2016-17
1420111,1420011,Tolland School District,Birch Grove Primary School,241,258,499,2016-17
1420311,1420011,Tolland School District,TALC,*,*,9,2016-17
1426111,1420011,Tolland School District,Tolland High School,424,391,815,2016-17
1420211,1420011,Tolland School District,Tolland Intermediate School,257,280,537,2016-17
1425111,1420011,Tolland School District,Tolland Middle School,295,307,602,2016-17
1430111,1430011,Torrington School District,East School,170,195,365,2016-17
1431511,1430011,Torrington School District,ABC / Forbes School,0,*,*,2016-17
1432411,1430011,Torrington School District,ABC / Torringford,0,*,*,2016-17
1432211,1430011,Torrington School District,East TPS - PreK - Reg Ed,25,23,48,2016-17
1430211,1430011,Torrington School District,Forbes School,169,204,373,2016-17
1431611,1430011,Torrington School District,Pre-K SpEd,6,13,19,2016-17
1430811,1430011,Torrington School District,Southwest School,155,159,314,2016-17
1432311,1430011,Torrington School District,Torringford Community Outreach,0,*,*,2016-17
1430911,1430011,Torrington School District,Torringford School,290,293,583,2016-17
1431411,1430011,Torrington School District,Torrington Expulsion Program,0,*,*,2016-17
1436111,1430011,Torrington School District,Torrington High School,400,497,897,2016-17
1435111,1430011,Torrington School District,Torrington Middle School,490,539,1029,2016-17
1431311,1430011,Torrington School District,Vogel-Wetmore School,234,228,462,2016-17
2785113,2780013,Trailblazers Academy District,Trailblazers Academy,56,73,129,2016-17
1440111,1440011,Trumbull School District,Booth Hill School,227,237,464,2016-17
1440811,1440011,Trumbull School District,Daniels Farm School,220,231,451,2016-17
1440611,1440011,Trumbull School District,Educating Learners in Transitional Environments (ELITE),*,*,9,2016-17
1441011,1440011,Trumbull School District,Frenchtown Elementary School,250,279,529,2016-17
1445211,1440011,Trumbull School District,Hillcrest Middle School,373,399,772,2016-17
1440411,1440011,Trumbull School District,Jane Ryan School,201,205,406,2016-17
1445111,1440011,Trumbull School District,Madison Middle School,404,431,835,2016-17
1440311,1440011,Trumbull School District,Middlebrook School,233,239,472,2016-17
1440511,1440011,Trumbull School District,REACH,8,7,15,2016-17
1440911,1440011,Trumbull School District,Tashua School,194,214,408,2016-17
1440211,1440011,Trumbull School District,Trumbull Alternative School,*,*,7,2016-17
1448011,1440011,Trumbull School District,Trumbull Early Childhood Education Center,102,130,232,2016-17
1446111,1440011,Trumbull School District,Trumbull High School,1075,991,2066,2016-17
3360115,3360015,Unified School District #1,Bridgeport Correctional Center,0,*,*,2016-17
3360215,3360015,Unified School District #1,Brooklyn Correctional Institution,0,*,*,2016-17
3360315,3360015,Unified School District #1,Cheshire Correctional Institution,0,13,13,2016-17
3362415,3360015,Unified School District #1,Corrigan/Radgowski Correctional Institution,0,15,15,2016-17
3360415,3360015,Unified School District #1,Enfield Correctional Institution,0,*,*,2016-17
3361915,3360015,Unified School District #1,Garner Correctional Institution,0,*,*,2016-17
3360615,3360015,Unified School District #1,Hartford Correctional Center,0,*,*,2016-17
3362215,3360015,Unified School District #1,MacDougall/Walker Correctional Institution,0,*,*,2016-17
3361115,3360015,Unified School District #1,Manson Youth Institution,0,275,275,2016-17
3360915,3360015,Unified School District #1,New Haven Correctional Center,0,*,*,2016-17
3362615,3360015,Unified School District #1,Northern Correctional Institution,0,6,6,2016-17
3361215,3360015,Unified School District #1,Osborn Correctional Institution,0,*,*,2016-17
3361315,3360015,Unified School District #1,Robinson Correctional Institution,0,6,6,2016-17
3361515,3360015,Unified School District #1,Willard/Cybulski Correctional Institution,0,*,*,2016-17
3362515,3360015,Unified School District #1,York Correctional Institution,21,0,21,2016-17
3470115,3470015,Unified School District #2,Children's Place School,0,27,27,2016-17
3470315,3470015,Unified School District #2,Riverview School,50,9,59,2016-17
3470215,3470015,Unified School District #2,Virtual Academy,*,*,*,2016-17
3476715,3470015,Unified School District #2,Walter G. Cady School,0,41,41,2016-17
1450111,1450011,Union School District,Union Elementary School,37,31,68,2016-17
3480315,3480015,Vernon School District,Hartford Detention Center,*,*,9,2016-17
1460311,1460011,Vernon School District,Northeast School,135,147,282,2016-17
1461411,1460011,Vernon School District,Center Road School,235,242,477,2016-17
1460111,1460011,Vernon School District,Lake Street School,129,141,270,2016-17
1460211,1460011,Vernon School District,Maple Street School,131,153,284,2016-17
1469011,1460011,Vernon School District,Next Step Program (AACBP),*,*,13,2016-17
1466111,1460011,Vernon School District,Rockville High School,440,407,847,2016-17
1461011,1460011,Vernon School District,Skinner Road School,156,154,310,2016-17
1465111,1460011,Vernon School District,Vernon Center Middle School,350,362,712,2016-17
1470111,1470011,Voluntown School District,Voluntown Elementary School,137,142,279,2016-17
1480211,1480011,Wallingford School District,Highland School,171,163,334,2016-17
1489011,1480011,Wallingford School District,A.R.T.S. Academy,*,*,11,2016-17
1481011,1480011,Wallingford School District,Cook Hill School,176,196,372,2016-17
1485211,1480011,Wallingford School District,Dag Hammarskjold Middle School,361,366,727,2016-17
1480511,1480011,Wallingford School District,Education Enhancement Program,8,7,15,2016-17
1480911,1480011,Wallingford School District,Evarts C. Stevens School,142,180,322,2016-17
1489211,1480011,Wallingford School District,Harvest Park,*,*,6,2016-17
1485311,1480011,Wallingford School District,James H. Moran Middle School,342,334,676,2016-17
1486111,1480011,Wallingford School District,Lyman Hall High School,561,475,1036,2016-17
1486211,1480011,Wallingford School District,Mark T. Sheehan High School,416,404,820,2016-17
1480111,1480011,Wallingford School District,Moses Y. Beach School,169,155,324,2016-17
1489111,1480011,Wallingford School District,Multi-Vocational Life Skills Program,*,*,10,2016-17
1480311,1480011,Wallingford School District,Parker Farms School,143,119,262,2016-17
1481211,1480011,Wallingford School District,Pond Hill School,147,168,315,2016-17
1480411,1480011,Wallingford School District,Rock Hill School,161,161,322,2016-17
1480811,1480011,Wallingford School District,Yalesville School,145,176,321,2016-17
3480115,3480015,Waterbury School District,Bridgeport Detention Center,0,*,*,2016-17
3481115,3480015,Waterbury School District,BRAVE,0,*,*,2016-17
3480415,3480015,Waterbury School District,SAGE,0,*,*,2016-17
1515211,1510011,Waterbury School District,West Side Middle School,455,562,1017,2016-17
1512311,1510011,Waterbury School District,Washington School,159,163,322,2016-17
1512111,1510011,Waterbury School District,B. W. Tinker School,297,298,595,2016-17
1510411,1510011,Waterbury School District,B.W. Tinker BDLC,0,17,17,2016-17
1514611,1510011,Waterbury School District,Bucks Hill Autism,*,*,9,2016-17
1514311,1510011,Waterbury School District,Bucks Hill Bilingual,66,86,152,2016-17
1510511,1510011,Waterbury School District,Bucks Hill School,224,229,453,2016-17
1510111,1510011,Waterbury School District,Bunker Hill BDLC,*,*,22,2016-17
1510611,1510011,Waterbury School District,Bunker Hill School,245,245,490,2016-17
1511911,1510011,Waterbury School District,Carrington ESC,*,*,10,2016-17
1512711,1510011,Waterbury School District,Carrington School,250,247,497,2016-17
1514111,1510011,Waterbury School District,Chase Bilingual,51,53,104,2016-17
1514511,1510011,Waterbury School District,Crosby Autism,0,6,6,2016-17
1516211,1510011,Waterbury School District,Crosby High School,504,633,1137,2016-17
1510911,1510011,Waterbury School District,Driggs School,245,262,507,2016-17
1511611,1510011,Waterbury School District,Duggan School,226,270,496,2016-17
1519111,1510011,Waterbury School District,Enlightenment School,76,92,168,2016-17
1511411,1510011,Waterbury School District,F. J. Kingsbury School,263,262,525,2016-17
1512611,1510011,Waterbury School District,Gilmartin School,226,247,473,2016-17
1510711,1510011,Waterbury School District,H. S. Chase School,310,365,675,2016-17
1514211,1510011,Waterbury School District,Hopeville Bilingual,42,53,95,2016-17
1511311,1510011,Waterbury School District,Hopeville School,210,179,389,2016-17
1516411,1510011,Waterbury School District,John F. Kennedy High School,612,640,1252,2016-17
1513111,1510011,Waterbury School District,Maloney Interdistrict Magnet School,307,283,590,2016-17
1519811,1510011,Waterbury School District,Maloney Prek,12,14,26,2016-17
1513511,1510011,Waterbury School District,Margaret M. Generali Autism,*,*,29,2016-17
1511111,1510011,Waterbury School District,Margaret M. Generali Elementary School,284,297,581,2016-17
1512911,1510011,Waterbury School District,Michael F. Wallace Autism,*,*,7,2016-17
1515111,1510011,Waterbury School District,Michael F. Wallace Middle School,583,611,1194,2016-17
1511811,1510011,Waterbury School District,North End ESC,*,*,7,2016-17
1515311,1510011,Waterbury School District,North End Middle School,481,504,985,2016-17
1512411,1510011,Waterbury School District,Reed ESC,8,10,18,2016-17
1513411,1510011,Waterbury School District,Reed School,221,243,464,2016-17
1512811,1510011,Waterbury School District,Regan School,125,137,262,2016-17
1513311,1510011,Waterbury School District,Rotella Interdistrict Magnet School,317,296,613,2016-17
1518011,1510011,Waterbury School District,Special Education Preschool,93,135,228,2016-17
1512011,1510011,Waterbury School District,Sprague School,216,260,476,2016-17
1519011,1510011,Waterbury School District,State Street School,19,49,68,2016-17
1512211,1510011,Waterbury School District,Walsh School,178,182,360,2016-17
1516011,1510011,Waterbury School District,Waterbury Arts Magnet School (High),307,171,478,2016-17
1515011,1510011,Waterbury School District,Waterbury Arts Magnet School (Middle),219,122,341,2016-17
1516711,1510011,Waterbury School District,Waterbury Career Academy,493,372,865,2016-17
1510811,1510011,Waterbury School District,Wendell L. Cross School,174,176,350,2016-17
1511711,1510011,Waterbury School District,Wilby ESC,*,*,11,2016-17
1516311,1510011,Waterbury School District,Wilby High School,485,591,1076,2016-17
1511211,1510011,Waterbury School District,Woodrow Wilson BDLC,*,*,15,2016-17
1513211,1510011,Waterbury School District,Woodrow Wilson School,215,237,452,2016-17
1521111,1520011,Waterford School District,Autism Class,0,*,*,2016-17
1520311,1520011,Waterford School District,Avery Point Transition Program,*,*,8,2016-17
1525111,1520011,Waterford School District,Clark Lane Middle School,326,311,637,2016-17
1520211,1520011,Waterford School District,Great Neck Elementary School,149,151,300,2016-17
1520611,1520011,Waterford School District,Oswegatchie Elementary School,182,174,356,2016-17
1520711,1520011,Waterford School District,Quaker Hill Elementary School,174,190,364,2016-17
1526111,1520011,Waterford School District,Waterford High School,405,441,846,2016-17
1521211,1520011,Waterford School District,Waterford High School Tutor Center,*,0,*,2016-17
3480315,3480015,Watertown School District,Hartford Detention Center,*,*,9,2016-17
1530311,1530011,Watertown School District,Fletcher W. Judson School,140,158,298,2016-17
1530211,1530011,Watertown School District,John Trumbull Primary School,276,363,639,2016-17
1530411,1530011,Watertown School District,Polk School,148,177,325,2016-17
1535111,1530011,Watertown School District,Swift Middle School,309,351,660,2016-17
1536111,1530011,Watertown School District,Watertown High School,424,415,839,2016-17
1530811,1530011,Watertown School District,Watertown Transition Academy,0,*,*,2016-17
1551711,1550011,West Hartford School District,Smith School,188,186,374,2016-17
1559111,1550011,West Hartford School District,Achieve,*,*,13,2016-17
1557311,1550011,West Hartford School District,REACH,12,28,40,2016-17
1551611,1550011,West Hartford School District,Aiken School,196,214,410,2016-17
1559311,1550011,West Hartford School District,Braeburn Learning Center,0,6,6,2016-17
1550211,1550011,West Hartford School District,Braeburn School,160,190,350,2016-17
1555311,1550011,West Hartford School District,Bristow Middle School,211,206,417,2016-17
1550411,1550011,West Hartford School District,Bugbee School,221,199,420,2016-17
1550511,1550011,West Hartford School District,Charter Oak International Academy,234,217,451,2016-17
1556111,1550011,West Hartford School District,Conard High School,693,763,1456,2016-17
1550611,1550011,West Hartford School District,Duffy School,256,232,488,2016-17
1556211,1550011,West Hartford School District,Hall High School,710,737,1447,2016-17
1555111,1550011,West Hartford School District,King Philip Middle School,473,512,985,2016-17
1550911,1550011,West Hartford School District,Morley School,143,140,283,2016-17
1559411,1550011,West Hartford School District,Norfeldt Learning Center,*,*,10,2016-17
1551011,1550011,West Hartford School District,Norfeldt School,156,187,343,2016-17
1555211,1550011,West Hartford School District,Sedgwick Middle School,450,424,874,2016-17
1559211,1550011,West Hartford School District,Strive-West Hartford,12,20,32,2016-17
1559011,1550011,West Hartford School District,WAAVE (W Hartford Applied Academic/Voc'l Experience),8,9,17,2016-17
1551211,1550011,West Hartford School District,Webster Hill School,225,190,415,2016-17
1559511,1550011,West Hartford School District,Whiting Lane Learning Center,*,*,10,2016-17
1551311,1550011,West Hartford School District,Whiting Lane School,172,224,396,2016-17
1559611,1550011,West Hartford School District,Wolcott Learning Center,6,8,14,2016-17
1551511,1550011,West Hartford School District,Wolcott School,234,224,458,2016-17
1561211,1560011,West Haven School District,Washington School,220,252,472,2016-17
1560111,1560011,West Haven School District,Life Skills,*,*,7,2016-17
1561111,1560011,West Haven School District,ASD Lab,*,*,6,2016-17
1560811,1560011,West Haven School District,Alma E. Pagels School,121,211,332,2016-17
1560711,1560011,West Haven School District,Blended,8,8,16,2016-17
1560511,1560011,West Haven School District,Blended (Molloy),6,6,12,2016-17
1565311,1560011,West Haven School District,Carrigan 5/6 Intermediate School,476,481,957,2016-17
1560611,1560011,West Haven School District,Edith E. Mackrille School,145,147,292,2016-17
1560311,1560011,West Haven School District,Forest School,213,232,445,2016-17
1565111,1560011,West Haven School District,Harry M. Bailey Middle School,386,420,806,2016-17
1560211,1560011,West Haven School District,PACE,9,27,36,2016-17
1561411,1560011,West Haven School District,Savin Rock Community School,235,238,473,2016-17
1560411,1560011,West Haven School District,Seth G. Haley School,200,207,407,2016-17
1566111,1560011,West Haven School District,West Haven High School,709,719,1428,2016-17
1540211,1540011,Westbrook School District,Daisy Ingraham School,136,126,262,2016-17
1546111,1540011,Westbrook School District,Westbrook High School,145,128,273,2016-17
1545111,1540011,Westbrook School District,Westbrook Middle School,95,132,227,2016-17
1570111,1570011,Weston School District,Hurlbutt Elementary School,217,224,441,2016-17
1576111,1570011,Weston School District,Weston High School,373,441,814,2016-17
1570211,1570011,Weston School District,Weston Intermediate School,240,281,521,2016-17
1575111,1570011,Weston School District,Weston Middle School,273,313,586,2016-17
1585111,1580011,Westport School District,Bedford Middle School,413,444,857,2016-17
1580111,1580011,Westport School District,CES Segregated,0,7,7,2016-17
1580311,1580011,Westport School District,Coleytown Elementary School,178,193,371,2016-17
1585311,1580011,Westport School District,Coleytown Middle School,259,254,513,2016-17
1580411,1580011,Westport School District,Green's Farms School,208,210,418,2016-17
1580211,1580011,Westport School District,Green's Farms Segregated,*,*,*,2016-17
1580511,1580011,Westport School District,King's Highway Elementary School,239,251,490,2016-17
1580611,1580011,Westport School District,King's Highway Segregated,*,*,*,2016-17
1580711,1580011,Westport School District,Long Lots School,275,270,545,2016-17
1580811,1580011,Westport School District,Saugatuck Elementary School,234,249,483,2016-17
1586111,1580011,Westport School District,Staples High School,897,956,1853,2016-17
1588011,1580011,Westport School District,Stepping Stones Preschool,21,33,54,2016-17
1590811,1590011,Wethersfield School District,Alfred W. Hanmer School,162,177,339,2016-17
1591011,1590011,Wethersfield School District,Charles Wright School,159,160,319,2016-17
1590211,1590011,Wethersfield School District,Emerson-Williams School,194,216,410,2016-17
1591111,1590011,Wethersfield School District,Highcrest School,227,198,425,2016-17
1591211,1590011,Wethersfield School District,Samuel B. Webb Elementary School,168,177,345,2016-17
1595211,1590011,Wethersfield School District,Silas Deane Middle School,287,273,560,2016-17
1596111,1590011,Wethersfield School District,Wethersfield High School,582,570,1152,2016-17
1590111,1590011,Wethersfield School District,Wethersfield Transition Academy,*,*,15,2016-17
1600111,1600011,Willington School District,Center School,109,133,242,2016-17
1605111,1600011,Willington School District,Hall Memorial School,92,92,184,2016-17
1615211,1610011,Wilton School District,Middlebrook School,482,532,1014,2016-17
1610711,1610011,Wilton School District,Cider Mill School,458,428,886,2016-17
1610511,1610011,Wilton School District,Miller-Driscoll School,394,423,817,2016-17
1616111,1610011,Wilton School District,Wilton High School,695,636,1331,2016-17
1620411,1620011,Winchester School District,Batcheller Early Education Center,96,122,218,2016-17
1625111,1620011,Winchester School District,Pearson Middle School,152,166,318,2016-17
1631211,1630011,Windham School District,Assisted Work Program,*,*,9,2016-17
1630411,1630011,Windham School District,Charles H. Barrows STEM Academy,271,289,560,2016-17
1638011,1630011,Windham School District,Early Headstart,15,21,36,2016-17
1630111,1630011,Windham School District,Natchaug School,142,172,314,2016-17
1630811,1630011,Windham School District,North Windham ASD Program,*,*,6,2016-17
1630311,1630011,Windham School District,North Windham School,243,232,475,2016-17
1631111,1630011,Windham School District,Sweeney ASD Program,*,*,6,2016-17
1630911,1630011,Windham School District,Sweeney Medically Fragile Program,*,*,*,2016-17
1630611,1630011,Windham School District,W. B. Sweeney School,130,130,260,2016-17
1630511,1630011,Windham School District,Windham Center School,143,136,279,2016-17
1638311,1630011,Windham School District,Windham Early Childhood Prospect Street,92,86,178,2016-17
1631011,1630011,Windham School District,Windham Early Childhood Tuckie Road,27,21,48,2016-17
1636111,1630011,Windham School District,Windham High School,241,340,581,2016-17
1635111,1630011,Windham School District,Windham Middle School,255,301,556,2016-17
1650111,1650011,Windsor Locks School District,North Street School,229,206,435,2016-17
1650611,1650011,Windsor Locks School District,Pine Meadow Academy,12,22,34,2016-17
1650211,1650011,Windsor Locks School District,RISE Transition Academy,*,*,11,2016-17
1650411,1650011,Windsor Locks School District,South Elementary School,189,151,340,2016-17
1656111,1650011,Windsor Locks School District,Windsor Locks High School,184,215,399,2016-17
1655111,1650011,Windsor Locks School District,Windsor Locks Middle School,164,182,346,2016-17
1640111,1640011,Windsor School District,Clover Street School,141,130,271,2016-17
1640211,1640011,Windsor School District,Community Based Transition Academy,*,*,15,2016-17
1640411,1640011,Windsor School District,Expulsion,*,*,*,2016-17
1640811,1640011,Windsor School District,John F. Kennedy School,172,202,374,2016-17
1640911,1640011,Windsor School District,Oliver Ellsworth School,178,188,366,2016-17
1640511,1640011,Windsor School District,Poquonock Elementary School,134,169,303,2016-17
1645311,1640011,Windsor School District,Sage Park Middle School,327,361,688,2016-17
1640311,1640011,Windsor School District,Spark,7,10,17,2016-17
1646111,1640011,Windsor School District,Windsor High School,562,576,1138,2016-17
1660311,1660011,Wolcott School District,ABC Classroom,*,*,*,2016-17
1660611,1660011,Wolcott School District,Alcott School,119,156,275,2016-17
1660211,1660011,Wolcott School District,Frisbie School,145,154,299,2016-17
1660411,1660011,Wolcott School District,Phoenix Program,0,*,*,2016-17
1665111,1660011,Wolcott School District,Tyrrell Middle School,276,296,572,2016-17
1660511,1660011,Wolcott School District,Wakelee School,159,180,339,2016-17
1666111,1660011,Wolcott School District,Wolcott High School,375,413,788,2016-17
1670311,1670011,Woodbridge School District,Beecher Road School,377,397,774,2016-17
9036122,9030022,Woodstock Academy District,Woodstock Academy,551,514,1065,2016-17
1690211,1690011,Woodstock School District,Woodstock Elementary School,218,212,430,2016-17
1695111,1690011,Woodstock School District,Woodstock Middle School,201,207,408,2016-17
